key,micro,other,oligo,astro,neuron,n_cells
CTCATGGCTCACAATC-1_Br2720_Ant_IF,0,0,0,0,0,0
ATCTGTAATTGTACCC-1_Br2720_Ant_IF,1,0,0,2,0,3
TTATTAGGGAAGCATC-1_Br2720_Ant_IF,1,0,0,6,0,7
CTTCTTACGTCGTATA-1_Br2720_Ant_IF,0,0,0,0,0,0
GAAGTGCTGGATAGCT-1_Br2720_Ant_IF,2,1,3,0,0,6
GTGCAACAAATGTGGC-1_Br2720_Ant_IF,2,0,1,0,0,3
CATGCGTTAGACAGAA-1_Br2720_Ant_IF,0,1,0,0,0,1
ACACACTTTCTACACG-1_Br2720_Ant_IF,3,5,2,0,0,10
AGCCCTAAGCGAAGTT-1_Br2720_Ant_IF,1,1,1,2,0,5
ATTAATTCGGTCACTC-1_Br2720_Ant_IF,0,0,0,0,0,0
AACAGGAAATCGAATA-1_Br2720_Ant_IF,0,0,0,0,0,0
ACCAAGAACGCGTGTC-1_Br2720_Ant_IF,0,0,0,0,0,0
GATGCTACAAGCGCCT-1_Br2720_Ant_IF,2,0,1,0,0,3
GTTCCAGTCTGACCAT-1_Br2720_Ant_IF,2,0,2,4,0,8
ATGATCGGGAATAGAC-1_Br2720_Ant_IF,0,0,0,0,0,0
TTGGATTGGGTACCAC-1_Br2720_Ant_IF,1,1,2,0,0,4
TACCTCACGCTTGTAC-1_Br2720_Ant_IF,3,0,0,4,0,7
CATGGCAGGAAGATCG-1_Br2720_Ant_IF,0,1,3,0,0,4
ATGACGCCGGCTCTAA-1_Br2720_Ant_IF,3,0,1,3,0,7
AGCGACATCCCATTCA-1_Br2720_Ant_IF,1,2,1,0,0,4
AGTAATGTCTTGCCGC-1_Br2720_Ant_IF,5,0,2,0,0,7
TTCTTAGTGGCTCAGA-1_Br2720_Ant_IF,3,0,1,0,0,4
CGTCTGGAAGGGCCCG-1_Br2720_Ant_IF,5,0,1,0,0,6
ACGTGCGCCTCGTGCA-1_Br2720_Ant_IF,2,3,0,0,1,6
AGAGCGGGCTAATCAT-1_Br2720_Ant_IF,7,0,1,0,0,8
GCGTCGAAATGTCGGT-1_Br2720_Ant_IF,0,2,2,0,0,4
AACTGATATTAGGCCT-1_Br2720_Ant_IF,5,0,2,0,0,7
CGAGCTGGGCTTTAGG-1_Br2720_Ant_IF,1,1,0,1,0,3
GGGTGTTTCAGCTATG-1_Br2720_Ant_IF,1,1,1,0,0,3
TTAATTTCAGACGCGG-1_Br2720_Ant_IF,2,2,1,0,0,5
CACTGTCCAAGTGAGA-1_Br2720_Ant_IF,0,0,0,0,0,0
ATTACTAGCCTCTTGC-1_Br2720_Ant_IF,0,0,0,0,0,0
CATAGTAGCATAGTAG-1_Br2720_Ant_IF,2,0,1,0,0,3
CAACTCCTTGATCCCG-1_Br2720_Ant_IF,0,0,0,0,0,0
AAGTAGAAGACCGGGT-1_Br2720_Ant_IF,2,0,0,2,0,4
GCGGGAACCAGGCCCT-1_Br2720_Ant_IF,0,0,4,0,0,4
ATTAGATTGATAGCGG-1_Br2720_Ant_IF,3,1,0,1,0,5
CTCGGTCCGTAGCCTG-1_Br2720_Ant_IF,3,0,0,2,0,5
TGGCTTTGGGTAGACA-1_Br2720_Ant_IF,1,1,1,0,0,3
TATCCATATCATGCGA-1_Br2720_Ant_IF,0,1,1,2,0,4
GGAGTGCCGCCCTGGA-1_Br2720_Ant_IF,3,0,0,1,0,4
TGAGAATGCTTTACCG-1_Br2720_Ant_IF,1,2,1,0,1,5
TTAACCAACCCTCCCT-1_Br2720_Ant_IF,2,1,3,0,0,6
TGTTTCGGTACTTCTC-1_Br2720_Ant_IF,2,1,2,0,0,5
TTGCTGAAGGAACCAC-1_Br2720_Ant_IF,2,0,2,0,0,4
TATTTAGTCTAGATCG-1_Br2720_Ant_IF,0,2,2,0,0,4
CTCCGGCCTAATATGC-1_Br2720_Ant_IF,4,0,0,1,1,6
TTGTGGCCCTGACAGT-1_Br2720_Ant_IF,2,1,1,0,0,4
TCGCCGGTCGATCCGT-1_Br2720_Ant_IF,1,1,3,0,2,7
CCATAGGTTGGCGTGG-1_Br2720_Ant_IF,3,2,1,0,0,6
GAACGACCGAATGATA-1_Br2720_Ant_IF,2,0,1,0,0,3
TCCGATAATTGCCATA-1_Br2720_Ant_IF,0,0,1,0,0,1
CATTACGTCGGCCCGT-1_Br2720_Ant_IF,3,0,3,0,1,7
CAAGCACCAAATGCCT-1_Br2720_Ant_IF,1,1,4,0,0,6
TGCATGGATCGGATCT-1_Br2720_Ant_IF,2,0,0,0,0,2
GAAATCGCGCGCAACT-1_Br2720_Ant_IF,3,1,2,0,0,6
CTGAAAGAGATCCGAC-1_Br2720_Ant_IF,4,0,2,1,0,7
CACCTCGATGGTGGAC-1_Br2720_Ant_IF,1,0,6,0,0,7
ATTTGTTCCAGGGCTC-1_Br2720_Ant_IF,3,0,4,0,0,7
TGGGCCACAAGAGCGC-1_Br2720_Ant_IF,0,2,1,0,0,3
CCTTCTTGATCCAGTG-1_Br2720_Ant_IF,1,0,2,2,0,5
TTCATGGCGCAACAGG-1_Br2720_Ant_IF,2,1,0,0,0,3
TAACAAAGGGAGAAGC-1_Br2720_Ant_IF,0,0,0,0,0,0
TCTGAACCGGTCGGCT-1_Br2720_Ant_IF,0,0,0,0,0,0
TATAAGTGAGGATAGC-1_Br2720_Ant_IF,4,0,0,1,1,6
GCCCGCGCGTTTGACA-1_Br2720_Ant_IF,0,0,0,0,0,0
TGCTGGTTGGACAATT-1_Br2720_Ant_IF,3,0,0,6,1,10
GCCTAGCGATCTGACC-1_Br2720_Ant_IF,2,0,2,0,0,4
TATAAATCCACAAGCT-1_Br2720_Ant_IF,3,0,1,3,0,7
CGCTCGACATAATGAT-1_Br2720_Ant_IF,7,0,2,0,0,9
CCAATTGAATGTTAAT-1_Br2720_Ant_IF,2,1,1,0,1,5
GCTAATACCGAATGCC-1_Br2720_Ant_IF,6,0,0,1,0,7
TTCAACGACCCGACCG-1_Br2720_Ant_IF,4,0,4,0,0,8
TTCCTCGAGGGTGTCT-1_Br2720_Ant_IF,6,0,1,0,1,8
CAACGACCCGTTTACA-1_Br2720_Ant_IF,2,0,3,0,0,5
CTTGTACTTGTTGACT-1_Br2720_Ant_IF,5,0,1,0,1,7
TCTCTAATAGCTGGTA-1_Br2720_Ant_IF,3,0,2,0,0,5
ATTATGCCATAGGGAG-1_Br2720_Ant_IF,1,0,4,0,0,5
GACAACGCAGCTTACG-1_Br2720_Ant_IF,3,0,1,1,0,5
AGATGACTCGCCCACG-1_Br2720_Ant_IF,3,0,1,0,0,4
GTGCGGGTCTCCAAAT-1_Br2720_Ant_IF,5,0,2,0,0,7
GTACGAGATTGCGACA-1_Br2720_Ant_IF,4,0,4,0,0,8
GTATAGGACTCAGTAG-1_Br2720_Ant_IF,9,0,1,0,0,10
TTGCACGGAGCAGCAC-1_Br2720_Ant_IF,3,0,3,0,0,6
CACAGCTAGGGAGTGA-1_Br2720_Ant_IF,9,3,1,0,0,13
ATACTAGCATGACCCT-1_Br2720_Ant_IF,5,0,0,0,0,5
CCAAGACTTCTGCGAA-1_Br2720_Ant_IF,9,0,0,0,0,9
ACATAATAAGGCGGTG-1_Br2720_Ant_IF,2,0,1,0,0,3
TAATACACAGTAGTAT-1_Br2720_Ant_IF,4,0,1,0,1,6
TCTTGGTAACACCAAA-1_Br2720_Ant_IF,2,0,6,1,2,11
AACTGGGTCCCGACGT-1_Br2720_Ant_IF,4,0,4,0,0,8
ATCACTTCATCCTCGC-1_Br2720_Ant_IF,4,0,1,0,0,5
TGGAAGGATAAAGATG-1_Br2720_Ant_IF,1,0,2,0,0,3
CATGATGCACAATTCT-1_Br2720_Ant_IF,6,0,2,0,0,8
TGCCTGATCAAACGAT-1_Br2720_Ant_IF,3,0,1,2,0,6
ATAGGGATATCCTTGA-1_Br2720_Ant_IF,1,0,3,0,1,5
CACCTAATCAGTTTAC-1_Br2720_Ant_IF,5,0,3,0,1,9
TGTGACTACGCCAGTC-1_Br2720_Ant_IF,3,0,5,0,1,9
CCCGACCATAGTCCGC-1_Br2720_Ant_IF,0,1,2,2,0,5
CGCGCCCGACTTAATA-1_Br2720_Ant_IF,3,0,1,0,0,4
TGCCACCTGGCGAAAC-1_Br2720_Ant_IF,0,3,0,0,0,3
CTGCCAAGGTTGGAAG-1_Br2720_Ant_IF,0,3,0,0,0,3
TAAATGAATCCGTTTC-1_Br2720_Ant_IF,0,0,0,0,0,0
GTCACTCTCCAAATCT-1_Br2720_Ant_IF,1,0,0,0,2,3
CGCAATTACTTTCGGT-1_Br2720_Ant_IF,4,0,2,0,2,8
CTGTTCATCTCACGGG-1_Br2720_Ant_IF,0,0,0,0,0,0
TTCTTGTAACCTAATG-1_Br2720_Ant_IF,3,0,0,2,1,6
GCTTGATGATAATCAG-1_Br2720_Ant_IF,2,0,2,0,1,5
TTGGCTCGCATGAGAC-1_Br2720_Ant_IF,0,1,0,0,0,1
GCCCAGTTGGTATGCC-1_Br2720_Ant_IF,3,0,1,3,0,7
ATTCCTCCGCCAGTGC-1_Br2720_Ant_IF,1,3,0,0,0,4
TCGTCCGCTGGCGTCT-1_Br2720_Ant_IF,0,0,2,1,0,3
GGAGAAGTCATTGGCA-1_Br2720_Ant_IF,0,0,0,0,2,2
TTGTTAGCAAATTCGA-1_Br2720_Ant_IF,2,0,2,0,0,4
TCTAGCATCTTCGATG-1_Br2720_Ant_IF,0,5,1,0,1,7
TTCTAGGCCAATTGTG-1_Br2720_Ant_IF,2,0,4,0,0,6
TCACGGTCATCGCACA-1_Br2720_Ant_IF,0,0,0,1,0,1
ATGAAGCCAAGGAGCC-1_Br2720_Ant_IF,2,0,3,0,1,6
AATGACTGTCAGCCGG-1_Br2720_Ant_IF,1,1,0,0,0,2
CCAAACAGAACCCTCG-1_Br2720_Ant_IF,1,0,0,0,0,1
TATCGATGATTAAACG-1_Br2720_Ant_IF,0,0,1,0,0,1
GAACACACATCAACCA-1_Br2720_Ant_IF,0,2,2,0,3,7
CCCGTCAGCGTCTGAC-1_Br2720_Ant_IF,0,1,0,0,0,1
AGCATCGTCGATAATT-1_Br2720_Ant_IF,3,1,3,0,0,7
GACTAAGATCATGCAC-1_Br2720_Ant_IF,0,0,3,1,0,4
TAGGGTGTTTCAAGAG-1_Br2720_Ant_IF,2,0,1,0,0,3
TGGTTCGTAGCAAAGG-1_Br2720_Ant_IF,3,0,3,0,0,6
CTGTTCACTGCCTGTG-1_Br2720_Ant_IF,2,0,0,0,0,2
ATGTGCATCCGACGCA-1_Br2720_Ant_IF,2,0,1,0,0,3
TTGTCGTTCAGTTACC-1_Br2720_Ant_IF,3,0,6,0,1,10
CGGGATCAATGTAAGA-1_Br2720_Ant_IF,0,0,1,2,0,3
TTATCTGTATCATAAC-1_Br2720_Ant_IF,3,0,1,0,0,4
ATCGACTCTTTCCGTT-1_Br2720_Ant_IF,3,0,1,0,0,4
CTCATTTGATGGGCGG-1_Br2720_Ant_IF,2,2,1,0,0,5
GTAAGCGGGCAGTCAG-1_Br2720_Ant_IF,0,0,1,1,0,2
TCTATCGGTCGCAACA-1_Br2720_Ant_IF,1,1,0,0,0,2
AACGCGGTCTCCAGCC-1_Br2720_Ant_IF,3,0,4,2,2,11
ATTAATACTACGCGGG-1_Br2720_Ant_IF,1,0,5,0,0,6
CTTTAACTTTCAAAGG-1_Br2720_Ant_IF,3,3,2,3,1,12
CGTACCTGATAGGCCT-1_Br2720_Ant_IF,1,1,2,1,0,5
GAATGTTGGGTAATCT-1_Br2720_Ant_IF,0,0,0,0,0,0
TGCGGAGTAAAGGTGC-1_Br2720_Ant_IF,2,0,1,0,1,4
CCTGAATATTTACATA-1_Br2720_Ant_IF,1,0,2,1,0,4
TTGCTCCCATACCGGA-1_Br2720_Ant_IF,4,0,5,1,0,10
CCTCTAATCTGCCAAG-1_Br2720_Ant_IF,0,1,1,1,0,3
AGGTTGAGGCACGCTT-1_Br2720_Ant_IF,4,0,1,0,0,5
TCCCGTCAGTCCCGCA-1_Br2720_Ant_IF,3,0,1,0,0,4
TCCGATGACTGAGCTC-1_Br2720_Ant_IF,0,1,5,2,0,8
CAGCCTCCTGCAGAGG-1_Br2720_Ant_IF,2,0,5,0,0,7
CTTAGCCTTCCACATG-1_Br2720_Ant_IF,2,0,2,0,0,4
ATTAATGAACCAGTCG-1_Br2720_Ant_IF,2,1,3,0,0,6
CCCGGTGGAAGAACCT-1_Br2720_Ant_IF,0,0,0,0,0,0
GATTCCTATACGGCGC-1_Br2720_Ant_IF,2,1,0,0,2,5
TTACCCTAACAGTCCT-1_Br2720_Ant_IF,0,0,0,0,0,0
ACCCACCTACATGCTC-1_Br2720_Ant_IF,1,0,0,0,0,1
AAAGGGCAGCTTGAAT-1_Br2720_Ant_IF,1,0,0,0,0,1
CACACAGGGATAGATT-1_Br2720_Ant_IF,0,0,1,0,1,2
AGAGCGTACAAGCTCG-1_Br2720_Ant_IF,7,1,0,0,0,8
TCTTACGGCATCCGAC-1_Br2720_Ant_IF,4,0,0,0,1,5
GCCTATTCCGATATAG-1_Br2720_Ant_IF,3,0,1,0,2,6
GAAAGTGACTAACTGC-1_Br2720_Ant_IF,2,0,0,0,0,2
CCGGAATGGTTTCAGT-1_Br2720_Ant_IF,1,0,0,0,2,3
AGTATAATACTAGGCA-1_Br2720_Ant_IF,0,1,0,0,0,1
TAACTATCGAAGGTCC-1_Br2720_Ant_IF,0,0,0,0,1,1
ATGAGGAGTGTTAATC-1_Br2720_Ant_IF,0,0,0,0,0,0
TGTGTCGCGAGTTGCA-1_Br2720_Ant_IF,0,0,0,0,1,1
ATCCAACGCAGTCATA-1_Br2720_Ant_IF,0,0,3,0,0,3
AAGGCGCGTAAAGCTT-1_Br2720_Ant_IF,1,1,0,0,1,3
AGTCGGCCCAAACGAC-1_Br2720_Ant_IF,5,1,6,0,1,13
AACGTCAGACTAGTGG-1_Br2720_Ant_IF,0,0,1,0,1,2
ACTACCAGCTCTCTGG-1_Br2720_Ant_IF,0,0,0,0,0,0
GCAAGTGCACAGAGAA-1_Br2720_Ant_IF,0,0,1,0,0,1
ACACCTTAAGTAGGGC-1_Br2720_Ant_IF,0,5,1,0,0,6
TTCGACGGGAAGGGCG-1_Br2720_Ant_IF,0,2,1,0,1,4
TTCGCACTCGCGTGCT-1_Br2720_Ant_IF,1,3,1,0,0,5
TATTTGTTACCCTTTA-1_Br2720_Ant_IF,1,2,3,0,0,6
CGCTGTGACGCCGCAC-1_Br2720_Ant_IF,1,0,4,1,0,6
GTTGCACGGAGTTTCG-1_Br2720_Ant_IF,2,0,0,0,0,2
GTTTCCTGGAGGGTGA-1_Br2720_Ant_IF,1,0,0,0,1,2
ACACCCAGCATGCAGC-1_Br2720_Ant_IF,1,0,2,2,0,5
TCAACCATGTTCGGGC-1_Br2720_Ant_IF,1,0,1,1,0,3
TTACAACTACGCATCC-1_Br2720_Ant_IF,1,2,1,0,0,4
TCCGATGGTGCGACAT-1_Br2720_Ant_IF,1,0,1,0,0,2
GGGCGTACATTTATAT-1_Br2720_Ant_IF,1,1,0,0,0,2
AGCGACCAACGATATT-1_Br2720_Ant_IF,1,0,1,0,0,2
ACACAAAGACGGGTGG-1_Br2720_Ant_IF,3,1,4,0,0,8
ATCGCACGCCGGGAGA-1_Br2720_Ant_IF,3,0,2,0,0,5
GCTCTAAACCCTGACG-1_Br2720_Ant_IF,0,1,0,0,0,1
AATGCAACCGGGTACC-1_Br2720_Ant_IF,1,1,1,0,0,3
TCAAACAACCGCGTCG-1_Br2720_Ant_IF,2,0,2,1,0,5
TATGCTCCCTACTTAC-1_Br2720_Ant_IF,3,0,1,0,0,4
AAAGGGATGTAGCAAG-1_Br2720_Ant_IF,3,0,7,0,0,10
ACGATCATACATAGAG-1_Br2720_Ant_IF,1,0,2,0,0,3
TTGTTCAGTGTGCTAC-1_Br2720_Ant_IF,2,0,0,0,0,2
ATGCATGATCCAGGAT-1_Br2720_Ant_IF,2,0,0,1,0,3
AGTCTTCTCCTCAAAT-1_Br2720_Ant_IF,2,0,0,0,0,2
GATTCCCTTGTCGCAG-1_Br2720_Ant_IF,2,0,3,0,0,5
CTCGCACCTATATAGT-1_Br2720_Ant_IF,4,0,2,0,0,6
ACTCAATAAAGGCACG-1_Br2720_Ant_IF,4,0,1,0,0,5
AACCGAGCTTGGTCAT-1_Br2720_Ant_IF,1,1,2,0,0,4
TAAGGCAACATAAGAT-1_Br2720_Ant_IF,2,1,0,0,0,3
CACGCACAGCGCAGCT-1_Br2720_Ant_IF,3,0,2,0,0,5
GGTTTACAATCTCAAT-1_Br2720_Ant_IF,4,0,3,2,0,9
TGCAGGATCGGCAAAG-1_Br2720_Ant_IF,1,0,1,0,0,2
ATAACGGAGTCCAACG-1_Br2720_Ant_IF,4,0,3,0,0,7
AACGATATGTCAACTG-1_Br2720_Ant_IF,1,1,4,0,0,6
GACAACGACCATTGAA-1_Br2720_Ant_IF,4,0,0,0,0,4
TTGACCATGTTCTCCG-1_Br2720_Ant_IF,3,0,0,0,0,3
AGTACGGGCACCTGGC-1_Br2720_Ant_IF,3,1,0,1,0,5
CGCCATCCGATTATGA-1_Br2720_Ant_IF,2,0,3,0,0,5
AAGGTATCCTAATATA-1_Br2720_Ant_IF,2,0,2,0,0,4
TGTTGTCAAGAAGTCT-1_Br2720_Ant_IF,0,2,1,0,0,3
CAGTGAATAAATGACT-1_Br2720_Ant_IF,0,0,0,1,0,1
GACTGCGGCACGTGTA-1_Br2720_Ant_IF,0,0,0,0,0,0
TTATCGCCTGCGAAGC-1_Br2720_Ant_IF,0,0,0,0,1,1
TGGAATTAGACGCTTT-1_Br2720_Ant_IF,0,4,0,0,0,4
TCGTCACACTGTTAGC-1_Br2720_Ant_IF,1,5,0,0,0,6
TTATGTTTGCGATAGA-1_Br2720_Ant_IF,0,1,0,0,0,1
GGTGCTGATCACAAAG-1_Br2720_Ant_IF,0,3,2,0,0,5
CATAGCCGCCCGGGAT-1_Br2720_Ant_IF,0,0,1,0,0,1
GGTTAGTTACGGCGCC-1_Br2720_Ant_IF,0,2,0,0,1,3
ATTCCCACATAAACAA-1_Br2720_Ant_IF,0,2,1,0,0,3
ATTCAGTAGCAGGGTC-1_Br2720_Ant_IF,0,0,2,0,0,2
CAGTTCCGCGGGTCGA-1_Br2720_Ant_IF,1,0,1,0,3,5
AAGAGATGAATCGGTA-1_Br2720_Ant_IF,0,2,0,0,1,3
CGCAATTCTACAATAA-1_Br2720_Ant_IF,1,3,0,0,1,5
TAACGCTTTGAGAGCG-1_Br2720_Ant_IF,1,3,1,0,0,5
AGGCTATGGTTAGCTT-1_Br2720_Ant_IF,1,1,0,0,0,2
GAGGAATGGAGAGGTT-1_Br2720_Ant_IF,0,0,2,0,1,3
TCCTCTACGAGATGGC-1_Br2720_Ant_IF,1,0,1,0,1,3
TTGATTATGCAGATGA-1_Br2720_Ant_IF,0,2,0,0,1,3
TCAGTACTGACCCGCG-1_Br2720_Ant_IF,0,4,0,0,1,5
TTATGACAAACTGGAT-1_Br2720_Ant_IF,0,2,2,0,0,4
GTAAGTAGGGTATACC-1_Br2720_Ant_IF,1,0,0,0,2,3
CGCAAACACGAGTTAC-1_Br2720_Ant_IF,0,3,2,0,0,5
TGGCCGTATATTGACC-1_Br2720_Ant_IF,0,0,0,0,0,0
ACTGTAGCACTTTGGA-1_Br2720_Ant_IF,0,1,0,0,1,2
GCTCTATGTTACGTGC-1_Br2720_Ant_IF,0,1,0,0,0,1
TGCGCGATTAACGGAG-1_Br2720_Ant_IF,2,1,1,1,0,5
GAATCGACATGGTCAC-1_Br2720_Ant_IF,0,3,0,0,0,3
GACTAAGTAGGCTCAC-1_Br2720_Ant_IF,0,2,1,0,0,3
ATCTTGACCTGCAACG-1_Br2720_Ant_IF,0,2,0,0,1,3
ATGCACTACCGCATTG-1_Br2720_Ant_IF,0,2,0,0,0,2
CAGATACTAACATAGT-1_Br2720_Ant_IF,0,1,1,0,0,2
GATCGACACTATCTGA-1_Br2720_Ant_IF,1,0,1,0,2,4
ATAGAGTACTGGGACA-1_Br2720_Ant_IF,2,0,2,0,0,4
CCTACTGCTTACACTT-1_Br2720_Ant_IF,0,0,0,0,0,0
CCTGCTATTTGAGAAG-1_Br2720_Ant_IF,3,5,0,1,1,10
CGCGTTCATGAAATAC-1_Br2720_Ant_IF,1,0,0,0,0,1
CATTATGCTTGTTGTG-1_Br2720_Ant_IF,1,0,0,1,0,2
CCAGGGACGTGGCCTC-1_Br2720_Ant_IF,2,1,0,0,1,4
TATGGATGTGCTACGC-1_Br2720_Ant_IF,1,1,1,0,0,3
GTACTAAGATTTGGAG-1_Br2720_Ant_IF,3,1,0,0,0,4
AGACCCGCCCTCCTCG-1_Br2720_Ant_IF,1,2,0,0,1,4
CGCATTAGCTAATAGG-1_Br2720_Ant_IF,4,2,2,2,1,11
GCTCTCGGGTACCGAA-1_Br2720_Ant_IF,4,0,2,0,0,6
CACCGCCAGAAGGTTT-1_Br2720_Ant_IF,1,0,0,1,0,2
TCCCAAAGACGAAGGA-1_Br2720_Ant_IF,0,3,0,0,0,3
ATGGATTGACCAAACG-1_Br2720_Ant_IF,1,3,0,0,0,4
GTCATGGACATGACTA-1_Br2720_Ant_IF,1,0,1,0,0,2
CTACTGCCACCTGACC-1_Br2720_Ant_IF,0,0,0,0,0,0
TTATATTTGGCAATCC-1_Br2720_Ant_IF,2,0,1,0,0,3
AGCACCAGTACTCACG-1_Br2720_Ant_IF,1,1,2,0,0,4
CATGGTCTAGATACCG-1_Br2720_Ant_IF,1,0,2,0,1,4
TCTACCGTCCACAAGC-1_Br2720_Ant_IF,0,3,2,0,0,5
CTAGTTGGGCCCGGTA-1_Br2720_Ant_IF,3,0,0,1,0,4
TCCCGCGTACTCCTGG-1_Br2720_Ant_IF,4,1,1,1,0,7
CAGAGCATGAGCTTGC-1_Br2720_Ant_IF,1,1,5,0,0,7
ACACGGGAACTTAGGG-1_Br2720_Ant_IF,1,1,1,0,1,4
GGCTCTGCTCCAACGC-1_Br2720_Ant_IF,1,0,1,1,0,3
AGAACGTGGTACATTC-1_Br2720_Ant_IF,1,0,4,0,1,6
CAATAAACCTTGGCCC-1_Br2720_Ant_IF,1,0,3,0,1,5
ACTTCGCCATACGCAC-1_Br2720_Ant_IF,4,0,2,0,0,6
ATCTGGTTAAGACTGT-1_Br2720_Ant_IF,3,0,1,0,0,4
TCGTAAGACGACATTG-1_Br2720_Ant_IF,1,1,0,1,0,3
GTGTACCTTGGCTACG-1_Br2720_Ant_IF,3,0,3,1,0,7
GCCCGTAATACCTTCT-1_Br2720_Ant_IF,0,0,0,0,0,0
CGGTCAAGTGGGAACC-1_Br2720_Ant_IF,0,1,4,0,1,6
TTGTAAGGCCAGTTGG-1_Br2720_Ant_IF,3,1,0,1,0,5
GGAGCACCAAGAACTA-1_Br2720_Ant_IF,0,4,0,1,0,5
TAATAGTGACGACCAG-1_Br2720_Ant_IF,1,0,2,0,1,4
CTAAATCCTATTCCGG-1_Br2720_Ant_IF,0,0,0,0,0,0
CGAGTTCTGTCCCACC-1_Br2720_Ant_IF,3,0,1,0,0,4
GAGTCGACAGACCCTC-1_Br2720_Ant_IF,0,0,0,0,0,0
AGGGTGGATAGTGCAT-1_Br2720_Ant_IF,0,0,0,0,0,0
TGATAGCGGGATTCTA-1_Br2720_Ant_IF,0,0,1,0,0,1
GTCAGTTTGGTAGTCG-1_Br2720_Ant_IF,0,1,0,0,0,1
GCATTCGAAATGAACA-1_Br2720_Ant_IF,0,3,0,0,0,3
AAAGACTGGGCGCTTT-1_Br2720_Ant_IF,1,2,1,0,1,5
TAACAATATTTGTTGC-1_Br2720_Ant_IF,0,0,0,0,0,0
CCAGCTTCCGCCCGCA-1_Br2720_Ant_IF,1,1,0,0,0,2
GATATGGATTACGCGG-1_Br2720_Ant_IF,1,0,1,0,1,3
AGAGCAGTTATGAGAC-1_Br2720_Ant_IF,0,2,2,0,1,5
TCACATCTTATCTGAT-1_Br2720_Ant_IF,1,1,0,0,0,2
TATGAAGACAGGTGCG-1_Br2720_Ant_IF,0,2,0,0,1,3
TACCTGCTGCACTGTG-1_Br2720_Ant_IF,0,0,0,0,1,1
TAGGTCCAAGTAAGGA-1_Br2720_Ant_IF,0,1,0,0,1,2
GAAACTCGTGCGATGC-1_Br2720_Ant_IF,1,1,2,0,0,4
AACAATTACTCTACGC-1_Br2720_Ant_IF,0,1,0,0,1,2
CCGCACGTGACCTCGG-1_Br2720_Ant_IF,0,0,0,0,1,1
AACTTGCCCGTATGCA-1_Br2720_Ant_IF,1,3,0,0,0,4
GGGTATGTATGCACTT-1_Br2720_Ant_IF,1,0,0,0,0,1
TTCGTACTCCAGAACG-1_Br2720_Ant_IF,0,1,2,0,2,5
GAATTTCTCGCTGCAG-1_Br2720_Ant_IF,0,2,0,0,0,2
AACAGGATGGGCCGCG-1_Br2720_Ant_IF,2,1,2,0,0,5
GACGTGTAGGGATTAT-1_Br2720_Ant_IF,1,0,1,0,0,2
TAGGTGAGCCCTACTC-1_Br2720_Ant_IF,0,1,0,0,0,1
CTAATTCGCACGCGCT-1_Br2720_Ant_IF,0,1,1,0,1,3
GAAGCTTGCTGACCGC-1_Br2720_Ant_IF,3,1,0,0,0,4
GGTTAGGCTTGGAGAA-1_Br2720_Ant_IF,0,2,0,0,0,2
ACAAGGACAAGAGGTT-1_Br2720_Ant_IF,0,2,0,0,1,3
AGGCCACCCGTTATGA-1_Br2720_Ant_IF,0,1,1,0,1,3
GTGGGCTTAGACACAC-1_Br2720_Ant_IF,3,1,2,0,0,6
CGTGTCCCATTCGCGA-1_Br2720_Ant_IF,0,3,1,0,0,4
TGGAGTGATGCGATGA-1_Br2720_Ant_IF,0,1,0,0,0,1
AACAACTGGTAGTTGC-1_Br2720_Ant_IF,0,2,0,0,0,2
CCTGGCTAGACCCGCC-1_Br2720_Ant_IF,0,1,1,0,0,2
CGCAATTAGGGTAATA-1_Br2720_Ant_IF,0,1,0,0,0,1
TCGAAATTTAGGACCA-1_Br2720_Ant_IF,1,1,2,0,0,4
AGACTAGCCTTCCAGA-1_Br2720_Ant_IF,3,0,0,0,0,3
TTGATCTAACTTTGTC-1_Br2720_Ant_IF,2,1,1,0,0,4
AAGGAGCGGTTGGTGC-1_Br2720_Ant_IF,0,2,0,0,0,2
ACTTGGGACCCGGTGG-1_Br2720_Ant_IF,2,1,1,0,0,4
TGATCTCCGGCGCCAG-1_Br2720_Ant_IF,2,0,1,0,0,3
CAGTTCAAATTGACAC-1_Br2720_Ant_IF,1,0,1,0,0,2
GTCCGGCTGAATTGCG-1_Br2720_Ant_IF,0,0,4,1,1,6
CTGGAAATGGATGCTT-1_Br2720_Ant_IF,3,0,4,0,0,7
TGATCGGTTTGACCCT-1_Br2720_Ant_IF,0,0,5,0,0,5
TAGAGTCTAAGCGAAC-1_Br2720_Ant_IF,0,0,3,0,0,3
GAGACTGATGGGTAGA-1_Br2720_Ant_IF,4,2,0,0,0,6
TAGCTAAGTCCGGGAG-1_Br2720_Ant_IF,0,0,1,0,0,1
GGGCGATATGTGTGAA-1_Br2720_Ant_IF,1,0,1,0,0,2
CTCGAGGTCGAACAGT-1_Br2720_Ant_IF,1,2,2,0,1,6
GATCCCTTTATACTGC-1_Br2720_Ant_IF,0,1,0,1,0,2
GTCATGCACCTCCGTT-1_Br2720_Ant_IF,2,1,3,0,0,6
ACTTTCCTATAGCTTC-1_Br2720_Ant_IF,0,0,0,0,0,0
TCGCTCGATATATTCC-1_Br2720_Ant_IF,0,0,4,1,0,5
ATAGGTTGGGCAGATG-1_Br2720_Ant_IF,2,0,1,0,0,3
CAATTAAGGGTGATGA-1_Br2720_Ant_IF,2,0,0,0,0,2
ACCGACTGAGTCCCAC-1_Br2720_Ant_IF,2,0,3,1,0,6
CCTGTCACCCGGGCTC-1_Br2720_Ant_IF,1,0,4,0,1,6
GATCGGTGGCCATAAC-1_Br2720_Ant_IF,0,1,1,0,0,2
CCTATGGGTTACCGTC-1_Br2720_Ant_IF,1,1,3,0,0,5
TTGGGACACTGCCCGC-1_Br2720_Ant_IF,1,0,1,0,0,2
CGAGGCTAAATATGGC-1_Br2720_Ant_IF,6,0,0,0,0,6
TCAGGGTGTAACGTAA-1_Br2720_Ant_IF,1,3,0,0,1,5
CGAGAGATGTGAACCT-1_Br2720_Ant_IF,2,1,0,0,0,3
TCGCTGGGCGGATTGT-1_Br2720_Ant_IF,4,0,0,0,0,4
AGATCTCAGGTGTGAT-1_Br2720_Ant_IF,4,0,2,0,0,6
TGGCCAAACTGAAGTA-1_Br2720_Ant_IF,2,0,6,0,0,8
GCTTCCGTCCCTAGAC-1_Br2720_Ant_IF,4,0,1,0,0,5
CAGCAGCCCGTTCCTT-1_Br2720_Ant_IF,2,0,2,0,0,4
TGTATAACAGATCCTG-1_Br2720_Ant_IF,1,0,1,0,0,2
CGCGGGAATTAGGCAG-1_Br2720_Ant_IF,5,0,1,0,0,6
TGCATGTGGTAATCTA-1_Br2720_Ant_IF,3,0,1,0,1,5
ACAATTTGAGCAGTGG-1_Br2720_Ant_IF,4,0,3,0,0,7
GAGCTAAGGGCATATC-1_Br2720_Ant_IF,2,0,3,0,0,5
CCAGATAGTTGAGTGA-1_Br2720_Ant_IF,3,0,0,0,1,4
CCACAATGTACGTCTT-1_Br2720_Ant_IF,3,0,2,0,0,5
CAATGGATCTCTACCA-1_Br2720_Ant_IF,4,0,1,0,0,5
TGTGGCAAAGCGTATG-1_Br2720_Ant_IF,0,0,2,0,0,2
TCCGTTTAGCCTTGAA-1_Br2720_Ant_IF,1,0,3,0,0,4
GGTGATGAAGGAAGTG-1_Br2720_Ant_IF,0,0,0,0,0,0
GCAACCCAAGTTGTTT-1_Br2720_Ant_IF,0,1,0,0,1,2
ATGAAGTGGACCCAGC-1_Br2720_Ant_IF,0,1,0,0,0,1
GAGAATCTCACGATCA-1_Br2720_Ant_IF,0,2,0,0,0,2
TATATCATTGATCAGT-1_Br2720_Ant_IF,0,2,0,0,0,2
AACTTTACGGGAGCTT-1_Br2720_Ant_IF,0,3,1,0,3,7
TTCTTGTGTCCATCAG-1_Br2720_Ant_IF,1,0,0,0,1,2
ACAATTTAGGAGGCTC-1_Br2720_Ant_IF,0,2,1,0,1,4
ATACTTGTTCTCGAGC-1_Br2720_Ant_IF,0,2,0,0,0,2
CACGGGATTGAGGGTT-1_Br2720_Ant_IF,0,1,0,0,1,2
GTTAATGTCTATCTTA-1_Br2720_Ant_IF,0,2,0,0,1,3
GCGTTATATTTGGAAC-1_Br2720_Ant_IF,1,0,0,0,0,1
CGTCAAGGCTATAAAT-1_Br2720_Ant_IF,0,3,0,0,0,3
TTAGCTCTGTAATCCG-1_Br2720_Ant_IF,1,1,0,0,1,3
AATGGTCCACCGTTCA-1_Br2720_Ant_IF,0,5,0,0,1,6
GTCATTGCATTGACCC-1_Br2720_Ant_IF,0,3,1,0,0,4
TGTCCGTGGCGCCTTT-1_Br2720_Ant_IF,0,3,2,0,0,5
TCAACTAACGTATAAC-1_Br2720_Ant_IF,1,0,1,0,0,2
TCCTCTCCAGTTGTCC-1_Br2720_Ant_IF,0,0,0,0,0,0
TGTGTTCGTATCCAAG-1_Br2720_Ant_IF,0,0,0,0,1,1
CCGCGTAGGTAAGGGC-1_Br2720_Ant_IF,0,1,0,0,2,3
CTGCGGGTGAAATGTT-1_Br2720_Ant_IF,0,0,0,0,0,0
TATCTACAGAGGTAAT-1_Br2720_Ant_IF,0,2,0,0,1,3
CTACTCTAGGCCCGGC-1_Br2720_Ant_IF,0,0,0,0,1,1
ACAAGCAGTGCCTAGC-1_Br2720_Ant_IF,1,1,0,0,1,3
TACAAGTCTCGTGCAT-1_Br2720_Ant_IF,0,3,0,0,0,3
TCGGAATGCGCTCTGA-1_Br2720_Ant_IF,1,3,3,0,1,8
TCGCGTCCAGAAGGTC-1_Br2720_Ant_IF,0,1,1,0,1,3
TATGGCCCGGCCTCGC-1_Br2720_Ant_IF,0,0,1,0,2,3
GCTGGCATATTCACCT-1_Br2720_Ant_IF,0,1,0,0,0,1
GTCAGAATAGTCTATG-1_Br2720_Ant_IF,2,0,1,0,0,3
GGCGTCCTATCCGCTG-1_Br2720_Ant_IF,0,1,1,0,0,2
CGGAGTTTGAGAGACA-1_Br2720_Ant_IF,0,2,1,0,0,3
AGCACTTAAGGACGCC-1_Br2720_Ant_IF,0,1,1,0,0,2
TCCACAATGGTTTACG-1_Br2720_Ant_IF,0,0,1,0,1,2
CCAACGATGCACTGAT-1_Br2720_Ant_IF,3,2,1,0,0,6
ATTTACAGTTTACTGG-1_Br2720_Ant_IF,2,1,3,0,1,7
CCCTGAAATGAGTTGA-1_Br2720_Ant_IF,0,0,0,0,0,0
CAAACGGTCGCACTTT-1_Br2720_Ant_IF,0,0,1,0,1,2
TGATTCGTCTATCACT-1_Br2720_Ant_IF,2,1,2,0,1,6
TCAGGTTCTTTGAGAA-1_Br2720_Ant_IF,3,1,0,0,0,4
CACGCAGCGAGGCTTT-1_Br2720_Ant_IF,0,1,0,0,2,3
TTAAGCGCCTGACCCA-1_Br2720_Ant_IF,0,1,0,0,0,1
CTTACACGGTATTCCA-1_Br2720_Ant_IF,0,0,0,0,1,1
AAGGCTGTGCTCATCG-1_Br2720_Ant_IF,0,3,0,0,0,3
GACCAGAGCCCTGTAG-1_Br2720_Ant_IF,1,0,1,0,0,2
TCCCAGGCTTAGCTAA-1_Br2720_Ant_IF,0,0,1,0,0,1
ATTGAAGATCTTAGTG-1_Br2720_Ant_IF,0,3,3,0,3,9
AGTTCCTACAGAATTA-1_Br2720_Ant_IF,0,3,0,0,0,3
GGGCTGGTTAGTCGCG-1_Br2720_Ant_IF,0,1,0,0,0,1
GAAATGGCGGTGTTAG-1_Br2720_Ant_IF,0,1,0,0,0,1
TACGAACACGACTTCA-1_Br2720_Ant_IF,0,0,0,0,0,0
ACCACAAGTTTCTATC-1_Br2720_Ant_IF,1,2,0,0,0,3
ATATTTAACCCTCAAG-1_Br2720_Ant_IF,0,0,0,1,0,1
GATCATTCCAAACATT-1_Br2720_Ant_IF,0,2,1,0,0,3
TCCAGGCGAGTACGGT-1_Br2720_Ant_IF,1,1,2,0,0,4
GTTTGACCAAATCCTA-1_Br2720_Ant_IF,2,2,0,0,0,4
CACAGCACCCACGGCA-1_Br2720_Ant_IF,2,2,4,0,0,8
TGCAAGAATGACGTAA-1_Br2720_Ant_IF,1,0,2,0,0,3
GCGAAGCCATACCCGT-1_Br2720_Ant_IF,3,0,1,0,0,4
TCCTTTCTTACGCTTA-1_Br2720_Ant_IF,1,1,2,0,0,4
GCTGCTCTCCGGACAC-1_Br2720_Ant_IF,2,0,1,0,0,3
ACTGTCTTCTTTAGAA-1_Br2720_Ant_IF,3,0,3,0,1,7
TCAAACTTAGATTGTT-1_Br2720_Ant_IF,1,1,1,0,0,3
CTATGTCACTAGCCCA-1_Br2720_Ant_IF,1,2,1,1,1,6
TGCGCAAAGCATTTGG-1_Br2720_Ant_IF,6,0,2,0,0,8
TTAATGTAGACCAGGT-1_Br2720_Ant_IF,1,0,2,0,0,3
GGCGGTAGGATCATTG-1_Br2720_Ant_IF,0,0,0,0,0,0
GGCAATAGTCAATGAG-1_Br2720_Ant_IF,0,1,5,0,0,6
ACACGAGACTCCTTCT-1_Br2720_Ant_IF,3,1,0,3,0,7
GACACAAGGGAAGAAA-1_Br2720_Ant_IF,3,1,1,1,1,7
TCAGCAAATGCATCTC-1_Br2720_Ant_IF,2,2,4,0,0,8
GAGATCTGTCACTCCG-1_Br2720_Ant_IF,2,2,0,0,0,4
ATGCCGGTCTTGCATA-1_Br2720_Ant_IF,1,0,0,0,0,1
TTGGGCGGCGGTTGCC-1_Br2720_Ant_IF,1,0,3,1,0,5
TTGTTGTGTGTCAAGA-1_Br2720_Ant_IF,6,1,1,0,0,8
ACTGTACGATACACAT-1_Br2720_Ant_IF,6,0,1,0,0,7
TCCACTTTATCTAGGT-1_Br2720_Ant_IF,3,0,1,0,0,4
GGTCTGAGAATCTGGA-1_Br2720_Ant_IF,2,1,2,0,0,5
TAGAAAGGTGGCGCTA-1_Br2720_Ant_IF,5,0,1,0,0,6
TATGTCTCATTGTGCC-1_Br2720_Ant_IF,2,0,0,0,0,2
GGATTTCACTTCTATA-1_Br2720_Ant_IF,5,0,0,0,0,5
TGAGTGGTCCGTGACG-1_Br2720_Ant_IF,6,0,2,1,0,9
CGCTTTCTTGCATTCG-1_Br2720_Ant_IF,3,0,0,0,0,3
ACCCAACGCCCGTGGC-1_Br2720_Ant_IF,3,0,0,0,0,3
GAACGTCTCATGGTCG-1_Br2720_Ant_IF,4,1,0,1,1,7
AGGGTTCCCTTTGGTT-1_Br2720_Ant_IF,1,0,1,0,2,4
GTAGCTTCCTCTTGTT-1_Br2720_Ant_IF,5,0,2,3,1,11
GCATGAGGGACGCGGC-1_Br2720_Ant_IF,4,2,0,0,1,7
CTACCCTAAGGTCATA-1_Br2720_Ant_IF,6,1,0,0,0,7
TCACCGCTCGGCACTC-1_Br2720_Ant_IF,0,3,0,0,0,3
GGCTCGCGTTGAGGTA-1_Br2720_Ant_IF,1,0,0,0,0,1
CCATACTCGCCTCTCC-1_Br2720_Ant_IF,1,0,0,0,1,2
ACGATACCTATCCTGA-1_Br2720_Ant_IF,0,3,0,0,0,3
CTCACCAGTACAAGTG-1_Br2720_Ant_IF,0,3,1,0,0,4
CGAAGACGGTGAGTGC-1_Br2720_Ant_IF,0,2,0,0,1,3
AAATTAATAAGCGCGA-1_Br2720_Ant_IF,0,2,0,0,0,2
GGGCCCTTATCTATAC-1_Br2720_Ant_IF,0,2,0,0,2,4
CTGCCCACGAAGCGTT-1_Br2720_Ant_IF,0,2,1,0,2,5
GGACAAGTTGCAGTGA-1_Br2720_Ant_IF,1,5,0,0,2,8
GTCCGAGAGCAATCAT-1_Br2720_Ant_IF,0,1,0,0,0,1
ATGGCAGCCGAGAAAC-1_Br2720_Ant_IF,0,2,1,0,1,4
CCTCGGATGCTACCTG-1_Br2720_Ant_IF,0,1,0,0,2,3
ATACGGTGAAGATGCA-1_Br2720_Ant_IF,1,3,0,0,3,7
ACATCAGCTGGGACGC-1_Br2720_Ant_IF,0,1,2,0,1,4
GGTTGTGTAGCCTGGC-1_Br2720_Ant_IF,0,0,0,0,3,3
CCTGCGTTCTACGCTT-1_Br2720_Ant_IF,1,1,1,0,0,3
GAACGTTAGGAAGACG-1_Br2720_Ant_IF,0,2,0,0,0,2
CTGATAGTGTATCTCA-1_Br2720_Ant_IF,0,3,3,0,0,6
TTCTGCGAGCGCCCTT-1_Br2720_Ant_IF,1,1,1,0,0,3
CTTTGGCGCTTTATAC-1_Br2720_Ant_IF,0,1,2,0,0,3
TCCGAACTTGGCTTAC-1_Br2720_Ant_IF,1,2,0,0,0,3
TAGATTCCTGGTTATT-1_Br2720_Ant_IF,0,1,0,0,0,1
CCGACAAAGGGAGTGC-1_Br2720_Ant_IF,0,2,0,0,0,2
CCATGGCCCTTGTACC-1_Br2720_Ant_IF,0,1,1,0,0,2
GAAATATCACCATCAG-1_Br2720_Ant_IF,0,0,0,0,1,1
ACGAAATGGGCGGCAC-1_Br2720_Ant_IF,0,2,1,0,0,3
GTGAGCGTGCTGCACT-1_Br2720_Ant_IF,1,1,0,0,1,3
CCGCGGGTACGAAGAA-1_Br2720_Ant_IF,0,1,0,0,0,1
TCCCTGGCTCGCTGGA-1_Br2720_Ant_IF,1,3,2,0,0,6
CAGCTTAGTAGGTAGC-1_Br2720_Ant_IF,0,1,0,0,1,2
CACGAAAGTTAGTCCC-1_Br2720_Ant_IF,1,3,2,0,0,6
ACCTAATCGACTTCCT-1_Br2720_Ant_IF,1,1,1,0,0,3
AAGTAGTGACGCGAGG-1_Br2720_Ant_IF,0,2,0,0,1,3
TCCGATTACATTGCCG-1_Br2720_Ant_IF,1,0,1,0,0,2
CCTCCGACAATTCAAG-1_Br2720_Ant_IF,2,0,0,0,0,2
GTTCACAGGAGTCTAG-1_Br2720_Ant_IF,2,0,0,0,0,2
CGAAGTTGCTCTGTGT-1_Br2720_Ant_IF,2,0,1,0,1,4
GTCGGATATCTCAGAC-1_Br2720_Ant_IF,0,1,0,0,1,2
CGCTCTCCGTAGATTA-1_Br2720_Ant_IF,0,1,0,0,0,1
CAAGCAACGTCGGAGT-1_Br2720_Ant_IF,0,0,0,0,2,2
CCATTCCCTGCCCACA-1_Br2720_Ant_IF,0,0,0,0,1,1
CTTTGGCTTTAGTAAA-1_Br2720_Ant_IF,0,1,0,0,0,1
GGCTATTAAGTTGTAT-1_Br2720_Ant_IF,3,1,0,0,1,5
CCATTAGCGATAATCC-1_Br2720_Ant_IF,0,1,0,0,1,2
TGTTCTTCCATTGACT-1_Br2720_Ant_IF,0,0,1,0,1,2
AGATAACTTCAGGGCC-1_Br2720_Ant_IF,2,0,0,0,1,3
ATAGACGAAGAGAAAG-1_Br2720_Ant_IF,2,0,3,0,1,6
GGCGGAGTAATATTAG-1_Br2720_Ant_IF,0,1,0,0,0,1
TGACCCACGTTAGACA-1_Br2720_Ant_IF,1,0,1,0,1,3
TCACAGGTTATTGGGC-1_Br2720_Ant_IF,0,0,0,0,1,1
TCACGCATTGTAGATC-1_Br2720_Ant_IF,0,0,0,0,1,1
TTGAAGAATTCCCAGG-1_Br2720_Ant_IF,0,0,0,0,0,0
AAATGGTCAATGTGCC-1_Br2720_Ant_IF,1,0,1,0,0,2
TAGTGCCCTCCAGAGT-1_Br2720_Ant_IF,2,1,0,0,0,3
GGTATTGCCGAGTTTA-1_Br2720_Ant_IF,2,1,2,0,1,6
CGTATTAAGAGATCTA-1_Br2720_Ant_IF,3,1,0,0,0,4
ACTGTCCAGGATTATA-1_Br2720_Ant_IF,6,0,3,0,0,9
CGGGCAGCTAAACCGC-1_Br2720_Ant_IF,4,0,2,0,0,6
TTGCTGATCATGTTCG-1_Br2720_Ant_IF,2,0,4,0,0,6
TATGGGTACGTATCGT-1_Br2720_Ant_IF,0,0,5,0,0,5
CAGCTCACTGAGACAT-1_Br2720_Ant_IF,3,1,1,0,0,5
GGGACTGCATAGATAG-1_Br2720_Ant_IF,2,0,1,0,0,3
ACGCATTCGTGAGTAC-1_Br2720_Ant_IF,1,1,4,0,0,6
CTCTGGACGCCTGGTG-1_Br2720_Ant_IF,5,1,4,0,0,10
AGGGTTTAGTTCGGGA-1_Br2720_Ant_IF,2,1,1,0,0,4
GGGAGAACTCACAGTA-1_Br2720_Ant_IF,3,0,0,1,0,4
ATCAATCTGGGCTGCA-1_Br2720_Ant_IF,0,1,6,0,0,7
TCTTCGATACCAATAA-1_Br2720_Ant_IF,3,0,2,0,0,5
ACGTAGATTGCTGATG-1_Br2720_Ant_IF,3,1,0,1,0,5
TCTTGATGCGTAGCGA-1_Br2720_Ant_IF,3,1,1,0,0,5
GGGCTGCCTAGGGCGA-1_Br2720_Ant_IF,2,0,0,0,0,2
CTCTCACAATCGATGA-1_Br2720_Ant_IF,7,0,1,1,0,9
CCAAGCGTAACTCGTA-1_Br2720_Ant_IF,5,0,0,0,0,5
ACAACAGCATGAGCTA-1_Br2720_Ant_IF,1,0,0,0,0,1
GTCCCAACGTAAAGTA-1_Br2720_Ant_IF,2,0,0,0,0,2
TCGGAGTACATGAGTA-1_Br2720_Ant_IF,3,0,0,0,0,3
GGGAGTTAATGAGGCG-1_Br2720_Ant_IF,0,0,3,0,0,3
CCGGGCGGTCTCGTCA-1_Br2720_Ant_IF,4,0,0,0,0,4
CCGTAAGTTGGTCCCA-1_Br2720_Ant_IF,6,0,0,0,0,6
GGAGGGCTTGGTTGGC-1_Br2720_Ant_IF,3,2,0,0,0,5
TCGGACGCCCAGCCCA-1_Br2720_Ant_IF,8,0,0,0,0,8
TCTGTGCCATCATAGT-1_Br2720_Ant_IF,5,0,1,0,1,7
GTACTGGAGTTAGACC-1_Br2720_Ant_IF,6,0,0,0,0,6
GGAATGCGCTAGCGTG-1_Br2720_Ant_IF,7,0,0,0,0,7
GTGTGAATAACTTAGG-1_Br2720_Ant_IF,4,0,0,0,0,4
GGTCGGCCAGGAGCTT-1_Br2720_Ant_IF,3,0,0,1,0,4
TAGCCGGCGGTCAGCG-1_Br2720_Ant_IF,9,1,1,2,1,14
CGGGTGTACCCATTTA-1_Br2720_Ant_IF,2,0,0,0,0,2
AGTGATTCAAGCAGGA-1_Br2720_Ant_IF,9,0,0,1,0,10
GTTGGATTGAGAACAC-1_Br2720_Ant_IF,3,0,1,0,0,4
CACACGCGCTGTCTTA-1_Br2720_Ant_IF,4,10,0,1,0,15
TAGACGCCCGTACCGG-1_Br2720_Ant_IF,6,0,0,0,0,6
GGTTTCAATCGGTCAG-1_Br2720_Ant_IF,4,0,0,1,0,5
AATCTGCGTTGGGACG-1_Br2720_Ant_IF,6,0,0,0,0,6
TTACGGATGGTTCGAG-1_Br2720_Ant_IF,3,0,0,0,0,3
CGGCAGGGTCGGGTTG-1_Br2720_Ant_IF,5,0,0,0,0,5
GCTTTCAGAGGAGGTG-1_Br2720_Ant_IF,6,2,0,1,0,9
TCTTCCCATGGGCACA-1_Br2720_Ant_IF,0,2,0,0,0,2
TACCGCGGACTTGCAG-1_Br2720_Ant_IF,0,0,0,0,0,0
GGTATGAAAGAACTGA-1_Br2720_Ant_IF,0,2,0,0,2,4
GTGGCCTAATATCATT-1_Br2720_Ant_IF,0,0,0,0,0,0
CCTGTGAAACCGTAAC-1_Br2720_Ant_IF,0,2,1,0,0,3
GGCAGAGAGATCGGGA-1_Br2720_Ant_IF,0,2,0,0,0,2
TAGCGTCGAATATTGA-1_Br2720_Ant_IF,0,1,0,0,1,2
CGCCGACTATTCGCTA-1_Br2720_Ant_IF,2,2,0,0,0,4
TCTGGCGCAAGCCGGG-1_Br2720_Ant_IF,0,2,0,0,1,3
AGTGGTTGCGTATAGG-1_Br2720_Ant_IF,0,4,2,0,0,6
ATCGGTTACCTAGTAA-1_Br2720_Ant_IF,0,4,0,0,1,5
CCTGCCCGTTGTCTAG-1_Br2720_Ant_IF,0,1,0,0,3,4
GCACACGCCCATGGTC-1_Br2720_Ant_IF,0,1,0,0,1,2
AGTACGGCCCGTATCG-1_Br2720_Ant_IF,0,1,0,0,1,2
TATCTAGCCTAAAGGA-1_Br2720_Ant_IF,1,0,0,0,2,3
CACTCGGTTAGGAGGA-1_Br2720_Ant_IF,2,0,0,0,2,4
ATGTTCGTCGACCCAC-1_Br2720_Ant_IF,1,1,0,0,0,2
TTCCTCTGCCCGAATA-1_Br2720_Ant_IF,0,1,0,0,0,1
TTACTATCGGCTTCTC-1_Br2720_Ant_IF,0,1,0,0,1,2
GCCGCATTAGTCCGGC-1_Br2720_Ant_IF,0,2,1,0,0,3
TAAGGGCTGGGAGAGG-1_Br2720_Ant_IF,1,0,0,0,0,1
TAAGCAGGCGACACGC-1_Br2720_Ant_IF,0,1,0,0,0,1
AGCACTACCGGCCTGT-1_Br2720_Ant_IF,0,1,0,0,0,1
GAAAGCCCTTTGGACC-1_Br2720_Ant_IF,0,1,0,0,1,2
GACCGACTGAAGCGTC-1_Br2720_Ant_IF,0,1,0,0,1,2
CGGTGAAGACTAAAGT-1_Br2720_Ant_IF,1,1,0,0,0,2
CCCTGCGCTACGCATA-1_Br2720_Ant_IF,0,1,0,0,0,1
TACTGGACAGCTCGGC-1_Br2720_Ant_IF,0,0,0,0,1,1
TTAGTAGGGCGGCGGG-1_Br2720_Ant_IF,0,1,2,0,0,3
GAGGCTATCAAAGTCG-1_Br2720_Ant_IF,0,1,3,0,1,5
TTACCATTGATTACCC-1_Br2720_Ant_IF,1,1,1,0,1,4
ATACCACGGGCAACTT-1_Br2720_Ant_IF,2,0,1,0,0,3
TGTCCTAAGTCACCGC-1_Br2720_Ant_IF,0,2,1,0,1,4
AGGTAGGTACAAAGCT-1_Br2720_Ant_IF,2,0,0,0,0,2
GGCATACAGGTAGCGG-1_Br2720_Ant_IF,1,0,0,0,2,3
TGTAGTGATCTATAAT-1_Br2720_Ant_IF,2,0,0,0,2,4
TCCCGGGTGTGCTGCT-1_Br2720_Ant_IF,2,0,4,0,3,9
TACGATGTTGATCATC-1_Br2720_Ant_IF,4,0,0,0,0,4
CCTCTCTCCCATCTAG-1_Br2720_Ant_IF,2,1,1,0,2,6
GCAGGACTATAGAATA-1_Br2720_Ant_IF,2,2,0,0,2,6
CTAGTGAAGGACAGGA-1_Br2720_Ant_IF,3,0,3,0,0,6
TACGAGAACTTCACGT-1_Br2720_Ant_IF,1,1,1,0,1,4
CGTTGTTTCAATTCCC-1_Br2720_Ant_IF,4,0,0,0,4,8
GCAAATATTACGCTTT-1_Br2720_Ant_IF,0,0,0,0,2,2
CCAATAGTGCCGTCGA-1_Br2720_Ant_IF,1,0,2,0,3,6
ATTGCTGCTCCTCCAT-1_Br2720_Ant_IF,1,2,3,0,3,9
GAGATCTGCTTGGCAT-1_Br2720_Ant_IF,4,1,1,0,0,6
GCCGAAATTCCTACGT-1_Br2720_Ant_IF,0,1,0,0,0,1
GGCACTCCACTGGGCA-1_Br2720_Ant_IF,0,1,2,0,1,4
GGGTCACCGTGACGGT-1_Br2720_Ant_IF,1,0,0,0,1,2
CACTTAATCAGACGGA-1_Br2720_Ant_IF,2,1,0,0,0,3
CGTTTCGCTCATTACA-1_Br2720_Ant_IF,0,1,0,0,1,2
ATAAAGGCTCGGTCGT-1_Br2720_Ant_IF,2,1,1,0,0,4
CACTAAAGTTGCCTAT-1_Br2720_Ant_IF,1,1,3,1,0,6
GTGCTCAAGTACTGTC-1_Br2720_Ant_IF,1,1,2,0,0,4
CCATGCCTGTTTAGTA-1_Br2720_Ant_IF,0,1,2,0,1,4
TCTAGTTATCAGAAGA-1_Br2720_Ant_IF,6,0,2,0,0,8
TTGTAATCCGTACTCG-1_Br2720_Ant_IF,0,1,0,0,1,2
TCCCAGCTTTAGTCTG-1_Br2720_Ant_IF,1,1,2,0,1,5
CTACGCACGGAGTACC-1_Br2720_Ant_IF,1,1,0,0,0,2
AAATTAACGGGTAGCT-1_Br2720_Ant_IF,1,1,1,0,0,3
CGGCCACGCACAAAGT-1_Br2720_Ant_IF,4,0,0,0,0,4
GAAGCGTGAGGAATTT-1_Br2720_Ant_IF,1,0,2,0,1,4
ATATCTTAGGGCCTTC-1_Br2720_Ant_IF,1,4,1,0,0,6
ACGCGGGCCAAGGACA-1_Br2720_Ant_IF,1,0,0,0,0,1
GCGAGTTCTGCAAAGA-1_Br2720_Ant_IF,1,0,1,0,0,2
TATTCGTGCCAGAATA-1_Br2720_Ant_IF,3,2,1,0,0,6
AGGGCTGCAGTTACAG-1_Br2720_Ant_IF,2,2,0,0,0,4
CTAGCATAGTATAATG-1_Br2720_Ant_IF,1,2,1,0,0,4
TAGGTTCGAGTTCGTC-1_Br2720_Ant_IF,2,1,3,0,0,6
GAATTATAGTGAAAGG-1_Br2720_Ant_IF,2,0,2,0,0,4
CTATCGGGTCTCAACA-1_Br2720_Ant_IF,1,0,0,0,0,1
GCGCTAATTGAATAGA-1_Br2720_Ant_IF,5,2,0,0,0,7
ATGCGACAGTCCCATT-1_Br2720_Ant_IF,2,1,0,0,0,3
GGTAGTGCTCGCACCA-1_Br2720_Ant_IF,3,1,0,1,0,5
AAGCTCGTGCCAAGTC-1_Br2720_Ant_IF,1,2,0,0,1,4
TATTCAATTCTAATCC-1_Br2720_Ant_IF,0,0,1,0,1,2
TTCAAAGTCTCTAGCC-1_Br2720_Ant_IF,1,0,0,0,0,1
TTGAATATGGACTTTC-1_Br2720_Ant_IF,7,1,1,0,0,9
AAGAGCTCTTTATCGG-1_Br2720_Ant_IF,5,2,0,0,1,8
TTACTCCGGCCGGGAA-1_Br2720_Ant_IF,2,0,0,1,0,3
AAACGAGACGGTTGAT-1_Br2720_Ant_IF,3,1,0,0,0,4
GCTAAGTAGTTTCTCT-1_Br2720_Ant_IF,6,1,0,0,0,7
ATAACGCCGGAGGGTC-1_Br2720_Ant_IF,5,1,0,0,0,6
GGATCCGGAATATACT-1_Br2720_Ant_IF,4,0,1,0,0,5
TGAAAGGACCTGACTC-1_Br2720_Ant_IF,4,0,0,0,0,4
TCCGCGGCAGCATCTG-1_Br2720_Ant_IF,1,1,0,1,1,4
TGCATATGTCTGTCAC-1_Br2720_Ant_IF,8,1,2,0,0,11
TGTAGGAGAAATTTCC-1_Br2720_Ant_IF,4,0,2,0,0,6
AGTGAGACTTCCAGTA-1_Br2720_Ant_IF,1,0,0,0,0,1
CCCAAACATGCTGCTC-1_Br2720_Ant_IF,3,0,2,3,0,8
GCTTATGAAGCAGGAA-1_Br2720_Ant_IF,5,0,0,0,0,5
TTCTAACCGAAGCTTA-1_Br2720_Ant_IF,5,0,2,0,0,7
GGATGTCCTTACCGCA-1_Br2720_Ant_IF,5,0,0,0,0,5
AGGGTGCTCTCGAGGG-1_Br2720_Ant_IF,8,0,0,0,0,8
AACTCTCAATAGAGCG-1_Br2720_Ant_IF,1,1,0,0,0,2
TCTGAATTCCGTACAA-1_Br2720_Ant_IF,2,1,0,0,0,3
GCGTGGTACTGGGTTA-1_Br2720_Ant_IF,1,1,0,0,0,2
CGTCGGATAGTGTTGA-1_Br2720_Ant_IF,5,0,0,0,0,5
ATATGTCTCCCTAGCC-1_Br2720_Ant_IF,6,0,0,0,0,6
TCTTTAAGACTATGAA-1_Br2720_Ant_IF,0,0,3,2,0,5
TCATTTAAGTCTCCGA-1_Br2720_Ant_IF,2,0,1,0,1,4
GATATTGAGATTGGCG-1_Br2720_Ant_IF,0,0,0,0,0,0
TGACATCGAGCGGACC-1_Br2720_Ant_IF,0,2,0,0,0,2
CAAACCAGGTCTGCAT-1_Br2720_Ant_IF,1,2,1,0,0,4
ACAAGCTATATGGAAG-1_Br2720_Ant_IF,0,2,0,0,0,2
TCGCCCACTGCGAGAG-1_Br2720_Ant_IF,0,3,0,0,0,3
AGCCGCAAATTCAAAT-1_Br2720_Ant_IF,0,2,0,0,2,4
TTAACGTTAAAGCCTG-1_Br2720_Ant_IF,1,1,0,0,0,2
CAGCGCCAACACGATA-1_Br2720_Ant_IF,1,1,0,0,1,3
ATCCAATGGTACCGAA-1_Br2720_Ant_IF,1,0,1,0,0,2
GTGCTGCAGATAAGGA-1_Br2720_Ant_IF,0,0,0,0,1,1
GGCCTTTGCAACTGGC-1_Br2720_Ant_IF,0,1,1,0,1,3
GTCGTACCTACGATTG-1_Br2720_Ant_IF,2,2,1,0,0,5
TAGAAATTCACGTATA-1_Br2720_Ant_IF,0,2,1,0,2,5
AGAATAAATCTTCAGG-1_Br2720_Ant_IF,1,0,0,0,1,2
CATTGCGAAATGGGCG-1_Br2720_Ant_IF,0,2,0,0,0,2
GTCTACTCAATTACAA-1_Br2720_Ant_IF,2,2,1,0,2,7
TGTAATGACCACAATA-1_Br2720_Ant_IF,1,2,2,0,1,6
AAAGTCGACCCTCAGT-1_Br2720_Ant_IF,4,1,0,0,1,6
TACTCGGCACGCCGGG-1_Br2720_Ant_IF,1,2,0,0,0,3
AGGTGTATCGCCATGA-1_Br2720_Ant_IF,3,1,1,0,4,9
TGTGCTTTACGTAAGA-1_Br2720_Ant_IF,0,4,2,0,1,7
AAACCTCATGAAGTTG-1_Br2720_Ant_IF,4,0,0,0,4,8
TATAGGGTACTCATGA-1_Br2720_Ant_IF,0,4,0,0,0,4
CCAGCTGATGGTACTT-1_Br2720_Ant_IF,4,0,2,0,4,10
AATATTGGAGTATTGA-1_Br2720_Ant_IF,2,2,0,0,1,5
GGCCCTCACCCACTTA-1_Br2720_Ant_IF,0,0,1,0,1,2
AACCAAGACTTCTCTG-1_Br2720_Ant_IF,3,0,1,0,0,4
TCGTATTACCCATTGC-1_Br2720_Ant_IF,1,0,0,0,0,1
ATTCGACGCCGGGCCT-1_Br2720_Ant_IF,2,0,2,0,1,5
GGCGCAGGACATCTTC-1_Br2720_Ant_IF,0,1,0,0,0,1
GTACTCCCTTATCGCT-1_Br2720_Ant_IF,6,1,0,0,0,7
TGGTCTGTTGGGCGTA-1_Br2720_Ant_IF,1,2,0,0,0,3
AATAACAACGCTCGGC-1_Br2720_Ant_IF,1,1,0,0,0,2
CATACCCGTACCCAGT-1_Br2720_Ant_IF,3,1,1,0,0,5
ACAATCCATTTAAACC-1_Br2720_Ant_IF,0,1,2,0,0,3
GTTACAATTGGTGACG-1_Br2720_Ant_IF,0,0,1,0,1,2
TTGCCCTGATCACGGG-1_Br2720_Ant_IF,0,2,0,0,1,3
CTAACCGCGCGCCCGT-1_Br2720_Ant_IF,0,2,1,0,1,4
CTAAAGAATGCCTACT-1_Br2720_Ant_IF,0,0,1,0,1,2
ACCCATCTTGAGGGTA-1_Br2720_Ant_IF,0,0,0,0,0,0
GATCTTTGCAGGGTAT-1_Br2720_Ant_IF,0,1,0,0,0,1
GGGTACTTCATGAACT-1_Br2720_Ant_IF,0,1,0,0,0,1
GCCGCTTGTGAGAAAC-1_Br2720_Ant_IF,0,0,0,0,0,0
CCTGTAAGACATGATA-1_Br2720_Ant_IF,0,0,0,0,2,2
CGACAGTTCGCGTTAT-1_Br2720_Ant_IF,0,0,0,0,0,0
ACGATGCATATGTTAT-1_Br2720_Ant_IF,0,1,4,0,1,6
TGTTCCGCTTCCATGA-1_Br2720_Ant_IF,0,0,4,0,0,4
GGATGACGCGAGTTTA-1_Br2720_Ant_IF,0,0,3,0,1,4
GAAGTTTCCACTCAAT-1_Br2720_Ant_IF,1,0,1,0,1,3
GCGAGGCCCGAGCAGA-1_Br2720_Ant_IF,1,0,1,0,2,4
CATACTATGTAATTGT-1_Br2720_Ant_IF,0,1,1,0,2,4
CCAATGTCACAGCAAG-1_Br2720_Ant_IF,0,1,0,0,0,1
GTTGGATTTGCGTTGG-1_Br2720_Ant_IF,1,0,2,0,1,4
GGGAGGATGCCCGAAA-1_Br2720_Ant_IF,2,1,0,0,0,3
GATCGCGGGCTCTCCA-1_Br2720_Ant_IF,2,0,2,0,0,4
GTTCGCCATAAGTGCC-1_Br2720_Ant_IF,2,2,0,0,1,5
AGATTATAGGACGTTT-1_Br2720_Ant_IF,1,0,0,0,0,1
TCGAGACCAACACCGT-1_Br2720_Ant_IF,1,1,0,0,1,3
TATGGGACCGAGCAGG-1_Br2720_Ant_IF,3,1,0,0,1,5
GATGCGTCCTGCATTC-1_Br2720_Ant_IF,0,2,2,0,0,4
TATGGTCTGAGTAACA-1_Br2720_Ant_IF,1,1,1,0,1,4
GCATAGAGCACTCAGG-1_Br2720_Ant_IF,3,0,3,0,0,6
CTTCATTGTCAGTGGA-1_Br2720_Ant_IF,1,1,0,0,1,3
GCAGATTAGGGATATC-1_Br2720_Ant_IF,0,0,0,0,0,0
CCTGTCGCCCGTAAAT-1_Br2720_Ant_IF,3,2,2,0,0,7
CAATTTCGTATAAGGG-1_Br2720_Ant_IF,0,0,2,0,2,4
GTACACTTACCTGAAG-1_Br2720_Ant_IF,1,1,0,0,0,2
CCAGCCTGGACCAATA-1_Br2720_Ant_IF,1,0,2,0,1,4
ATGGAGCAGGCCGTGA-1_Br2720_Ant_IF,3,0,0,0,0,3
GTCATTAGAGCGAACG-1_Br2720_Ant_IF,0,2,1,0,0,3
AAGACTGCAAGCTACT-1_Br2720_Ant_IF,1,1,2,0,1,5
CTAGTCACGTCTTAAG-1_Br2720_Ant_IF,3,0,1,0,0,4
ACTCTTGTATAGTAAC-1_Br2720_Ant_IF,6,0,0,0,0,6
ATTAGGCGATGCTTTC-1_Br2720_Ant_IF,2,1,0,0,0,3
TTCGGGACTAATCGCG-1_Br2720_Ant_IF,4,0,0,0,0,4
TGGACTGTTCGCTCAA-1_Br2720_Ant_IF,2,2,0,0,0,4
AACGTGCGAAAGTCTC-1_Br2720_Ant_IF,6,0,0,0,0,6
CCACCCAAGGAAAGTG-1_Br2720_Ant_IF,5,2,2,0,0,9
CCGCACAAAGACCAAC-1_Br2720_Ant_IF,4,1,1,0,0,6
GCGATTGTTAACGTTA-1_Br2720_Ant_IF,2,0,0,0,1,3
ACTCGTCAGTAATCCC-1_Br2720_Ant_IF,5,0,0,0,0,5
GGTGATAAGGAGCAGT-1_Br2720_Ant_IF,3,2,1,0,0,6
AAGAGGCATGGATCGC-1_Br2720_Ant_IF,5,0,0,0,0,5
CACGTTCGTGCTCTAG-1_Br2720_Ant_IF,1,0,0,0,0,1
CTATTTGGTTACGGAT-1_Br2720_Ant_IF,0,2,0,0,0,2
GTACAGAGGCAAGGGT-1_Br2720_Ant_IF,2,0,0,0,0,2
GGGCCGGCCGAAGTAC-1_Br2720_Ant_IF,5,1,3,0,0,9
CCTGAACGATATATTC-1_Br2720_Ant_IF,4,0,0,1,0,5
CCGGGCTGCTCCATAC-1_Br2720_Ant_IF,4,0,1,0,1,6
TACTTGTTAGTAGTCC-1_Br2720_Ant_IF,2,0,0,0,0,2
CCTAGGCGTAGCGATC-1_Br2720_Ant_IF,2,0,0,0,0,2
CTGGCGCACAGGTCTG-1_Br2720_Ant_IF,0,0,0,1,0,1
ACTTATACTTACCCGG-1_Br2720_Ant_IF,0,0,0,0,0,0
GAAGTCTCCCTAGCGA-1_Br2720_Ant_IF,7,0,0,0,0,7
ACCGATGGTAGCATCG-1_Br2720_Ant_IF,6,0,0,0,0,6
CGAGTTTATCGGACTG-1_Br2720_Ant_IF,2,0,0,0,0,2
CATAACGGACAGTCGT-1_Br2720_Ant_IF,7,0,0,0,0,7
TGACGATGCACTAGAA-1_Br2720_Ant_IF,5,0,0,0,0,5
TAGGGAGCTTGGGATG-1_Br2720_Ant_IF,1,0,0,0,0,1
AGGGTCGATGCGAACT-1_Br2720_Ant_IF,1,0,1,0,1,3
TATATCCCTGGGAGGA-1_Br2720_Ant_IF,2,0,1,0,0,3
CATCTTACACCACCTC-1_Br2720_Ant_IF,2,1,0,1,1,5
GTGCGACAGGGAGTGT-1_Br2720_Ant_IF,2,0,0,0,0,2
CCGATCTCAACCTTAT-1_Br2720_Ant_IF,6,1,1,0,0,8
ACGATCATCTTGTAAA-1_Br2720_Ant_IF,4,0,2,1,0,7
GAAAGAACAGCGTTAT-1_Br2720_Ant_IF,1,0,3,0,0,4
ATATCAACCTACAGAG-1_Br2720_Ant_IF,0,2,0,0,0,2
ACAGGTGTGTTGTTGC-1_Br2720_Ant_IF,0,1,0,0,0,1
TGAACTGCTATGACTT-1_Br2720_Ant_IF,0,0,0,0,1,1
TGACATATATGACGAT-1_Br2720_Ant_IF,1,1,1,0,2,5
AAGTCTTCTGTGGCCT-1_Br2720_Ant_IF,0,3,0,0,0,3
ACCAGACCATAACAAC-1_Br2720_Ant_IF,0,1,0,0,0,1
TGAGACGTACCTCTCA-1_Br2720_Ant_IF,1,5,2,0,1,9
GACCGTTACATGCGAC-1_Br2720_Ant_IF,0,0,0,0,2,2
GGTTCGGATTATACTA-1_Br2720_Ant_IF,0,1,1,0,1,3
CCTCCTGAGCCCACAT-1_Br2720_Ant_IF,1,1,1,0,1,4
CCGCGATTTGGTAGGT-1_Br2720_Ant_IF,0,3,0,0,1,4
AATCTCTACTGTGGTT-1_Br2720_Ant_IF,0,2,1,0,1,4
ACTTTGACTGCATCCT-1_Br2720_Ant_IF,3,0,0,0,2,5
CCCTGACTAACAAATT-1_Br2720_Ant_IF,2,3,0,0,0,5
ACGCTGTGAGGCGTAG-1_Br2720_Ant_IF,5,2,1,0,2,10
GCATACGAGGTCTTTA-1_Br2720_Ant_IF,5,0,1,0,4,10
TCGGGATTCAAACATA-1_Br2720_Ant_IF,0,1,0,0,0,1
GGGCCCTACGAAAGGG-1_Br2720_Ant_IF,3,2,0,0,1,6
CGCCAAGAAGCCGAGT-1_Br2720_Ant_IF,0,3,0,0,0,3
GGTACATCTGGGACGA-1_Br2720_Ant_IF,3,0,0,0,2,5
GGATGCTGGCGTTCCT-1_Br2720_Ant_IF,1,0,3,0,2,6
CCGATTCGAGGGACCC-1_Br2720_Ant_IF,0,1,2,0,2,5
CCACTGGTGGCTGGTT-1_Br2720_Ant_IF,0,0,2,0,1,3
GACAGGCACACACTAT-1_Br2720_Ant_IF,0,0,1,0,1,2
TCAACGCGACCGGCAG-1_Br2720_Ant_IF,0,0,0,0,1,1
CTACGACTAGCTATAA-1_Br2720_Ant_IF,1,0,0,0,1,2
CGGTTGACCTGGCATA-1_Br2720_Ant_IF,0,0,0,0,1,1
ATCCTGAATCGCTGCG-1_Br2720_Ant_IF,1,1,0,0,0,2
GTTTCATATCGTCGCT-1_Br2720_Ant_IF,4,2,3,0,0,9
ATAAATATTAGCAGCT-1_Br2720_Ant_IF,0,0,0,0,1,1
AAGAGGATGTACGCGA-1_Br2720_Ant_IF,1,2,0,0,0,3
TCCTGCGTTGATACTC-1_Br2720_Ant_IF,1,4,0,0,0,5
CGTGCATTGTCGACGC-1_Br2720_Ant_IF,0,3,0,0,0,3
CCGGGTTCGAGGTTAC-1_Br2720_Ant_IF,0,3,0,0,1,4
CCCAATTTCACAACTT-1_Br2720_Ant_IF,0,0,0,0,0,0
TGATTTATTAGCTGTG-1_Br2720_Ant_IF,0,3,0,0,1,4
TGGAAGAAGGGAACGT-1_Br2720_Ant_IF,0,2,1,0,0,3
GACGCTTGCTTCTAAA-1_Br2720_Ant_IF,0,4,0,0,0,4
GGGAACGGGAGGTTAG-1_Br2720_Ant_IF,1,2,0,0,0,3
GCGGCTCTGACGTACC-1_Br2720_Ant_IF,1,1,0,0,0,2
ACGTTAGATTTGCCCG-1_Br2720_Ant_IF,0,1,0,0,0,1
GAGAGGGCGCGAGGTT-1_Br2720_Ant_IF,2,2,1,0,1,6
GCGTCTCTGCATTGGG-1_Br2720_Ant_IF,0,1,0,0,1,2
GCAGCACACAGCCCAG-1_Br2720_Ant_IF,0,3,0,0,0,3
CAGGCCGTTTGGGTGT-1_Br2720_Ant_IF,0,1,0,0,1,2
AACTCAAGTTAATTGC-1_Br2720_Ant_IF,1,1,4,0,1,7
CTTCGTAGATAGGTGA-1_Br2720_Ant_IF,0,0,0,0,0,0
TGCAGAGTACCGAGCA-1_Br2720_Ant_IF,0,0,0,1,0,1
GAAGTGATTTATCGTG-1_Br2720_Ant_IF,0,0,0,0,0,0
CGCTACGGGACATTTA-1_Br2720_Ant_IF,1,0,0,0,2,3
CCACACTGAGATATTA-1_Br2720_Ant_IF,0,0,0,0,2,2
CGATCCGACCCAGTGC-1_Br2720_Ant_IF,2,1,1,0,2,6
CTGTACTTCTTAGCAT-1_Br2720_Ant_IF,0,0,4,0,0,4
ACTTATTAGGATCGGT-1_Br2720_Ant_IF,1,2,1,0,1,5
TAGTCCGCAGAGAATG-1_Br2720_Ant_IF,0,0,3,0,2,5
TTCACGAAAGGATCAC-1_Br2720_Ant_IF,0,0,2,0,0,2
TACATTTCTAACGTGC-1_Br2720_Ant_IF,0,1,1,0,0,2
ACCATATCCGCAATAA-1_Br2720_Ant_IF,0,2,0,0,0,2
CACTCAAGAGCTATGG-1_Br2720_Ant_IF,0,0,0,0,1,1
TGTACGAACAAATCCG-1_Br2720_Ant_IF,0,2,0,0,0,2
ATCATCCAATATTTGT-1_Br2720_Ant_IF,0,2,0,0,1,3
CGCTATTCTTAGGCTC-1_Br2720_Ant_IF,1,0,1,0,1,3
TGGCAGCAGTAATAGT-1_Br2720_Ant_IF,0,1,0,0,0,1
TCACGTGCCCGATTCA-1_Br2720_Ant_IF,0,1,1,0,0,2
CATACGGCGTCTGGGC-1_Br2720_Ant_IF,1,1,0,0,0,2
CACATGATTCAGCAAC-1_Br2720_Ant_IF,2,0,4,1,0,7
GCTAGTAGAGCTTGTA-1_Br2720_Ant_IF,2,2,0,0,0,4
TGCTGTTGAAGAACTC-1_Br2720_Ant_IF,2,0,0,1,2,5
CGGAGCATGGCGATCC-1_Br2720_Ant_IF,0,2,2,0,0,4
TAGCGTTGGGTCTTAC-1_Br2720_Ant_IF,2,1,1,0,0,4
GTAGCGGCTATACACT-1_Br2720_Ant_IF,0,2,0,0,1,3
TAACATACAATGTGGG-1_Br2720_Ant_IF,0,0,0,0,0,0
TCTTCGAATAGACGTT-1_Br2720_Ant_IF,2,2,2,1,0,7
GATCGTGACTGATATC-1_Br2720_Ant_IF,1,2,0,0,0,3
GATCCGGGAATTAACA-1_Br2720_Ant_IF,3,1,0,0,0,4
TTATATACGCTGTCAC-1_Br2720_Ant_IF,2,1,0,1,0,4
GTCGCGTAACCCGTTG-1_Br2720_Ant_IF,4,0,0,0,0,4
AGCTCTAGACGTTCCA-1_Br2720_Ant_IF,1,0,0,1,0,2
GTCAAGCGGACTCGGG-1_Br2720_Ant_IF,5,1,0,1,1,8
CGAGGGACTGCGGTCG-1_Br2720_Ant_IF,3,2,0,0,0,5
AATCGCCTCAGCGCCA-1_Br2720_Ant_IF,4,0,0,0,0,4
CTTGTTGCTGAGTCAA-1_Br2720_Ant_IF,4,2,0,0,0,6
GATATGAGACACTAAC-1_Br2720_Ant_IF,1,0,2,0,0,3
TTATGATCTTAACGAA-1_Br2720_Ant_IF,2,0,0,1,0,3
CGCCGCCCATGCCTGT-1_Br2720_Ant_IF,3,0,0,0,1,4
CTGGGATAAATAATGG-1_Br2720_Ant_IF,0,0,0,0,1,1
GTGCCCGTTCGGATTC-1_Br2720_Ant_IF,1,0,0,0,0,1
TTCAATACTCTGAATC-1_Br2720_Ant_IF,6,0,0,1,0,7
CGCACATGTCCACTAC-1_Br2720_Ant_IF,3,0,0,2,1,6
AGAAGAGCGCCGTTCC-1_Br2720_Ant_IF,7,0,0,0,0,7
GATAACTCGCACTGTG-1_Br2720_Ant_IF,1,0,0,0,0,1
AGTCGACGGTCTCAAG-1_Br2720_Ant_IF,6,0,1,0,0,7
GTGACCGCACACTACG-1_Br2720_Ant_IF,8,0,0,0,0,8
GTATGTGGGTCTAGTT-1_Br2720_Ant_IF,1,0,0,0,1,2
CTTGAGTTAGGGTAAT-1_Br2720_Ant_IF,3,2,1,0,0,6
TTAGCTGATTTGCCGT-1_Br2720_Ant_IF,4,0,0,2,0,6
GCTGTTGCTACCGAAC-1_Br2720_Ant_IF,2,1,0,0,0,3
TATTACCATCCTGCTT-1_Br2720_Ant_IF,0,1,0,0,1,2
TTGAATTCACGTGAGG-1_Br2720_Ant_IF,3,0,1,0,1,5
CCATCTCACCAGTGAA-1_Br2720_Ant_IF,1,0,1,0,0,2
CGCACGTGCGCTATCA-1_Br2720_Ant_IF,3,0,2,0,0,5
ACCCGGATGACGCATC-1_Br2720_Ant_IF,6,0,0,0,0,6
CGCTAGAGACCGCTGC-1_Br2720_Ant_IF,2,0,1,0,0,3
ATAGTTCCACCCACTC-1_Br2720_Ant_IF,2,0,4,0,1,7
GCAGACCCAGCACGTA-1_Br2720_Ant_IF,3,0,1,1,0,5
TAGACTACCTAGCGTT-1_Br2720_Ant_IF,0,2,3,1,0,6
GGTTCTACTCGTCTGA-1_Br2720_Ant_IF,1,0,0,0,0,1
GACTCACCCACGTGAG-1_Br2720_Ant_IF,3,2,0,0,1,6
AGCTCTTCGTAACCTT-1_Br2720_Ant_IF,2,2,0,0,0,4
AAGGATCGATCGCTTG-1_Br2720_Ant_IF,0,1,0,0,0,1
TAATTTCCGTCCAGTA-1_Br2720_Ant_IF,0,1,0,0,1,2
TCCTTCAATCCCTACG-1_Br2720_Ant_IF,0,2,1,0,0,3
TACCTATCCCTAGAGG-1_Br2720_Ant_IF,1,1,0,0,0,2
GCATGGGTACTGACGC-1_Br2720_Ant_IF,2,0,0,0,1,3
GTCGGGAACATGGTAG-1_Br2720_Ant_IF,1,3,1,0,0,5
GCAAATGAGGACACTT-1_Br2720_Ant_IF,1,0,0,0,1,2
GAATGGGCTTATCGAC-1_Br2720_Ant_IF,1,2,0,0,2,5
TGGTCGTGCAAGGCAA-1_Br2720_Ant_IF,0,2,1,0,0,3
CACCACGCCACACAGA-1_Br2720_Ant_IF,5,3,3,0,0,11
GAACCTCGACCTACAC-1_Br2720_Ant_IF,0,2,0,0,0,2
CAATACGCTCTGAGGC-1_Br2720_Ant_IF,1,0,0,0,1,2
TGGTAAGCAGGATTGA-1_Br2720_Ant_IF,0,2,0,0,2,4
AGTGGCTCCGTCGGCC-1_Br2720_Ant_IF,0,1,1,0,1,3
GATCGGATAGAACCAT-1_Br2720_Ant_IF,0,0,0,0,0,0
GCTACAGTACGGACCG-1_Br2720_Ant_IF,2,0,0,0,1,3
TCTATTACTAGAGGAT-1_Br2720_Ant_IF,0,1,2,0,0,3
TTCAGGCGTCAAAGCC-1_Br2720_Ant_IF,0,2,0,0,0,2
AGACCGGGAAACCCTG-1_Br2720_Ant_IF,1,3,0,0,0,4
AGAGATCTCTAAAGCG-1_Br2720_Ant_IF,0,4,0,0,1,5
CCCTGCCCAATCCGCT-1_Br2720_Ant_IF,1,1,1,0,2,5
GTGGCGGTCCCAGCGT-1_Br2720_Ant_IF,0,1,0,0,2,3
GCATTGTAATTCATAT-1_Br2720_Ant_IF,0,1,1,0,0,2
CCGTTCCGAATCTCGG-1_Br2720_Ant_IF,0,2,0,0,2,4
AGCTTGATCTTAACTT-1_Br2720_Ant_IF,0,6,1,0,3,10
CCTGTACTCACGCCCA-1_Br2720_Ant_IF,0,0,1,0,2,3
AAGTGACGACCGAATT-1_Br2720_Ant_IF,0,0,0,0,2,2
CTCACTTGGCTGGTAA-1_Br2720_Ant_IF,2,2,3,0,2,9
CGCCTGGCCTACGTAA-1_Br2720_Ant_IF,0,3,0,0,2,5
CCCGTAAGTCTAGGCC-1_Br2720_Ant_IF,0,0,1,0,1,2
TTGGACATGTGGCTTA-1_Br2720_Ant_IF,0,2,0,0,1,3
ATTACGCGCTGGCAGG-1_Br2720_Ant_IF,0,2,0,0,0,2
ACGCGCTACACAGGGT-1_Br2720_Ant_IF,0,1,0,0,1,2
TACGTTTACCGGCAAT-1_Br2720_Ant_IF,1,0,1,0,0,2
CGAAACGCAATTCATG-1_Br2720_Ant_IF,0,0,0,0,1,1
TAGTCTAACAACGAGA-1_Br2720_Ant_IF,0,0,0,0,0,0
TTGCATGCTGATCACG-1_Br2720_Ant_IF,0,1,3,0,0,4
TCTGGGTAGCGCTCAT-1_Br2720_Ant_IF,0,0,3,0,1,4
ACATCGGTCAGCCGCG-1_Br2720_Ant_IF,1,1,1,0,0,3
AGATACCGGTGTTCAC-1_Br2720_Ant_IF,0,1,0,0,0,1
GATTACTGAATTTGGG-1_Br2720_Ant_IF,0,1,1,0,0,2
TCCAACTTTAAATTCT-1_Br2720_Ant_IF,1,1,0,0,1,3
TCCTAGCAAAGAAGCT-1_Br2720_Ant_IF,0,2,2,0,2,6
GTCTATCTGAGTTTCT-1_Br2720_Ant_IF,0,2,0,0,0,2
GATGTTCAATCCACGA-1_Br2720_Ant_IF,1,0,1,0,0,2
AGTTAAACACTTGCGA-1_Br2720_Ant_IF,2,1,0,0,0,3
AGCTCTTTACTCAGTT-1_Br2720_Ant_IF,0,2,2,0,0,4
ATCCAGGATTCGTGAA-1_Br2720_Ant_IF,1,0,0,0,0,1
AGTCAACACCACCATC-1_Br2720_Ant_IF,1,2,1,0,2,6
CGATACCTCGCGGACA-1_Br2720_Ant_IF,1,1,0,0,0,2
TACAACGCACAACTCA-1_Br2720_Ant_IF,1,1,1,2,0,5
AATTAAAGGTCGGCGT-1_Br2720_Ant_IF,1,1,0,0,1,3
TACGCAGTTCTTTCCT-1_Br2720_Ant_IF,1,0,0,0,0,1
GACCGTGCTGACGGTG-1_Br2720_Ant_IF,0,0,1,0,1,2
GGCAAATTACTTTACT-1_Br2720_Ant_IF,2,0,0,0,2,4
GGTACAAACATGCTAT-1_Br2720_Ant_IF,0,1,4,0,1,6
CGGGCCTTCTTTGTAA-1_Br2720_Ant_IF,1,1,2,0,0,4
CGTGAAGTTAATTCAC-1_Br2720_Ant_IF,1,2,0,0,0,3
ATAGTGAAGCGTTCTC-1_Br2720_Ant_IF,0,0,0,0,0,0
TACGCCATATTCTAAT-1_Br2720_Ant_IF,1,1,2,0,0,4
GCCGGGTTAGGGTCGC-1_Br2720_Ant_IF,0,0,0,0,0,0
TACATAGGCATACACC-1_Br2720_Ant_IF,1,0,3,0,1,5
GCCGATTGGCCAAGCT-1_Br2720_Ant_IF,1,1,0,0,1,3
CTGCCATGCATCACAT-1_Br2720_Ant_IF,4,0,0,0,0,4
TTATGAATGAAAGGGA-1_Br2720_Ant_IF,1,3,0,0,2,6
GCTGAGGCGTGAGTAT-1_Br2720_Ant_IF,2,0,0,0,0,2
GCGCCGTTCCACGATA-1_Br2720_Ant_IF,8,0,0,0,0,8
CGCATGGTGCGATGCT-1_Br2720_Ant_IF,1,1,0,0,0,2
AGGTTTCACACACCTT-1_Br2720_Ant_IF,3,0,1,0,2,6
CAAGGATCGCATGTTC-1_Br2720_Ant_IF,1,1,1,0,0,3
ACGTTAATGTCGAAGA-1_Br2720_Ant_IF,0,1,0,0,0,1
TCCAGAGCACCGGTTC-1_Br2720_Ant_IF,2,1,0,0,1,4
GATTCGACGGTTCACG-1_Br2720_Ant_IF,1,1,2,2,3,9
GTTTCTGCAGTCTCCC-1_Br2720_Ant_IF,2,2,0,0,1,5
GCTGCACGGTTTCTTA-1_Br2720_Ant_IF,1,2,0,1,0,4
CGTGCAGACTGGGACA-1_Br2720_Ant_IF,3,3,0,1,0,7
GTGTTACTATGCGTCC-1_Br2720_Ant_IF,1,0,0,0,2,3
TCCTCGGGCTGGGCTT-1_Br2720_Ant_IF,0,3,0,0,0,3
GTGAGGACACTTAAGG-1_Br2720_Ant_IF,4,2,0,0,0,6
ATACGCCGGCGAAACC-1_Br2720_Ant_IF,3,0,0,0,0,3
TCTGCCAGAAACTGCA-1_Br2720_Ant_IF,2,0,0,0,0,2
TTCTGCGGGTTAGCGG-1_Br2720_Ant_IF,3,0,0,1,0,4
CTCGGTACCACTGCTC-1_Br2720_Ant_IF,3,0,0,0,0,3
GTAAGTAACAGTCTGG-1_Br2720_Ant_IF,7,0,0,2,0,9
GTGCGTGTATATGAGC-1_Br2720_Ant_IF,5,1,0,2,1,9
ATTTGTCTTGGGAGCT-1_Br2720_Ant_IF,4,0,0,0,0,4
CCTCGGACCGGGATAG-1_Br2720_Ant_IF,4,0,1,0,0,5
TAGGTGCTCGCCTAGC-1_Br2720_Ant_IF,3,0,0,0,0,3
CTTTAGGAACACTGTT-1_Br2720_Ant_IF,4,1,0,0,0,5
TCGGGCCGTCGTGGTA-1_Br2720_Ant_IF,4,0,0,4,0,8
AGTGCTTGCACGAATA-1_Br2720_Ant_IF,3,0,2,1,0,6
TGCAGTTTCCTCCCAT-1_Br2720_Ant_IF,4,0,0,3,0,7
TGAGAGATTTACCACG-1_Br2720_Ant_IF,4,0,1,0,0,5
GAAACAGATGACCACC-1_Br2720_Ant_IF,3,0,0,2,0,5
AGCAACATATCTTATT-1_Br2720_Ant_IF,1,0,2,0,0,3
CAAGTGTGGTTGCAAA-1_Br2720_Ant_IF,4,0,1,0,0,5
GCCTCATCTGGAAATA-1_Br2720_Ant_IF,1,0,3,0,0,4
AACCCTACTGTCAATA-1_Br2720_Ant_IF,1,0,2,0,0,3
ACGTATTACTCCGATC-1_Br2720_Ant_IF,0,0,1,0,0,1
TCTGGGAACCTTTGAA-1_Br2720_Ant_IF,2,0,1,0,1,4
GCTCGCTCATGTCCAA-1_Br2720_Ant_IF,3,0,0,0,0,3
GCGCAAGAGCGCGCTG-1_Br2720_Ant_IF,4,0,1,0,0,5
TTGACGCTCCATGAGC-1_Br2720_Ant_IF,0,0,2,0,0,2
TATAGATGGTCGCAGT-1_Br2720_Ant_IF,5,0,1,0,0,6
TTACATGCCACAACTA-1_Br2720_Ant_IF,5,0,3,0,0,8
ACATGGCGCCAAAGTA-1_Br2720_Ant_IF,2,0,2,0,0,4
TATGGTTAGTGGGAGA-1_Br2720_Ant_IF,1,0,5,0,0,6
CATGACTTCGCTGAAT-1_Br2720_Ant_IF,0,0,3,0,0,3
ACCACCAATGTAACAA-1_Br2720_Ant_IF,6,0,1,0,0,7
TCTTAGAGCTCCAATT-1_Br2720_Ant_IF,4,0,0,0,0,4
CCACGAATTTAACCTC-1_Br2720_Ant_IF,1,2,2,0,0,5
TTCTTGCTAGCATCTC-1_Br2720_Ant_IF,1,0,0,0,0,1
ACACCTTACTACTTGC-1_Br2720_Ant_IF,1,2,0,0,0,3
TGTGTCGAAGTCGAGG-1_Br2720_Ant_IF,1,2,0,0,0,3
GGATCAGAGCCATCAG-1_Br2720_Ant_IF,0,1,0,0,0,1
GTCCCAATCATCCCGC-1_Br2720_Ant_IF,0,1,0,0,1,2
TGCCACACTAGAGGAA-1_Br2720_Ant_IF,0,2,1,0,2,5
TGAATTTCACTTGCCT-1_Br2720_Ant_IF,0,3,1,0,0,4
CTCAGATTGTGATAAG-1_Br2720_Ant_IF,2,1,1,0,0,4
CGGACGTTACTTGAAG-1_Br2720_Ant_IF,0,1,0,0,1,2
CCGCCTTGCGATGTCG-1_Br2720_Ant_IF,0,1,0,0,1,2
CCAGTCAAATCTCTTA-1_Br2720_Ant_IF,0,2,0,0,0,2
AAACAGCTTTCAGAAG-1_Br2720_Ant_IF,0,1,0,0,0,1
TAGCTGATGTGAAGCG-1_Br2720_Ant_IF,0,0,2,0,0,2
CTTATGCGCTCAGGGC-1_Br2720_Ant_IF,0,1,2,0,2,5
TGGCTCTTGTCGCGTA-1_Br2720_Ant_IF,0,0,0,0,0,0
TTGTGAGGCATGACGC-1_Br2720_Ant_IF,1,2,0,0,0,3
CATAAGCTCTCCGTCT-1_Br2720_Ant_IF,1,0,1,0,0,2
CCTTCTCAGCGTTCCT-1_Br2720_Ant_IF,0,2,0,0,0,2
TGCAGCTACGTACTTC-1_Br2720_Ant_IF,2,1,0,0,0,3
CTCTACACTGGCGATT-1_Br2720_Ant_IF,0,1,0,0,0,1
TGCAGATCGTCCTAGG-1_Br2720_Ant_IF,0,2,0,0,1,3
TGCCAAAGTCAGACTT-1_Br2720_Ant_IF,0,5,0,0,0,5
ACAATAGTCGTACGTT-1_Br2720_Ant_IF,0,1,0,0,2,3
CATGCCAACTCGCAAA-1_Br2720_Ant_IF,0,2,2,0,2,6
TGCAGAACTATATCGT-1_Br2720_Ant_IF,0,2,1,0,2,5
TCGTGTCACGCTGACA-1_Br2720_Ant_IF,1,0,0,0,2,3
TGATCAGGGAACTGCT-1_Br2720_Ant_IF,0,4,2,0,2,8
CTTGCAACCGCCTCCT-1_Br2720_Ant_IF,0,3,0,0,2,5
AGCCCATACATGTAAG-1_Br2720_Ant_IF,1,3,0,0,3,7
ATCCAATGGAGGGTCC-1_Br2720_Ant_IF,0,2,0,0,2,4
AAACCGGGTAGGTACC-1_Br2720_Ant_IF,0,4,1,0,3,8
GCAACCACGGCCGCGT-1_Br2720_Ant_IF,1,0,4,0,2,7
CGCTTATTCCCGGTCG-1_Br2720_Ant_IF,0,4,2,0,0,6
TTACTCTGGTACGTAC-1_Br2720_Ant_IF,0,2,0,0,1,3
GTGGTTTCCGCCTTTC-1_Br2720_Ant_IF,1,8,5,0,1,15
ATAGGCGGCTATAGAA-1_Br2720_Ant_IF,1,1,1,0,0,3
GTGCCATCACACGGTG-1_Br2720_Ant_IF,0,2,1,0,0,3
CCCAACATACGTCGCG-1_Br2720_Ant_IF,0,0,0,0,0,0
CGGTGCAGATAGAACG-1_Br2720_Ant_IF,0,2,0,0,1,3
GGGCGGGTTCCCTACG-1_Br2720_Ant_IF,0,2,2,0,2,6
TGAGCCATACAGTCTC-1_Br2720_Ant_IF,0,0,2,0,0,2
CTCCGCCCACATGAGG-1_Br2720_Ant_IF,1,1,0,0,1,3
GTTGAACCGGTTCCAT-1_Br2720_Ant_IF,1,2,0,0,0,3
TTGACTACCATATGGT-1_Br2720_Ant_IF,0,0,3,0,1,4
ACCATCGTATATGGTA-1_Br2720_Ant_IF,2,1,1,0,0,4
TGCGTAAGAACCTGAT-1_Br2720_Ant_IF,0,1,0,0,2,3
AGAAGGTTGCCGAATT-1_Br2720_Ant_IF,2,1,0,0,1,4
AGGACGACCCATTAGA-1_Br2720_Ant_IF,1,2,0,0,0,3
GGTGCTGGTACACATT-1_Br2720_Ant_IF,1,1,0,0,0,2
GCGCTATGCCGAGGCA-1_Br2720_Ant_IF,0,0,1,0,0,1
ACCCGGTTACACTTCC-1_Br2720_Ant_IF,0,2,0,0,0,2
TAACTCATCCGCGCGG-1_Br2720_Ant_IF,1,0,0,0,1,2
CACAATGAGCTGCTAT-1_Br2720_Ant_IF,1,0,1,0,0,2
GTTACTTTGGGCCTAG-1_Br2720_Ant_IF,1,0,0,0,0,1
GGGCCCGTCTTAAACA-1_Br2720_Ant_IF,1,0,0,0,0,1
GAAATTGTCTCTATAA-1_Br2720_Ant_IF,0,1,0,0,2,3
GGCGCATGAATTGATG-1_Br2720_Ant_IF,1,0,2,0,1,4
CATATAGGTACAGTCA-1_Br2720_Ant_IF,0,2,0,0,1,3
TCAACGAGGAGACAAA-1_Br2720_Ant_IF,0,1,0,0,1,2
TTGCACAATTCAGAAA-1_Br2720_Ant_IF,2,1,0,0,1,4
CATCGGACGGGTTAAT-1_Br2720_Ant_IF,0,0,1,0,1,2
ATTAAACATGCGGACC-1_Br2720_Ant_IF,1,0,1,0,2,4
TATCTACCACAGCGGG-1_Br2720_Ant_IF,0,1,0,1,0,2
CGAGACCCTAGAGTGT-1_Br2720_Ant_IF,2,1,1,0,0,4
ACATCGATCGTTTACC-1_Br2720_Ant_IF,1,1,1,0,1,4
ATCGACCCAATACAGA-1_Br2720_Ant_IF,0,0,1,0,1,2
GAATCTGAACATTCTC-1_Br2720_Ant_IF,1,1,0,0,0,2
AGTTCCTATTTATGTT-1_Br2720_Ant_IF,0,1,2,0,0,3
CAGTCTGTATACTGGG-1_Br2720_Ant_IF,4,1,0,0,0,5
GGAGACGACACCTTTG-1_Br2720_Ant_IF,0,1,0,0,0,1
CCTAAATTAACGGTTC-1_Br2720_Ant_IF,0,1,3,0,0,4
GCTACGACTTATTGGG-1_Br2720_Ant_IF,4,3,0,0,0,7
CTGTGCAGGGTAGGTC-1_Br2720_Ant_IF,4,0,0,0,1,5
ACGCCGCTAGACGACC-1_Br2720_Ant_IF,0,1,0,0,1,2
ACTTGACTCCCTCTTT-1_Br2720_Ant_IF,1,1,0,0,0,2
CGCCTCCCTCCTCTAT-1_Br2720_Ant_IF,3,0,1,0,0,4
CTAGATTTACGACGGC-1_Br2720_Ant_IF,2,2,0,0,0,4
GATGCTGTATTTCATC-1_Br2720_Ant_IF,1,2,2,0,0,5
TGCGTTTGTTGACACT-1_Br2720_Ant_IF,8,0,0,0,0,8
CGTGCCCTCCCGAAGA-1_Br2720_Ant_IF,0,0,2,0,0,2
ACTCTCTGACTTAGGT-1_Br2720_Ant_IF,3,0,0,0,0,3
CTGGGTAGGCAGTTAA-1_Br2720_Ant_IF,1,1,0,1,1,4
GTTTGGCCCAAGTTAT-1_Br2720_Ant_IF,3,0,1,0,0,4
GAATGTGGTCCGGATT-1_Br2720_Ant_IF,2,0,1,0,0,3
CCCAGTTAAGGCGCCG-1_Br2720_Ant_IF,2,2,0,0,2,6
CGGTACTAGAATCAAA-1_Br2720_Ant_IF,2,0,0,2,0,4
GCTTAATGTAACTAAC-1_Br2720_Ant_IF,4,0,2,0,0,6
AGGACAGTCGAATCCC-1_Br2720_Ant_IF,2,1,2,0,0,5
GACAGCCAGACCTGAC-1_Br2720_Ant_IF,1,2,0,2,0,5
GGCGAAATCTAACTTG-1_Br2720_Ant_IF,2,1,0,0,0,3
CTGGTAACACATAGAA-1_Br2720_Ant_IF,2,0,0,1,0,3
TAGCCATTTCAAAGTC-1_Br2720_Ant_IF,0,0,4,1,1,6
GGGATTTACCGCACCT-1_Br2720_Ant_IF,3,1,1,2,0,7
ATGCCATTTGCGACCA-1_Br2720_Ant_IF,2,0,0,0,0,2
GAATAGACGCGACCCA-1_Br2720_Ant_IF,2,0,2,0,0,4
TGTATGGCGCAGACAG-1_Br2720_Ant_IF,0,0,0,0,0,0
GGATGAAGATCGCTGA-1_Br2720_Ant_IF,1,0,1,0,0,2
CGACAATTTGATCTAA-1_Br2720_Ant_IF,2,0,2,1,0,5
AAAGTTGACTCCCGTA-1_Br2720_Ant_IF,1,1,2,0,0,4
CGCGGCTCAACTTGAA-1_Br2720_Ant_IF,4,0,1,0,0,5
CACGCGGAACTGTTGC-1_Br2720_Ant_IF,3,0,5,0,0,8
TCTTAGAGTGAACTCT-1_Br2720_Ant_IF,1,0,4,0,0,5
AGTCCATTGGCTGATG-1_Br2720_Ant_IF,2,0,3,0,0,5
TTAAGATAGGATTGAC-1_Br2720_Ant_IF,2,0,0,1,0,3
ACATCCTGGTAACTGT-1_Br2720_Ant_IF,2,0,0,0,0,2
CACCTTGGCGCCTTTG-1_Br2720_Ant_IF,5,0,1,1,0,7
GCTAGACCGTCTACTG-1_Br2720_Ant_IF,1,1,2,0,0,4
CGGCCCAGGTATATCC-1_Br2720_Ant_IF,1,0,2,0,0,3
GTCCATTACTGCTACG-1_Br2720_Ant_IF,3,0,1,0,0,4
GGGTTTAGGATAGGAT-1_Br2720_Ant_IF,2,0,1,0,0,3
TAATTAGGACATCCGT-1_Br2720_Ant_IF,3,0,1,0,0,4
GCTCCCAGTCGGTCCA-1_Br2720_Ant_IF,4,0,0,0,0,4
ATTCGTGCTATCTCTT-1_Br2720_Ant_IF,4,0,0,0,0,4
GTTAACTATGTTGTCA-1_Br2720_Ant_IF,2,0,1,0,0,3
GCTCCGCTCGCTTCAG-1_Br2720_Ant_IF,2,0,3,2,0,7
GCAACGGCTAGTTATG-1_Br2720_Ant_IF,1,0,3,1,1,6
AATCGCGCAGAGGACT-1_Br2720_Ant_IF,0,0,0,0,0,0
AGGTTACACCATGCCG-1_Br2720_Ant_IF,0,0,0,1,0,1
CTTTGACGTCGCTTCT-1_Br2720_Ant_IF,2,1,0,0,0,3
CGTTATCATACTTCCA-1_Br2720_Ant_IF,0,1,1,0,1,3
GCTATGCCAGCTTATG-1_Br2720_Ant_IF,1,2,0,0,1,4
CAGTCGGCCTAGATAT-1_Br2720_Ant_IF,0,1,0,0,1,2
CCCGTGAGGGCGGTGA-1_Br2720_Ant_IF,1,0,0,0,0,1
TCTCGTGTTACGAGGA-1_Br2720_Ant_IF,0,0,1,0,0,1
ACGTCTCGTTCCGGGA-1_Br2720_Ant_IF,0,0,0,0,1,1
CGAGAGCGCGTAGATA-1_Br2720_Ant_IF,0,0,0,0,2,2
GACAGATTTCTGGCTC-1_Br2720_Ant_IF,0,2,0,0,2,4
GGGCCTAAATGGGCTA-1_Br2720_Ant_IF,1,0,0,0,2,3
ACTTGTAGTCCCTTCA-1_Br2720_Ant_IF,1,2,0,0,0,3
CCCGAAGTTTCGCGAA-1_Br2720_Ant_IF,0,1,1,0,1,3
ACCATCCGCCAACTAG-1_Br2720_Ant_IF,1,3,2,0,0,6
TGCGAATATGGGATTT-1_Br2720_Ant_IF,0,0,0,0,0,0
TACATCCCTATCCCTG-1_Br2720_Ant_IF,0,5,1,0,0,6
GTGGGAAGACTGAATC-1_Br2720_Ant_IF,2,0,0,0,1,3
TCAACATCGACCGAGA-1_Br2720_Ant_IF,0,0,0,0,0,0
CTATGTGAGTCACGGC-1_Br2720_Ant_IF,0,4,1,0,1,6
CCGAACACTGGGCCTC-1_Br2720_Ant_IF,0,2,1,0,0,3
AAACTTGCAAACGTAT-1_Br2720_Ant_IF,0,0,0,0,0,0
AGGGCGAGCAGCTGAT-1_Br2720_Ant_IF,0,0,1,0,1,2
AACACGAGACGCGGCC-1_Br2720_Ant_IF,0,2,0,0,0,2
TGACGAATATTTCCCT-1_Br2720_Ant_IF,1,3,1,0,1,6
TCGGAGAGTATCGGGA-1_Br2720_Ant_IF,5,0,0,0,0,5
CAAATCTCTCACAAGG-1_Br2720_Ant_IF,4,0,0,0,2,6
AGGCCCTAGAACGCCA-1_Br2720_Ant_IF,3,0,3,0,3,9
TAGAGATCATGCAACT-1_Br2720_Ant_IF,1,1,1,0,1,4
TTGTTTCCATACAACT-1_Br2720_Ant_IF,0,3,2,0,1,6
GAGAGGTGCATTCTGG-1_Br2720_Ant_IF,0,1,2,0,3,6
GTGGACCAACCCGATT-1_Br2720_Ant_IF,1,0,0,0,0,1
CTGGGCCTGCTATATC-1_Br2720_Ant_IF,0,0,0,0,0,0
CATAGTCCACAAGAAC-1_Br2720_Ant_IF,0,1,1,0,1,3
TTGACATGAACGTGGA-1_Br2720_Ant_IF,0,1,3,0,1,5
GGTTACCACCCTCGGG-1_Br2720_Ant_IF,0,2,1,0,0,3
TACCGGTCGTTTCCAT-1_Br2720_Ant_IF,0,1,1,0,0,2
CGAGTACTAAAGAGGA-1_Br2720_Ant_IF,0,0,1,0,0,1
GCAAGAATTCCTTGGC-1_Br2720_Ant_IF,0,3,0,0,0,3
TCGCCGAAGTTGCGTC-1_Br2720_Ant_IF,0,4,0,0,0,4
TTGAGAGTACTGCTAA-1_Br2720_Ant_IF,0,2,0,0,0,2
GCCACAATTTAAGGAC-1_Br2720_Ant_IF,0,2,0,0,1,3
ATATTCAGTTAAACCT-1_Br2720_Ant_IF,2,6,0,0,1,9
TGAGTGCCTCTTAAAT-1_Br2720_Ant_IF,2,1,1,0,2,6
ATCAGACGGCACGCCG-1_Br2720_Ant_IF,0,0,0,0,1,1
GTGCGAAATCGAACAC-1_Br2720_Ant_IF,0,3,2,0,0,5
GTGCCGCTTCAAAGGT-1_Br2720_Ant_IF,0,0,0,0,0,0
GATACGATGGGAGTCA-1_Br2720_Ant_IF,5,0,2,0,0,7
GACACTGAGTTCAGTG-1_Br2720_Ant_IF,1,0,1,0,1,3
ATCCTGCGTGGAATGG-1_Br2720_Ant_IF,0,1,0,0,0,1
ATCCTACCTAAGCTCT-1_Br2720_Ant_IF,1,0,2,0,0,3
AGTGATATGAGTAGTT-1_Br2720_Ant_IF,1,1,0,0,1,3
ATGATGCAATGGTACA-1_Br2720_Ant_IF,1,1,1,0,0,3
GAAACCGAATTACCTT-1_Br2720_Ant_IF,1,0,0,0,1,2
AGTGACCTACTTTACG-1_Br2720_Ant_IF,0,3,0,0,0,3
CAAATGTCCTTCCGTG-1_Br2720_Ant_IF,2,0,1,0,2,5
TTACTGGGATATTTCA-1_Br2720_Ant_IF,0,1,0,0,2,3
CTTGCCCAGGCTCTAC-1_Br2720_Ant_IF,2,0,5,0,0,7
AAATCGTGTACCACAA-1_Br2720_Ant_IF,2,1,0,0,0,3
GTGATCATAGATCTGC-1_Br2720_Ant_IF,0,0,2,0,3,5
TGGCAGATTACGATCA-1_Br2720_Ant_IF,1,0,0,0,0,1
TCACCCTCTTAAGATT-1_Br2720_Ant_IF,1,0,0,0,1,2
CAGGATATATCGTTGT-1_Br2720_Ant_IF,0,0,0,0,1,1
CCTGACCACCGATGGT-1_Br2720_Ant_IF,1,2,2,0,1,6
CTAAAGGGAAATAGGA-1_Br2720_Ant_IF,0,0,0,0,1,1
CCGCTATCAGCACCAG-1_Br2720_Ant_IF,0,1,2,0,0,3
CTTTAGTGCTATTATT-1_Br2720_Ant_IF,0,3,1,0,1,5
CGGGAATTTATGTAAA-1_Br2720_Ant_IF,1,2,0,0,0,3
TACGACTGCCTCTTAG-1_Br2720_Ant_IF,2,1,0,0,2,5
AAACTGCTGGCTCCAA-1_Br2720_Ant_IF,0,0,1,0,1,2
GTACGTTTGCCCGTCA-1_Br2720_Ant_IF,1,0,1,0,0,2
GGCAAGGCGAAATAGC-1_Br2720_Ant_IF,1,0,0,0,0,1
GATCTTGGAGGGCATA-1_Br2720_Ant_IF,1,0,2,0,0,3
AGCGTGGTATTCTACT-1_Br2720_Ant_IF,2,0,1,0,0,3
CTAAGGGAATGATTGG-1_Br2720_Ant_IF,1,0,1,1,0,3
CATGGTAAGTAGCGTT-1_Br2720_Ant_IF,0,0,1,0,0,1
CGTTGAGCGACCGTCG-1_Br2720_Ant_IF,1,3,0,0,1,5
TGCCCGTACCGTTAAA-1_Br2720_Ant_IF,0,0,1,0,0,1
ACAAGGGCAGGCTCTG-1_Br2720_Ant_IF,0,0,0,0,0,0
GAGATCTTCCATGACA-1_Br2720_Ant_IF,0,1,0,0,0,1
AATGACGTAGGATGTC-1_Br2720_Ant_IF,2,1,1,0,0,4
GTGGTGGCCAAGTGAA-1_Br2720_Ant_IF,2,0,2,0,0,4
TCCCGTGTGCAATTTG-1_Br2720_Ant_IF,0,3,0,0,0,3
ACATCGTATGCAATGG-1_Br2720_Ant_IF,3,1,2,1,0,7
GCGAAACTTAACTGGA-1_Br2720_Ant_IF,0,0,2,0,0,2
AATTGAACGCTCTGGT-1_Br2720_Ant_IF,2,0,0,3,0,5
ACAAATGGTAGTGTTT-1_Br2720_Ant_IF,1,0,4,0,0,5
ATGGTCGCGTGGTTTC-1_Br2720_Ant_IF,1,2,0,2,0,5
TGTTATTGTATGTGGC-1_Br2720_Ant_IF,2,0,1,0,0,3
TTCCGGTTACCCACTT-1_Br2720_Ant_IF,12,1,0,2,0,15
GAGTGTGCGGTACCCA-1_Br2720_Ant_IF,0,1,2,1,0,4
CAAGATATTATAACGT-1_Br2720_Ant_IF,1,0,1,2,0,4
ACACACCAGGACCAGT-1_Br2720_Ant_IF,1,0,0,3,0,4
ATGGGCCTCGGCCTCT-1_Br2720_Ant_IF,3,0,1,3,0,7
AAGGTGATAAACCAGC-1_Br2720_Ant_IF,2,0,0,0,0,2
TCTTACTTATGCCTCT-1_Br2720_Ant_IF,1,0,0,0,0,1
AAAGTGTGATTTATCT-1_Br2720_Ant_IF,3,0,0,0,0,3
TGCTCCACAGTTCTTA-1_Br2720_Ant_IF,0,0,1,0,0,1
CTGGCTGATTCATCCT-1_Br2720_Ant_IF,2,0,2,0,0,4
TAAGGCTGAATCCCTC-1_Br2720_Ant_IF,1,0,1,0,0,2
TCTAGTGATATCGTGG-1_Br2720_Ant_IF,1,3,1,0,0,5
TCGAAGAACCGAGCAC-1_Br2720_Ant_IF,1,0,4,0,1,6
GACAAACATATGCAGG-1_Br2720_Ant_IF,2,1,3,1,0,7
AAGTCAATTGTCGTCA-1_Br2720_Ant_IF,1,0,2,0,0,3
AGTGAACAAACTTCTC-1_Br2720_Ant_IF,1,0,3,1,0,5
CATGATGGAAGTTAGC-1_Br2720_Ant_IF,2,0,5,0,0,7
AAGTGCCTTGACTGTA-1_Br2720_Ant_IF,3,1,0,0,0,4
ATCGCCAGTCAACATT-1_Br2720_Ant_IF,1,1,1,0,0,3
ACCGCGGTGGAAGTCG-1_Br2720_Ant_IF,3,0,2,0,0,5
TCTTCTATAACCCGCC-1_Br2720_Ant_IF,1,0,2,0,0,3
CACATTTCTTGTCAGA-1_Br2720_Ant_IF,5,0,1,0,1,7
TAGCGTCCCTCGATTG-1_Br2720_Ant_IF,3,0,3,0,0,6
GTTCGGATCGGGAACA-1_Br2720_Ant_IF,1,1,1,0,0,3
CAAACTCGCGACGCCG-1_Br2720_Ant_IF,2,0,1,0,0,3
GTCTTGTAGCTATTCA-1_Br2720_Ant_IF,2,0,0,0,0,2
TCTCGACGTATCGCCG-1_Br2720_Ant_IF,2,0,1,0,0,3
TTGCCAAGCAGAACCC-1_Br2720_Ant_IF,1,0,1,1,0,3
AAACCCGAACGAAATC-1_Br2720_Ant_IF,3,0,2,0,0,5
TTGAGCAGCCCACGGT-1_Br2720_Ant_IF,1,2,1,0,0,4
CGCCTTTAGCATGCTC-1_Br2720_Ant_IF,3,0,3,0,0,6
CGACCTACTAGACAAT-1_Br2720_Ant_IF,0,0,0,0,0,0
GAGTCTTGTAAAGGAC-1_Br2720_Ant_IF,1,1,0,0,0,2
AATATCCTAGCAAACT-1_Br2720_Ant_IF,0,2,0,0,0,2
CCCTAGGCAACAAGAG-1_Br2720_Ant_IF,2,4,0,0,2,8
ACAAAGAAGGTAGGCC-1_Br2720_Ant_IF,0,1,0,0,0,1
CCCTGGCTGTTCCTTC-1_Br2720_Ant_IF,0,0,0,0,0,0
TCGCCGCACCGCGTGA-1_Br2720_Ant_IF,0,2,3,0,0,5
TATAGCGCACGTTATC-1_Br2720_Ant_IF,0,7,0,0,0,7
TTATCTGACATTAGGA-1_Br2720_Ant_IF,0,1,0,1,0,2
AGTGGTGTTACCCGTG-1_Br2720_Ant_IF,0,1,0,0,0,1
GCCAAGAATACTTCTG-1_Br2720_Ant_IF,0,0,2,0,1,3
CCGGCGTGAGACTCTG-1_Br2720_Ant_IF,0,3,0,0,1,4
TTCCCGGCGCCAATAG-1_Br2720_Ant_IF,0,1,0,0,1,2
AAACAGGGTCTATATT-1_Br2720_Ant_IF,0,3,0,0,1,4
ACAGTAATACAACTTG-1_Br2720_Ant_IF,0,1,0,0,0,1
CGAACGGCCGGACAAC-1_Br2720_Ant_IF,0,1,0,0,1,2
GCAACACACTAGAACT-1_Br2720_Ant_IF,1,0,0,0,2,3
ACTCCCATTCCTAAAG-1_Br2720_Ant_IF,0,2,0,0,0,2
ACCTGCGTGTCATGTT-1_Br2720_Ant_IF,0,3,0,0,1,4
TACTTTCCGCACGCCA-1_Br2720_Ant_IF,0,0,0,0,0,0
AGGTCAGGTGAGAGTG-1_Br2720_Ant_IF,0,2,1,0,0,3
TCCTCCTAAGACATTC-1_Br2720_Ant_IF,4,0,0,0,1,5
ATGTGAAAGCCTAATG-1_Br2720_Ant_IF,3,3,0,0,0,6
AGTCGGCTCAACTTTA-1_Br2720_Ant_IF,0,0,0,0,0,0
CGATCTGTTGGAGGAC-1_Br2720_Ant_IF,1,0,2,0,1,4
ACGGGAGTGTCGGCCC-1_Br2720_Ant_IF,2,1,1,0,0,4
TTAACTTCAGGTAGGA-1_Br2720_Ant_IF,1,3,0,0,1,5
CCACGGAGCCATAAGA-1_Br2720_Ant_IF,0,1,0,0,0,1
CTTCTATGTTGAAGTA-1_Br2720_Ant_IF,0,3,0,0,1,4
CACCGTTGCGCGATAT-1_Br2720_Ant_IF,0,2,0,0,0,2
TCTAGCAATCTCCGCC-1_Br2720_Ant_IF,0,1,0,0,3,4
AGTTTGGCCAGACCTA-1_Br2720_Ant_IF,0,0,1,0,1,2
TTGTAAGGACCTAAGT-1_Br2720_Ant_IF,1,1,1,0,0,3
AAATTTGCGGGTGTGG-1_Br2720_Ant_IF,0,0,0,0,0,0
AAGTTCGGCCAACAGG-1_Br2720_Ant_IF,1,2,1,0,0,4
CCGCTTACCTCACTCT-1_Br2720_Ant_IF,0,0,0,0,1,1
ATCACGTGCTAATTAA-1_Br2720_Ant_IF,3,0,0,0,1,4
GGTGAAGTACAGGGAT-1_Br2720_Ant_IF,1,3,1,0,0,5
GCTGTATTACTGGCCC-1_Br2720_Ant_IF,0,1,2,0,2,5
AACGGCCATCTCCGGT-1_Br2720_Ant_IF,0,1,0,0,3,4
TAAGTAACATCTTGAC-1_Br2720_Ant_IF,1,3,0,0,1,5
TTCTTGAGCCGCGCTA-1_Br2720_Ant_IF,0,7,0,0,0,7
AGTGCGTAGCTCGTAA-1_Br2720_Ant_IF,0,3,0,0,1,4
GGGATGGTCGTAACCG-1_Br2720_Ant_IF,0,0,0,0,0,0
GTCTGGGCGGTCGAGA-1_Br2720_Ant_IF,0,0,1,0,1,2
CGGAACGTAAACATAG-1_Br2720_Ant_IF,0,0,0,0,0,0
TGCGACACCCTAGTGC-1_Br2720_Ant_IF,0,4,0,0,1,5
CAAACGAGTATCGCAG-1_Br2720_Ant_IF,0,1,0,0,1,2
TCAGTAGGGACTATAA-1_Br2720_Ant_IF,0,2,0,0,2,4
GCGGTTCCCTATCATG-1_Br2720_Ant_IF,0,0,1,0,1,2
GTGACTTCAGTAGTGC-1_Br2720_Ant_IF,0,0,0,0,0,0
CGTCACGTCCATTGGT-1_Br2720_Ant_IF,0,0,0,0,0,0
ATAAGTTACCGCGACG-1_Br2720_Ant_IF,1,1,0,0,2,4
CTGAATCCGAGACCTC-1_Br2720_Ant_IF,0,3,0,0,0,3
TACGACGCTTGCTGCG-1_Br2720_Ant_IF,1,2,0,0,1,4
GAATTCACCCGGGTGT-1_Br2720_Ant_IF,0,1,0,0,0,1
GGGTGACACCTTAACT-1_Br2720_Ant_IF,3,1,0,0,1,5
TGAGTAAATTAGCGTA-1_Br2720_Ant_IF,1,2,0,0,1,4
GAGTCCGCTTACCGGA-1_Br2720_Ant_IF,0,0,0,0,0,0
GGCGCGTTCGAGTTTA-1_Br2720_Ant_IF,0,0,0,0,0,0
ATTCATATACTGTCCA-1_Br2720_Ant_IF,2,0,0,0,0,2
ATAAACGGACCCGTAA-1_Br2720_Ant_IF,1,1,2,0,1,5
GTCGTACCATCTCGGG-1_Br2720_Ant_IF,0,0,0,0,1,1
ATAATAGCTGTTGAAT-1_Br2720_Ant_IF,3,0,0,0,1,4
TTCCGCGTGAGGCGAT-1_Br2720_Ant_IF,0,1,0,0,2,3
TACCGGCTCACTGCCC-1_Br2720_Ant_IF,1,2,2,0,1,6
GTATCTTTCATAACCA-1_Br2720_Ant_IF,2,1,0,0,1,4
GTTACCTACAACTTGC-1_Br2720_Ant_IF,0,0,0,0,2,2
TGACTATAATCCTTTC-1_Br2720_Ant_IF,1,0,0,0,1,2
AAATACCTATAAGCAT-1_Br2720_Ant_IF,4,0,3,0,0,7
TTATTAGAGCGTGTTC-1_Br2720_Ant_IF,1,0,2,0,0,3
ATGTGGACATCTTGAT-1_Br2720_Ant_IF,1,0,2,0,0,3
GTACGCTTCATTGCAC-1_Br2720_Ant_IF,1,0,0,0,0,1
CACATATTAGCAGGAT-1_Br2720_Ant_IF,0,1,1,0,0,2
CAAGAGGGCGGAGTAC-1_Br2720_Ant_IF,1,0,4,0,0,5
TCGCAAAGATGCATTT-1_Br2720_Ant_IF,0,1,2,0,0,3
GTCGTTATTCGCTTAT-1_Br2720_Ant_IF,2,2,1,0,0,5
TCGTGTACTATGGATG-1_Br2720_Ant_IF,0,1,2,2,1,6
GCGGAGAGGGAGAACG-1_Br2720_Ant_IF,3,1,1,0,0,5
TCACAGGGAATCGCAA-1_Br2720_Ant_IF,1,0,1,0,0,2
GACTGCACCAGCCCAG-1_Br2720_Ant_IF,1,2,1,0,0,4
TCCGCTGTCATCCCGG-1_Br2720_Ant_IF,3,0,1,0,1,5
AGATACTCAAGATCGA-1_Br2720_Ant_IF,1,0,1,0,0,2
ACTGAATGGCGAAAGT-1_Br2720_Ant_IF,1,0,3,0,0,4
TCCTACATCCACGGCC-1_Br2720_Ant_IF,4,0,2,0,0,6
TTCAGCCCTGGTCCAC-1_Br2720_Ant_IF,2,3,0,0,0,5
TTAGAGTTTAGAAGGA-1_Br2720_Ant_IF,1,0,1,1,0,3
GGTTAGCTATATGTCT-1_Br2720_Ant_IF,0,1,2,1,0,4
CTGGTTTCGAGCAAGA-1_Br2720_Ant_IF,1,1,2,0,1,5
TGGGCCCATACTAATT-1_Br2720_Ant_IF,3,1,2,1,0,7
ACTTATTTATGTGCCA-1_Br2720_Ant_IF,4,0,0,0,0,4
TTAGTTATTCGTGGCA-1_Br2720_Ant_IF,0,0,3,0,0,3
AACCGCTAAGGGATGC-1_Br2720_Ant_IF,1,1,1,1,1,5
ATACGTCCACTCCTGT-1_Br2720_Ant_IF,1,0,5,0,0,6
CGACACGCTCCGACAG-1_Br2720_Ant_IF,5,0,1,0,0,6
TCTGAACTCGTACCCG-1_Br2720_Ant_IF,1,0,0,0,0,1
AGGATATAGGGATTTA-1_Br2720_Ant_IF,1,0,3,0,0,4
GTGATCACTAACGCCT-1_Br2720_Ant_IF,1,0,0,2,0,3
ACCGGGCCTTTGTTGA-1_Br2720_Ant_IF,2,0,4,0,1,7
TTGACAGGAGCTCCCG-1_Br2720_Ant_IF,1,0,2,0,0,3
CTCTTCTATTGACTGG-1_Br2720_Ant_IF,4,0,4,0,0,8
CGTGGCCGAATATCTA-1_Br2720_Ant_IF,4,0,0,2,0,6
GGTTTAGCCTTTCTTG-1_Br2720_Ant_IF,2,0,1,0,0,3
TCAAGGTTACTACACC-1_Br2720_Ant_IF,3,0,0,0,0,3
TTGACTATTGTCCGGC-1_Br2720_Ant_IF,0,0,1,0,0,1
CGGGAATATAGTATAC-1_Br2720_Ant_IF,1,0,0,1,0,2
GCAACAGCAGTATGCG-1_Br2720_Ant_IF,2,0,2,0,0,4
ATCAAACACTGTTCCA-1_Br2720_Ant_IF,4,0,1,0,0,5
TGGGCAATAGTTGGGT-1_Br2720_Ant_IF,3,1,3,1,0,8
TGAATGTCAGCCGGCC-1_Br2720_Ant_IF,0,0,3,0,0,3
CGGCTCTAAAGCTGCA-1_Br2720_Ant_IF,2,0,2,0,0,4
GGACACAAGTTTACAC-1_Br2720_Ant_IF,2,1,3,1,1,8
CCGAGAAGTCGCATAA-1_Br2720_Ant_IF,4,1,1,0,0,6
AACTACCCGTTTGTCA-1_Br2720_Ant_IF,2,0,0,0,0,2
GCACAAACGAGGCGTG-1_Br2720_Ant_IF,3,0,4,1,0,8
CACACAGCTTGCGCTC-1_Br2720_Ant_IF,2,1,0,0,0,3
GTGCTTACATCAGCGC-1_Br2720_Ant_IF,3,0,2,0,0,5
GCAAACGTCGCCAGGT-1_Br2720_Ant_IF,4,0,3,1,0,8
GAATAGCATTTAGGGT-1_Br2720_Ant_IF,3,0,3,0,0,6
TACTGTTTCTCTGGTA-1_Br2720_Ant_IF,2,0,3,0,0,5
TATGACCTTGCGCTGG-1_Br2720_Ant_IF,0,3,0,0,1,4
ATATACATGTATGGTA-1_Br2720_Ant_IF,1,1,0,0,1,3
TGTGTGACCATGAATC-1_Br2720_Ant_IF,0,2,2,0,0,4
CCCACTCCACGGTATC-1_Br2720_Ant_IF,1,1,1,0,1,4
GGGCAGACGTCACTGC-1_Br2720_Ant_IF,0,0,0,0,0,0
TCAAAGAGCTATCTGT-1_Br2720_Ant_IF,0,2,2,0,1,5
AGATGCATCCTGTGTC-1_Br2720_Ant_IF,0,1,3,0,0,4
GTGAAGTCACGACTCG-1_Br2720_Ant_IF,1,3,0,0,2,6
TGATTCAGGTCCCGCG-1_Br2720_Ant_IF,1,4,1,0,1,7
CGCCACAGGTCGCGAT-1_Br2720_Ant_IF,1,0,0,0,0,1
TTGAATCGTTGTATAA-1_Br2720_Ant_IF,0,0,0,0,0,0
TGGCCAATTTGGTACT-1_Br2720_Ant_IF,0,0,0,0,1,1
CGACCCTTAACGCCGG-1_Br2720_Ant_IF,0,1,1,0,1,3
TCGGCGTACTGCACAA-1_Br2720_Ant_IF,0,1,0,0,0,1
GAGTAAGGCCACGGGA-1_Br2720_Ant_IF,0,1,0,0,0,1
ATCAGCTCGTCCACTA-1_Br2720_Ant_IF,0,1,1,0,1,3
AGGATCACGCGATCTG-1_Br2720_Ant_IF,0,2,0,0,0,2
AAATGGCCCGTGCCCT-1_Br2720_Ant_IF,2,0,1,0,0,3
CAGTACCAGTTTACGT-1_Br2720_Ant_IF,0,0,2,0,1,3
GGTCGTAAGCTCGCAC-1_Br2720_Ant_IF,1,1,0,0,0,2
CGTTCATGGTGCGCGT-1_Br2720_Ant_IF,5,1,1,0,0,7
GACTACAAAGCGGTGG-1_Br2720_Ant_IF,1,3,1,0,0,5
CAGCTGGCGTAACCGT-1_Br2720_Ant_IF,2,0,1,0,1,4
ACTCGTAACCCGTCCT-1_Br2720_Ant_IF,1,1,1,0,1,4
CATATGTCAGGCTACG-1_Br2720_Ant_IF,0,0,0,0,0,0
GCCCGACTTCTTCCCG-1_Br2720_Ant_IF,0,0,0,0,0,0
CTGGCATCCGAATGAG-1_Br2720_Ant_IF,0,2,2,0,1,5
AAGTGCGTTAGAATCT-1_Br2720_Ant_IF,1,2,0,0,0,3
AGAAGTGATTCGTGAT-1_Br2720_Ant_IF,0,3,0,0,0,3
TACCTTAAGATTTCCC-1_Br2720_Ant_IF,0,5,0,0,0,5
AATGACAGCAATGTCT-1_Br2720_Ant_IF,0,3,1,0,1,5
TCAACGCAGGAAATAA-1_Br2720_Ant_IF,0,1,1,0,2,4
TATTCCTCCGCCCACT-1_Br2720_Ant_IF,1,1,2,0,6,10
ATCAAACGAAGGTTTG-1_Br2720_Ant_IF,2,0,1,0,1,4
TTGATTAGCTGTTTCT-1_Br2720_Ant_IF,0,1,0,0,3,4
CTGCTGAGGCCACGAA-1_Br2720_Ant_IF,0,1,1,0,0,2
CCGTGTTAAATTCCAT-1_Br2720_Ant_IF,3,1,0,0,0,4
CACGTCGGCAACCTCT-1_Br2720_Ant_IF,0,0,2,0,1,3
GTATTCTGAGAAACGA-1_Br2720_Ant_IF,1,2,0,0,2,5
CGGTGCGCGTTGGTCC-1_Br2720_Ant_IF,1,2,0,0,0,3
GTGATTCGCCGCTCAA-1_Br2720_Ant_IF,0,1,0,0,0,1
GCCCGCGCGTAAACGG-1_Br2720_Ant_IF,1,1,1,0,1,4
AACGTACTGTGGGTAC-1_Br2720_Ant_IF,0,1,1,0,1,3
GAGTATGCCCGCCTTG-1_Br2720_Ant_IF,0,1,1,0,1,3
TGATTCTGTCGCCGGT-1_Br2720_Ant_IF,1,1,1,0,0,3
GGGCGGCAAATGAATT-1_Br2720_Ant_IF,1,1,0,0,0,2
TTCCAATCTGGCTATC-1_Br2720_Ant_IF,3,2,0,0,0,5
GGAACCGTGTAAATTG-1_Br2720_Ant_IF,0,0,0,0,0,0
TTGGTCACACTCGTAA-1_Br2720_Ant_IF,0,1,0,0,0,1
CGAACCCGCATGCGTC-1_Br2720_Ant_IF,0,2,0,0,0,2
GGGCGTCACCACGTAA-1_Br2720_Ant_IF,0,1,0,0,1,2
TACCAGAAGTAGGTTC-1_Br2720_Ant_IF,3,0,1,0,0,4
TTGGATATCGTCTACG-1_Br2720_Ant_IF,0,3,0,0,0,3
TAGATATGGACTGGAA-1_Br2720_Ant_IF,0,1,0,0,0,1
GCGACGATAGTTGTAC-1_Br2720_Ant_IF,0,1,0,0,1,2
CTGGATTTACACTTGA-1_Br2720_Ant_IF,1,2,0,0,0,3
GTTATATTATCTCCCT-1_Br2720_Ant_IF,0,1,2,0,2,5
TATTCCACTCAGCTCG-1_Br2720_Ant_IF,0,1,1,0,1,3
CTGTTACCCAATCTAG-1_Br2720_Ant_IF,2,0,0,0,2,4
ACGCGAAGTCAGACGA-1_Br2720_Ant_IF,1,3,0,0,1,5
GATAGGTAACGTTGAC-1_Br2720_Ant_IF,1,2,1,0,1,5
TGTTCGTATTGCGGTG-1_Br2720_Ant_IF,0,1,0,0,3,4
GGTCAGTGGGTCCCAC-1_Br2720_Ant_IF,0,0,0,0,2,2
AATTCTAGAGTTAGGC-1_Br2720_Ant_IF,2,0,1,0,1,4
GTTTACGTTCCATCTG-1_Br2720_Ant_IF,1,0,0,0,2,3
AGACCCACCGCTGATC-1_Br2720_Ant_IF,0,2,2,0,0,4
TCTAGCATGCCCAGAA-1_Br2720_Ant_IF,0,1,0,0,1,2
CCCGCAGCGCGAACTA-1_Br2720_Ant_IF,1,0,0,0,0,1
CTCTATTTGGCTGCAG-1_Br2720_Ant_IF,0,0,1,0,1,2
TTCTGCCGCGCCTAGA-1_Br2720_Ant_IF,2,1,0,0,2,5
ACTCCCTAGAATAGTA-1_Br2720_Ant_IF,4,0,6,0,1,11
CCGAACCTTCCCGGCC-1_Br2720_Ant_IF,1,3,2,0,1,7
TCAGACGCTATAGAAG-1_Br2720_Ant_IF,0,1,1,0,1,3
CAGGCGCCATGCTAGG-1_Br2720_Ant_IF,2,1,1,0,0,4
CACTCGAGCTGAACAA-1_Br2720_Ant_IF,0,3,4,0,1,8
ACAAGGAAATCCGCCC-1_Br2720_Ant_IF,0,2,1,0,0,3
ACCACGTGCAGCTATA-1_Br2720_Ant_IF,0,0,0,0,0,0
ACGGCGACGATGGGAA-1_Br2720_Ant_IF,0,3,0,0,0,3
TTACTAAAGGACTTTA-1_Br2720_Ant_IF,2,0,0,0,0,2
GGCTGAAATAGCAAAG-1_Br2720_Ant_IF,0,1,3,0,1,5
TTAGACGAGTCACCTC-1_Br2720_Ant_IF,0,1,0,0,0,1
GTAGTCGCGGGAATCA-1_Br2720_Ant_IF,1,1,2,0,0,4
GCAAACCCTACATTAT-1_Br2720_Ant_IF,1,0,1,0,0,2
GTTAAAGTAGGACTGG-1_Br2720_Ant_IF,0,0,2,0,0,2
ACCCTCCCTTGCTATT-1_Br2720_Ant_IF,0,0,5,1,0,6
CATGTCTCATTTATGG-1_Br2720_Ant_IF,1,0,1,0,0,2
AATAGAATCTGTTTCA-1_Br2720_Ant_IF,3,0,1,0,0,4
TCTCATGAGATAGGGT-1_Br2720_Ant_IF,3,0,2,0,0,5
ATGACTATGCGACATT-1_Br2720_Ant_IF,1,0,0,1,0,2
CCTAACCCAAACAAGT-1_Br2720_Ant_IF,2,0,0,0,0,2
AGTCAAGATGACACTT-1_Br2720_Ant_IF,3,0,0,0,1,4
CGGGAGCTTCAGTGTA-1_Br2720_Ant_IF,1,1,1,0,0,3
CCACAGTACCCATCCT-1_Br2720_Ant_IF,0,1,1,0,1,3
GAGCGCGCACGAGTAG-1_Br2720_Ant_IF,2,0,0,1,0,3
ACCAGTGCGGGAGACG-1_Br2720_Ant_IF,1,1,3,0,1,6
TCCTTACGACGGTCCG-1_Br2720_Ant_IF,2,0,2,0,0,4
TAGTCGATCACGGGTT-1_Br2720_Ant_IF,1,0,3,1,0,5
AGACGAAGTGCCGGTC-1_Br2720_Ant_IF,2,0,1,1,0,4
CGCTGGTGACTACCCT-1_Br2720_Ant_IF,2,0,2,1,0,5
AGGCATTGTCGTAGGG-1_Br2720_Ant_IF,4,1,1,0,0,6
TGGTAGAATATATGGG-1_Br2720_Ant_IF,1,0,1,1,1,4
TTCTTATCCGCTGGGT-1_Br2720_Ant_IF,0,1,4,2,0,7
AGTTTGGCACGGGTTG-1_Br2720_Ant_IF,3,0,2,1,0,6
GCATCGGCCGTGTAGG-1_Br2720_Ant_IF,2,0,2,0,0,4
ATGCGAGTCCCACCAC-1_Br2720_Ant_IF,0,0,0,0,0,0
TCGGCGAACCCAAACC-1_Br2720_Ant_IF,4,0,0,0,0,4
AGAGTAAACTTCACTA-1_Br2720_Ant_IF,3,0,1,0,0,4
AAGCCGAAGCGGTTTA-1_Br2720_Ant_IF,1,0,2,0,0,3
CCCGAGTTTCTCCGTA-1_Br2720_Ant_IF,0,2,4,0,0,6
AATATCGAATCAATGC-1_Br2720_Ant_IF,1,0,2,0,0,3
GCGCCTCCCACTCCGA-1_Br2720_Ant_IF,3,0,2,0,0,5
CGTTAAACTAGTTAGG-1_Br2720_Ant_IF,7,0,1,0,0,8
TGAGTTAAAGACATTC-1_Br2720_Ant_IF,2,0,5,1,0,8
AACAGGTAGTATGGAT-1_Br2720_Ant_IF,1,0,3,2,0,6
GAACGCGGGTCACACG-1_Br2720_Ant_IF,4,0,2,1,0,7
TGTTTGAGATCGTCAG-1_Br2720_Ant_IF,1,0,4,2,0,7
ATCTCGTGAGCGAAAC-1_Br2720_Ant_IF,2,1,1,0,0,4
CTGAGAAAGTTCGGCG-1_Br2720_Ant_IF,4,0,1,0,0,5
ATTACCACACTGCCTG-1_Br2720_Ant_IF,2,0,3,2,0,7
CTGCTGTCTAACGAGC-1_Br2720_Ant_IF,3,0,2,0,0,5
CGTGGAAGCCTCGTAC-1_Br2720_Ant_IF,1,0,1,0,0,2
GGACTCACAAATTAGG-1_Br2720_Ant_IF,0,0,0,0,0,0
CTTTGCTGTCATGGAT-1_Br2720_Ant_IF,0,0,1,0,0,1
GGTGTTGGGCGTCTTA-1_Br2720_Ant_IF,1,1,0,0,0,2
TTAGAGGGATATACAG-1_Br2720_Ant_IF,0,1,0,0,0,1
TTGTACACCTCGAACA-1_Br2720_Ant_IF,0,1,1,0,0,2
GTGGGTACTGAGCGTA-1_Br2720_Ant_IF,0,2,0,0,1,3
CTTAAGCAGCGAGCCG-1_Br2720_Ant_IF,0,1,1,0,1,3
GCATTGACTTGCGGAA-1_Br2720_Ant_IF,1,4,0,0,0,5
CCATAACCTGTGCAGT-1_Br2720_Ant_IF,1,1,1,0,1,4
GGGCTACTATTTCGTG-1_Br2720_Ant_IF,0,4,0,0,0,4
GGCGAGCGAAACGGCA-1_Br2720_Ant_IF,1,2,0,0,1,4
GGAGACCATCTACATA-1_Br2720_Ant_IF,0,1,0,0,0,1
AGACCAAACCACACCT-1_Br2720_Ant_IF,1,2,0,0,0,3
CGACGCATCCGTACCT-1_Br2720_Ant_IF,1,1,0,0,1,3
CCTAGGTAAAGGTAGC-1_Br2720_Ant_IF,0,1,0,0,1,2
AGCGGCGGTTAGCGGT-1_Br2720_Ant_IF,0,0,0,0,0,0
CTGGACGCAGTCCGGC-1_Br2720_Ant_IF,1,1,0,0,0,2
AGCCTAATACCCACGT-1_Br2720_Ant_IF,0,2,0,0,1,3
AATCTGGCTTTCTAGT-1_Br2720_Ant_IF,0,0,0,0,0,0
CACCCTTGGTGAGACC-1_Br2720_Ant_IF,1,3,1,0,0,5
GGATCTTGACTCAACC-1_Br2720_Ant_IF,2,1,0,0,0,3
ACGAGGATACCACTCT-1_Br2720_Ant_IF,1,1,0,0,2,4
GAGTTGATGGCAATTT-1_Br2720_Ant_IF,0,2,1,0,0,3
GTGGCAAACAGCGGCA-1_Br2720_Ant_IF,0,2,1,0,1,4
GATGTAACGAACCACC-1_Br2720_Ant_IF,0,2,1,0,0,3
AGCCGTGGCTAAATGT-1_Br2720_Ant_IF,1,0,1,0,0,2
CTCCCTCCTTTCGATC-1_Br2720_Ant_IF,1,2,2,0,3,8
TTGGAAGAATACAGTC-1_Br2720_Ant_IF,4,3,0,0,0,7
AGTTAAGTCAACCGCT-1_Br2720_Ant_IF,0,1,0,0,1,2
CTCATGGTAATTTGCG-1_Br2720_Ant_IF,0,0,2,0,3,5
AAAGTAGCATTGCTCA-1_Br2720_Ant_IF,0,1,2,0,0,3
TTGTGGTAGGAGGGAT-1_Br2720_Ant_IF,0,0,2,0,3,5
AGTCGTGGGCATTACG-1_Br2720_Ant_IF,1,3,0,0,0,4
ACCTAAGTACCTTTCA-1_Br2720_Ant_IF,1,3,1,0,0,5
GTAGAGGGAGACAAGT-1_Br2720_Ant_IF,0,3,2,0,1,6
GATCCTCGACACTGGC-1_Br2720_Ant_IF,0,3,1,0,2,6
CCTACATTCACAGACG-1_Br2720_Ant_IF,2,0,0,0,0,2
TTGACCGTGTTAATGA-1_Br2720_Ant_IF,0,1,0,0,0,1
TCTGTTACCCAGCATA-1_Br2720_Ant_IF,2,3,0,0,2,7
CTAACTGGTCCGGTTC-1_Br2720_Ant_IF,0,0,1,0,3,4
AGCGACAGGAACGGTC-1_Br2720_Ant_IF,0,1,2,0,1,4
TAATAGAACAGAGTTA-1_Br2720_Ant_IF,1,1,1,0,3,6
ACAGGTGGAGGTGAGG-1_Br2720_Ant_IF,0,0,0,0,1,1
TGCGAGAATATTACCC-1_Br2720_Ant_IF,1,0,1,0,1,3
TTGCGTCGGCCAACCG-1_Br2720_Ant_IF,1,1,0,0,0,2
AGGCTTCCCGAAGAAG-1_Br2720_Ant_IF,0,2,3,0,0,5
GCGGACCGCGTTGTGG-1_Br2720_Ant_IF,0,3,0,0,0,3
GTAATCTGATTCTTCG-1_Br2720_Ant_IF,0,1,1,0,0,2
CCGCGGAATGCGTCAC-1_Br2720_Ant_IF,0,1,1,0,1,3
TTCCACACAGATTTGA-1_Br2720_Ant_IF,0,2,0,0,1,3
CTTCTATTAATGCTAG-1_Br2720_Ant_IF,0,1,0,0,1,2
CATTTGAGTGGTACGT-1_Br2720_Ant_IF,0,3,1,0,0,4
TCACAGCAAACTCGAA-1_Br2720_Ant_IF,0,3,2,0,1,6
CAGACGAACCTGATAC-1_Br2720_Ant_IF,0,2,0,0,0,2
TAGCTAGAAGGCATGA-1_Br2720_Ant_IF,0,4,0,0,0,4
ATCCAGAGCAACAACC-1_Br2720_Ant_IF,0,3,1,0,0,4
TCCGGTTCGTCCGGTC-1_Br2720_Ant_IF,0,1,0,0,1,2
CGCGCATGTTTGATTG-1_Br2720_Ant_IF,1,1,3,0,1,6
TGGCGATCAAGTTATG-1_Br2720_Ant_IF,1,0,0,0,0,1
CCCTTTGACAGGTCTT-1_Br2720_Ant_IF,1,1,1,0,2,5
CAGAGACGGTCACCCA-1_Br2720_Ant_IF,1,0,1,0,0,2
TAGCTCGCCTGATAAC-1_Br2720_Ant_IF,0,0,2,0,1,3
TTGTGTTTCCCGAAAG-1_Br2720_Ant_IF,0,2,1,0,0,3
TATACACAGACGCCTT-1_Br2720_Ant_IF,0,1,0,0,2,3
ACATTAGTTTATATCC-1_Br2720_Ant_IF,0,1,0,0,0,1
CCATCGCAGTTAAACT-1_Br2720_Ant_IF,1,3,0,0,0,4
AATTAGCGCTGCAGCG-1_Br2720_Ant_IF,0,3,0,0,1,4
TCCGCTTATCCCATTA-1_Br2720_Ant_IF,0,1,0,0,3,4
GTTTGGGCTTGTGAGC-1_Br2720_Ant_IF,4,1,0,0,0,5
CTTGTCAACATTCGAG-1_Br2720_Ant_IF,0,1,0,0,0,1
GGACCAACAGGATAAC-1_Br2720_Ant_IF,0,2,0,0,0,2
AAGCTAGATCGAGTAA-1_Br2720_Ant_IF,2,1,0,0,1,4
TACCGTGCCTCGGACC-1_Br2720_Ant_IF,1,0,0,0,1,2
GTAGCCAAACATGGGA-1_Br2720_Ant_IF,0,0,0,0,0,0
TGCCAGTACGTGGAGA-1_Br2720_Ant_IF,2,1,1,0,0,4
ATAAGGTGGAGAACAT-1_Br2720_Ant_IF,0,3,0,0,0,3
CTTTAATATTGGTCGA-1_Br2720_Ant_IF,1,0,3,0,1,5
TGGTTCAACGGGTAAT-1_Br2720_Ant_IF,0,0,0,0,1,1
GCTGCTACTGCGTAGC-1_Br2720_Ant_IF,1,2,1,0,0,4
CTGCACAACTACATAT-1_Br2720_Ant_IF,1,0,0,2,0,3
ATATTCCACATAGTGA-1_Br2720_Ant_IF,1,4,1,0,0,6
TGGCAAACTAAATTAC-1_Br2720_Ant_IF,1,4,1,0,0,6
ACCGCAATAACTGCCT-1_Br2720_Ant_IF,0,2,0,0,0,2
TCGCACCAGGAGGCAG-1_Br2720_Ant_IF,1,0,0,0,0,1
ACTTCAGGCTGATCCC-1_Br2720_Ant_IF,1,0,1,0,1,3
ACAAATCGCACCGAAT-1_Br2720_Ant_IF,1,0,0,0,0,1
TCTGATGTATTCTGTC-1_Br2720_Ant_IF,1,1,0,0,0,2
CTTTACCGAATAGTAG-1_Br2720_Ant_IF,0,1,2,0,0,3
GCAGATCCATAAGACT-1_Br2720_Ant_IF,0,3,1,0,0,4
TTCCTCGGACTAACCA-1_Br2720_Ant_IF,0,1,1,0,0,2
TTATCCGGGATCTATA-1_Br2720_Ant_IF,1,2,0,0,0,3
CTGGAAGACACGGTGG-1_Br2720_Ant_IF,2,1,1,0,0,4
GTTCGTCTAAAGAACT-1_Br2720_Ant_IF,1,0,0,0,0,1
GTCTATTGGTTCCGGT-1_Br2720_Ant_IF,0,0,1,0,0,1
CTAGGCGCCCTATCAG-1_Br2720_Ant_IF,3,1,0,0,0,4
AACGGACGTACGTATA-1_Br2720_Ant_IF,0,1,1,0,0,2
AACACACGCTCGCCGC-1_Br2720_Ant_IF,3,0,4,0,0,7
GCTACTATAGTAGAGT-1_Br2720_Ant_IF,0,3,0,0,1,4
AGCATATCAATATGCT-1_Br2720_Ant_IF,2,0,3,0,0,5
CGAACAGTATGGGCGT-1_Br2720_Ant_IF,3,0,1,0,0,4
ACAATTGTGTCTCTTT-1_Br2720_Ant_IF,2,0,1,0,0,3
GATCGCTACCCGATTT-1_Br2720_Ant_IF,1,1,1,0,0,3
ATTGCGATCAGTAACT-1_Br2720_Ant_IF,0,0,1,2,0,3
CAGCAGTCCAGACTAT-1_Br2720_Ant_IF,1,0,0,0,0,1
AGAGGCTTCGGAAACC-1_Br2720_Ant_IF,0,0,3,1,0,4
AAACAAGTATCTCCCA-1_Br2720_Ant_IF,0,0,1,1,0,2
GGCAGCAAACCTATGC-1_Br2720_Ant_IF,1,0,0,0,0,1
ACTAGTTGCGATCGTC-1_Br2720_Ant_IF,0,0,3,1,0,4
TTGGACCATCTGGCAA-1_Br2720_Ant_IF,1,0,1,1,0,3
CCCTCCTCGCTCGTAT-1_Br2720_Ant_IF,1,0,3,0,1,5
GAGCGCAAATACTCCG-1_Br2720_Ant_IF,3,0,2,0,0,5
ATTACATGTCAGTCTT-1_Br2720_Ant_IF,2,0,4,0,0,6
TTGGGACGTAAGAGTT-1_Br2720_Ant_IF,1,0,0,0,0,1
CTTCGGCCAATTGTTT-1_Br2720_Ant_IF,2,1,1,0,0,4
AGACCGCTCCGCGGTT-1_Br2720_Ant_IF,1,1,1,0,0,3
GACCGCGTCTGACGTG-1_Br2720_Ant_IF,2,0,3,0,0,5
CCAAATAACAAGATTC-1_Br2720_Ant_IF,3,0,0,0,0,3
TCTTTAGAGTCTAACA-1_Br2720_Ant_IF,2,1,6,1,0,10
CTCCCAATGAGTCGCG-1_Br2720_Ant_IF,3,0,2,0,0,5
TAGTCTTTCCGAATTG-1_Br2720_Ant_IF,1,0,3,0,0,4
GAGTAAACCGGAAAGT-1_Br2720_Ant_IF,4,1,0,0,0,5
GATCTCGACGCTGTGG-1_Br2720_Ant_IF,1,0,1,0,0,2
CTGACATAGAAATAGA-1_Br2720_Ant_IF,4,0,0,0,0,4
TATACCGAGTGCCACA-1_Br2720_Ant_IF,2,0,2,2,0,6
TCCGAACGTTGCCGCT-1_Br2720_Ant_IF,2,1,0,1,0,4
GCAGAAGGTAATCTCC-1_Br2720_Ant_IF,3,0,1,0,0,4
GGTACTAAGTGCTTTG-1_Br2720_Ant_IF,6,0,1,0,0,7
CAGAATATTCGTTATC-1_Br2720_Ant_IF,3,0,3,1,0,7
TAATCAACCAAATGGG-1_Br2720_Ant_IF,3,0,2,0,0,5
AACTGAGTTATACTGA-1_Br2720_Ant_IF,0,3,0,0,0,3
CCTCAACGATCGCTGT-1_Br2720_Ant_IF,0,1,0,0,0,1
CGGTACGGCAAACCCA-1_Br2720_Ant_IF,0,2,1,0,0,3
CAGATGTTTGTCCCAA-1_Br2720_Ant_IF,0,2,0,0,1,3
GTTTGTTAGCCAAGTA-1_Br2720_Ant_IF,0,3,0,0,0,3
ACGTGACAAAGTAAGT-1_Br2720_Ant_IF,0,0,0,0,0,0
TTGTCACCGCGGTATC-1_Br2720_Ant_IF,0,1,0,0,2,3
GATCTAACCGTATTCA-1_Br2720_Ant_IF,0,3,0,0,0,3
ATGGAAATTTAAGGAG-1_Br2720_Ant_IF,3,2,0,0,0,5
ATTGATCACCACATTT-1_Br2720_Ant_IF,1,3,0,0,0,4
ACTGCTCGGAAGGATG-1_Br2720_Ant_IF,0,0,0,0,0,0
TCTAAAGAACAGTCTC-1_Br2720_Ant_IF,0,1,0,0,0,1
CTGGGTTGAGTTAAAG-1_Br2720_Ant_IF,0,4,0,0,0,4
CCCAGTAAACTTGGGA-1_Br2720_Ant_IF,1,1,0,0,1,3
AGATTCACAACCGATA-1_Br2720_Ant_IF,0,0,1,0,1,2
AGAAGGTACACTTCAC-1_Br2720_Ant_IF,0,1,0,0,1,2
GCAGGAACTTAGATCT-1_Br2720_Ant_IF,0,1,0,0,0,1
AATCTAGGTTTACTTG-1_Br2720_Ant_IF,0,0,1,0,0,1
CCCGGTGTATCGGAAT-1_Br2720_Ant_IF,0,0,0,0,0,0
TTATCCTCAAGGAATA-1_Br2720_Ant_IF,0,1,0,0,1,2
AGCATCATTTCGAAAG-1_Br2720_Ant_IF,0,1,1,0,2,4
CGCGAGTCTGCCGGGT-1_Br2720_Ant_IF,0,1,0,0,2,3
TGCGTCATGACTGAGC-1_Br2720_Ant_IF,1,2,3,0,1,7
GTATGAAATTTCACTC-1_Br2720_Ant_IF,1,2,0,0,0,3
TTGGTTGCGGTGCGCG-1_Br2720_Ant_IF,1,3,0,0,1,5
ACAGAACTGAGAACAA-1_Br2720_Ant_IF,2,0,1,1,1,5
CTACTATCATAGGTTT-1_Br2720_Ant_IF,0,1,0,0,1,2
CCTCTATCGATTAGCA-1_Br2720_Ant_IF,2,3,0,0,0,5
CCGTATCTCGTCGTAG-1_Br2720_Ant_IF,0,0,2,0,0,2
TCACGATGTCCGTGGA-1_Br2720_Ant_IF,0,5,1,0,0,6
TCAACAAAGATAATTC-1_Br2720_Ant_IF,1,0,2,0,0,3
ATGACGCGTTCTATCC-1_Br2720_Ant_IF,0,4,0,0,1,5
ATTTGCGCGAGTAGCT-1_Br2720_Ant_IF,0,3,3,0,2,8
TTCTTGGACGATCTGC-1_Br2720_Ant_IF,0,3,1,0,0,4
AGACGACGATGCCGCT-1_Br2720_Ant_IF,0,0,0,0,0,0
GGTCTCTGAATGGACT-1_Br2720_Ant_IF,0,6,1,0,1,8
GCTCAATCCGTTTATT-1_Br2720_Ant_IF,2,2,0,0,0,4
CCAGAAAGCAACTCAT-1_Br2720_Ant_IF,0,1,0,0,1,2
CACCGTTAGGGATCAC-1_Br2720_Ant_IF,0,2,0,0,0,2
AATAACACTAGAACAA-1_Br2720_Ant_IF,0,1,0,0,0,1
CACCCGGTTTGTGACT-1_Br2720_Ant_IF,0,0,0,0,3,3
CCACCAACTTTACTGT-1_Br2720_Ant_IF,0,5,3,0,1,9
AACTCTCAGTGTGCTC-1_Br2720_Ant_IF,0,3,2,0,1,6
AAACCGTTCGTCCAGG-1_Br2720_Ant_IF,0,2,0,0,0,2
CAGCGATTCCCTTCAA-1_Br2720_Ant_IF,0,1,1,0,2,4
GCTAGCTTGAATAGCT-1_Br2720_Ant_IF,0,2,0,0,0,2
TTGCGGCATCAGAAAG-1_Br2720_Ant_IF,2,2,0,0,1,5
AATAGAACAGAGTGGC-1_Br2720_Ant_IF,1,2,0,0,1,4
GCCATCGAGCTGCGTG-1_Br2720_Ant_IF,1,1,0,0,0,2
ACACTGATCAAGGTGT-1_Br2720_Ant_IF,0,3,2,0,0,5
ACCAACGCTTATTTAT-1_Br2720_Ant_IF,0,0,0,0,0,0
GACATCGATTTATAAC-1_Br2720_Ant_IF,1,3,0,0,2,6
CAGACACCGATCGCTG-1_Br2720_Ant_IF,1,4,0,0,0,5
CCAAGAAAGTGGGCGA-1_Br2720_Ant_IF,3,3,1,0,0,7
GGTAGACCGTTGGGCG-1_Br2720_Ant_IF,0,1,2,0,0,3
TCGTTAGGAGTCCCTA-1_Br2720_Ant_IF,0,2,1,0,1,4
ACGGCCAACATGGACT-1_Br2720_Ant_IF,0,3,2,0,1,6
GTGAGTGGTACAACGC-1_Br2720_Ant_IF,0,1,3,0,0,4
GAGACTTCGCGACCGA-1_Br2720_Ant_IF,0,1,0,0,0,1
GAAGTCAGTTGCACTA-1_Br2720_Ant_IF,1,3,1,0,0,5
GTTTGGTAGGGTCAAC-1_Br2720_Ant_IF,0,0,2,0,2,4
ACGGCACTTGCTTGGG-1_Br2720_Ant_IF,0,3,2,0,1,6
CCTCTGTACTATTCTA-1_Br2720_Ant_IF,0,0,0,0,1,1
CTATTCATGTGTCCCA-1_Br2720_Ant_IF,0,3,0,0,1,4
GCCCGATCTGTGGTCG-1_Br2720_Ant_IF,0,0,0,0,1,1
TTAGAAGAACATGACT-1_Br2720_Ant_IF,1,2,0,0,1,4
AGGATAAAGTCGGGAT-1_Br2720_Ant_IF,0,0,0,0,0,0
CGGCAAACATCGTGCG-1_Br2720_Ant_IF,1,0,0,0,0,1
CTAGTTACAACCCGGT-1_Br2720_Ant_IF,1,2,1,0,1,5
TTCGACAGAGCCCGTG-1_Br2720_Ant_IF,0,0,0,0,0,0
AAGCATACTCTCCTGA-1_Br2720_Ant_IF,0,3,0,0,1,4
GACGACGATCCGCGTT-1_Br2720_Ant_IF,0,0,1,0,0,1
GGTAGAAGACCGCCTG-1_Br2720_Ant_IF,1,1,1,0,1,4
GAGATGGGAGTCGACA-1_Br2720_Ant_IF,0,0,1,0,0,1
AACGATAATGCCGTAG-1_Br2720_Ant_IF,0,0,2,0,1,3
TGGTCCCACGCTACGG-1_Br2720_Ant_IF,0,0,0,0,0,0
CTGCTTGGCGATAGCT-1_Br2720_Ant_IF,0,1,2,0,1,4
ATCGGAGACAGACGGC-1_Br2720_Ant_IF,0,3,0,0,1,4
TAGCGTCCGGTGTGGT-1_Br2720_Ant_IF,0,2,0,0,2,4
GTTGAGTCCCGCCGGT-1_Br2720_Ant_IF,1,1,0,0,0,2
AAATAGGGTGCTATTG-1_Br2720_Ant_IF,0,1,0,0,0,1
AAGTGTTTGGAGACGG-1_Br2720_Ant_IF,0,3,0,0,1,4
AGCACTACCTCACCAG-1_Br2720_Ant_IF,0,2,2,0,0,4
TGCCTTGGCCAGGCAA-1_Br2720_Ant_IF,0,0,2,0,0,2
TCGTCTTAGGCGTTAA-1_Br2720_Ant_IF,0,1,1,0,0,2
TTCTGACCGGGCTCAA-1_Br2720_Ant_IF,0,0,0,0,0,0
CAGAACTTAGCCCTCT-1_Br2720_Ant_IF,0,1,1,0,0,2
AGCTCCTTCGCACATC-1_Br2720_Ant_IF,3,1,2,1,0,7
ACAGGCTTGCCCGACT-1_Br2720_Ant_IF,0,1,1,0,0,2
GCTATACGTCTCGGAC-1_Br2720_Ant_IF,0,1,1,0,1,3
GAGCCAGCTACCTGTG-1_Br2720_Ant_IF,0,3,2,0,0,5
TGCTAAGTGTCTATTT-1_Br2720_Ant_IF,4,0,1,0,0,5
GTCCTACGAATAGTCT-1_Br2720_Ant_IF,1,1,1,0,0,3
CAGTGTCGGCTGGCCC-1_Br2720_Ant_IF,0,0,0,0,0,0
CTATCGACGAAATACA-1_Br2720_Ant_IF,1,0,1,1,0,3
CATCATTACCCTGAGG-1_Br2720_Ant_IF,3,0,0,0,0,3
TAAGTTGCGACGTAGG-1_Br2720_Ant_IF,0,0,2,2,0,4
AGTGCACGCTTAAGAA-1_Br2720_Ant_IF,1,1,3,3,0,8
TGTGCCGGTGCCGGAA-1_Br2720_Ant_IF,0,1,0,0,0,1
AGGAGGCCTTCGCGCG-1_Br2720_Ant_IF,0,0,3,1,0,4
TCCGCGGCCCAATGAA-1_Br2720_Ant_IF,4,0,2,0,0,6
TCCGTTAAGCTAATAT-1_Br2720_Ant_IF,4,0,2,0,0,6
AAATCTAGCCCTGCTA-1_Br2720_Ant_IF,1,1,3,0,1,6
CGCAGGCGATCCAAAC-1_Br2720_Ant_IF,9,3,0,1,0,13
CCATATGGAAACTATA-1_Br2720_Ant_IF,2,0,3,0,0,5
CACCGTATCCCATCCG-1_Br2720_Ant_IF,0,1,3,0,0,4
GGTCAAGACTACTTCG-1_Br2720_Ant_IF,0,0,5,1,1,7
CCCGTTTCGCAGATGT-1_Br2720_Ant_IF,1,0,2,0,0,3
GTTATAATACGGTGAA-1_Br2720_Ant_IF,4,0,0,0,0,4
ACTTGTGGATGGAACG-1_Br2720_Ant_IF,5,0,1,0,1,7
GTTCGCTGAGACGTCT-1_Br2720_Ant_IF,1,0,1,0,0,2
GACACTGGAACCCGAT-1_Br2720_Ant_IF,3,0,8,0,0,11
CCCAGGTCTGAAGGCT-1_Br2720_Ant_IF,2,0,3,0,0,5
TCTCGAGGAGGTTCGC-1_Br2720_Ant_IF,0,0,3,0,0,3
ACTATCTGCCCGCGTA-1_Br2720_Ant_IF,1,0,4,0,0,5
CCTAAATTGTATCCTA-1_Br2720_Ant_IF,2,0,0,0,0,2
AGAAATTATGACTCGC-1_Br2720_Ant_IF,2,0,2,0,0,4
TCCAGCGCTATAAGCG-1_Br2720_Ant_IF,4,0,0,0,0,4
TCGTGTATTGGTCACG-1_Br2720_Ant_IF,3,3,1,0,0,7
CCACATACTGCACCCA-1_Br2720_Ant_IF,1,0,7,0,1,9
GTTGCGGACGGTCAGG-1_Br2720_Ant_IF,4,0,4,0,0,8
GTATTTAATGGCATAA-1_Br2720_Ant_IF,2,0,0,0,0,2
GTCGATAGGTGACTTT-1_Br2720_Ant_IF,2,1,2,1,0,6
AATAATCTTCGTATCG-1_Br2720_Ant_IF,3,0,5,0,0,8
ATTGTTCAACGATCCG-1_Br2720_Ant_IF,2,0,2,2,0,6
GTGCAGCGTAGAGTAG-1_Br2720_Ant_IF,1,0,5,0,0,6
TGTGGTAGGGTGCCTT-1_Br2720_Ant_IF,3,0,3,0,0,6
TGTGGACTATCTACGT-1_Br2720_Ant_IF,0,1,1,0,0,2
GGCGGGCTCTAAGAGT-1_Br2720_Ant_IF,3,1,2,0,0,6
TGTGCCAGAGGCAAAG-1_Br2720_Ant_IF,0,2,0,0,0,2
TGGCTTATGTATAATG-1_Br2720_Ant_IF,0,2,0,0,0,2
GCAAGCTGGAAACCGC-1_Br2720_Ant_IF,0,3,0,0,0,3
GATATCAAGCAGGAGC-1_Br2720_Ant_IF,0,2,0,0,0,2
CACCAATCATCCGTCT-1_Br2720_Ant_IF,0,0,0,0,0,0
CCACATGGCTCTTTAT-1_Br2720_Ant_IF,0,2,0,0,0,2
GTCCTACTCTACGGGC-1_Br2720_Ant_IF,0,1,0,0,2,3
CTCGAGACATACGATA-1_Br2720_Ant_IF,0,1,0,0,0,1
TATCAGTGGCGTAGTC-1_Br2720_Ant_IF,0,2,1,0,0,3
TGACAGGACAAGTCCA-1_Br2720_Ant_IF,2,0,0,0,0,2
TATTAACACCAAAGCA-1_Br2720_Ant_IF,0,2,1,0,1,4
TAGGCGATGAGGTCTC-1_Br2720_Ant_IF,0,2,0,0,0,2
CCGCCGGAACTTCTCG-1_Br2720_Ant_IF,0,0,0,0,0,0
GCCATTAGCCTCAAAC-1_Br2720_Ant_IF,0,0,0,0,1,1
GTTAGGCTACCCGTTT-1_Br2720_Ant_IF,1,1,0,0,0,2
GGGTATTCTAGCAAAC-1_Br2720_Ant_IF,2,0,0,0,0,2
GCCCTAGCCGTCGCGA-1_Br2720_Ant_IF,0,2,0,0,0,2
CAGATCCTGGTTTGAA-1_Br2720_Ant_IF,0,3,0,0,2,5
CTTCAGTGGTCGCCTA-1_Br2720_Ant_IF,0,0,0,0,1,1
GGGCAACCGCACGTGC-1_Br2720_Ant_IF,1,0,0,0,0,1
GACCCAATTATGATAC-1_Br2720_Ant_IF,0,3,0,0,0,3
GAAGCTCGGACCCGTC-1_Br2720_Ant_IF,1,0,0,0,1,2
CGTCGGGTCTAAGCGC-1_Br2720_Ant_IF,0,2,0,0,0,2
GAGGCCCGACTCCGCA-1_Br2720_Ant_IF,0,0,0,0,0,0
TTGCCATAGCCCGCTC-1_Br2720_Ant_IF,0,2,1,0,2,5
TAACATACACGCGATC-1_Br2720_Ant_IF,5,0,0,0,0,5
CCGACGGGCATGAGGT-1_Br2720_Ant_IF,0,1,0,0,0,1
AATGTGCCCGAGGTGT-1_Br2720_Ant_IF,1,1,0,0,0,2
AGCTGTAACCTCAATC-1_Br2720_Ant_IF,0,2,0,0,1,3
CGAGTGAAGGTACCAG-1_Br2720_Ant_IF,1,0,1,0,0,2
AGTCTCACAAGACTAC-1_Br2720_Ant_IF,0,3,1,0,0,4
AAATTGATAGTCCTTT-1_Br2720_Ant_IF,1,5,0,0,2,8
TAAGTCGCCGAGTATC-1_Br2720_Ant_IF,0,4,2,0,0,6
GCGGAGAAACTTCGCA-1_Br2720_Ant_IF,0,4,2,0,0,6
GGCAAAGGCGCCAATA-1_Br2720_Ant_IF,1,1,1,0,0,3
ATTTCCGGGTTCTGCG-1_Br2720_Ant_IF,0,1,1,0,0,2
TAAACCCAGGAGGGCA-1_Br2720_Ant_IF,1,1,0,0,0,2
TTCGGGCGCTAGTCTT-1_Br2720_Ant_IF,0,2,0,0,0,2
GTGGAGTCGGCGGTTG-1_Br2720_Ant_IF,0,2,1,0,2,5
GCACGCCTACTTAGAT-1_Br2720_Ant_IF,0,1,0,0,1,2
CAATATTCTTGACCTA-1_Br2720_Ant_IF,0,2,0,0,0,2
CGTTTGTGTAGAGGGT-1_Br2720_Ant_IF,0,3,0,0,0,3
CATAGCGTTGCCCACC-1_Br2720_Ant_IF,0,1,0,0,1,2
TGATACATTTAGCCGT-1_Br2720_Ant_IF,0,3,0,0,2,5
TTCCGGCCTTGAGGCT-1_Br2720_Ant_IF,0,1,1,0,1,3
CCTATACCGTCCTGTC-1_Br2720_Ant_IF,0,2,0,0,1,3
TCGTTGCTATCCGGTC-1_Br2720_Ant_IF,0,2,0,0,1,3
TGGCGACTGCTCCAAA-1_Br2720_Ant_IF,1,4,0,0,1,6
CAGAGGCGATGCATGA-1_Br2720_Ant_IF,1,0,0,0,2,3
TCACAGGAGAATAAGA-1_Br2720_Ant_IF,1,2,0,0,1,4
GGGTTAACATTTGAGT-1_Br2720_Ant_IF,2,1,2,0,0,5
GCGGGCGAGCCTTACC-1_Br2720_Ant_IF,0,0,1,0,2,3
TGCCAATGGGTACTCT-1_Br2720_Ant_IF,0,2,0,0,1,3
AGGGACTCTACGCGAC-1_Br2720_Ant_IF,1,2,1,0,2,6
GACGCCGTAAAGGCTA-1_Br2720_Ant_IF,0,0,0,0,0,0
AAAGGCTCTCGCGCCG-1_Br2720_Ant_IF,2,1,1,0,0,4
CTGGCTGGTTGTCAGT-1_Br2720_Ant_IF,0,0,0,0,2,2
ACATCCCGGCCATACG-1_Br2720_Ant_IF,1,3,0,0,3,7
CTCTTGTCCCGCTTGG-1_Br2720_Ant_IF,0,4,2,0,0,6
TACGCCTCCATTCCGA-1_Br2720_Ant_IF,1,2,4,0,0,7
CGGAGCAATTTAATCG-1_Br2720_Ant_IF,0,2,1,0,3,6
AACTAGGCTTGGGTGT-1_Br2720_Ant_IF,0,3,1,0,0,4
GCGTCGCCAGGGTGAT-1_Br2720_Ant_IF,0,0,0,0,1,1
GTTGGTCATGCTATCC-1_Br2720_Ant_IF,0,3,0,0,0,3
GCTGGCGGCGCATGCT-1_Br2720_Ant_IF,0,0,0,0,0,0
TGAGCGGAAAGTGTTC-1_Br2720_Ant_IF,2,1,0,0,1,4
CTTTCTGTGCGGGCTT-1_Br2720_Ant_IF,0,3,1,0,0,4
ATCTAATATCCTACGG-1_Br2720_Ant_IF,1,0,1,0,2,4
AACCTTTAAATACGGT-1_Br2720_Ant_IF,0,2,0,0,0,2
TTCACTCGAGCACCTA-1_Br2720_Ant_IF,0,1,1,0,0,2
CTGCACTCCAGTACAG-1_Br2720_Ant_IF,1,1,2,0,1,5
CCATTTCTACCTATTA-1_Br2720_Ant_IF,2,1,1,0,1,5
CAAGCGGCACATAATT-1_Br2720_Ant_IF,1,2,0,0,1,4
GTTAACATCACTTAAA-1_Br2720_Ant_IF,0,1,0,0,0,1
ATATAAATGTAGCTGC-1_Br2720_Ant_IF,2,1,0,0,0,3
GCCTCTATACATAGCA-1_Br2720_Ant_IF,1,4,0,1,0,6
GTGTCGTATAGCGTTC-1_Br2720_Ant_IF,1,0,0,0,0,1
ATACGTACTTAGCCAC-1_Br2720_Ant_IF,1,1,0,0,0,2
GCTATCATACTCATGG-1_Br2720_Ant_IF,1,3,2,0,1,7
TATCCAATTGGTTATC-1_Br2720_Ant_IF,7,2,0,0,0,9
TCTCCCTGGGCAGCGT-1_Br2720_Ant_IF,0,0,0,0,0,0
CCTATAATGAGTGCCC-1_Br2720_Ant_IF,1,1,0,0,0,2
CAATGCGAGAAGTATC-1_Br2720_Ant_IF,0,1,0,0,1,2
TACCAATAAAGTACCA-1_Br2720_Ant_IF,2,2,0,0,1,5
GCTAGGCACCACGGAG-1_Br2720_Ant_IF,1,1,0,0,0,2
GGTGGACTGCTCTGGC-1_Br2720_Ant_IF,1,0,0,0,1,2
TATTCCGAGCTGTTAT-1_Br2720_Ant_IF,2,0,2,0,0,4
TTGAGAAGTTTAGCAT-1_Br2720_Ant_IF,0,0,0,0,0,0
GTCCGGACCTGAAATT-1_Br2720_Ant_IF,0,3,2,0,1,6
CTGTGGTCGGGAGATA-1_Br2720_Ant_IF,5,1,3,0,0,9
CATGTAAGAGACATTT-1_Br2720_Ant_IF,1,1,0,0,0,2
CACGTTTCGTACACAC-1_Br2720_Ant_IF,0,1,2,0,1,4
CATCCTCTCAAAGATC-1_Br2720_Ant_IF,1,0,0,0,0,1
GATTAACCGAAAGCCC-1_Br2720_Ant_IF,0,3,1,0,0,4
AACGCTGTTGCTGAAA-1_Br2720_Ant_IF,0,1,0,0,0,1
TTCAGCTGGCGTGCCC-1_Br2720_Ant_IF,2,3,0,0,1,6
TAGAGGTTCTACTTGT-1_Br2720_Ant_IF,0,0,3,1,1,5
GTATCAAACGTTAGCT-1_Br2720_Ant_IF,1,1,2,0,0,4
AATCATGTAAAGACTC-1_Br2720_Ant_IF,2,0,0,2,0,4
AGTCACTAGCTCTCGA-1_Br2720_Ant_IF,1,0,0,1,0,2
GCGAAACGATCGGGAG-1_Br2720_Ant_IF,3,0,2,0,0,5
CATGGATTGTCTTCCG-1_Br2720_Ant_IF,0,0,2,0,1,3
ATTGGATTACAGCGTA-1_Br2720_Ant_IF,2,0,1,0,0,3
CACACACGCTAACGAG-1_Br2720_Ant_IF,1,0,2,0,0,3
CTATGGGAAGCGGAAT-1_Br2720_Ant_IF,1,0,1,0,1,3
TGCCTAATTGAAGATT-1_Br2720_Ant_IF,1,0,2,0,0,3
TGGCAATGGGACGGCG-1_Br2720_Ant_IF,2,0,1,0,0,3
ACCTCCGCCCTCGCTG-1_Br2720_Ant_IF,2,3,0,0,0,5
CGGCAATAAGATCGCC-1_Br2720_Ant_IF,1,0,4,0,0,5
CCTTGACCACTTTATT-1_Br2720_Ant_IF,1,0,5,1,0,7
TCATTTAGAAGTGTGA-1_Br2720_Ant_IF,4,0,1,0,0,5
CAGAATAACACACGGA-1_Br2720_Ant_IF,0,0,2,0,0,2
TCTGAGCAATTGACTG-1_Br2720_Ant_IF,1,0,1,1,0,3
CAACGTGGTGGAGTCT-1_Br2720_Ant_IF,2,0,0,0,0,2
CACAGTTCGCTTCCCA-1_Br2720_Ant_IF,3,0,3,0,0,6
TCTCTCGCCGCACATA-1_Br2720_Ant_IF,3,0,2,0,0,5
TGGGCAGGCCACCGCA-1_Br2720_Ant_IF,2,0,2,0,0,4
CTCCTGTTCAAGGCAG-1_Br2720_Ant_IF,1,0,3,0,0,4
TATTTGATTTGCACAG-1_Br2720_Ant_IF,1,0,1,0,0,2
GCCACTCCTTACGGTA-1_Br2720_Ant_IF,3,0,5,0,0,8
ACCGATATTTAATCAT-1_Br2720_Ant_IF,1,0,3,1,0,5
TTATTATCTGGAAGGC-1_Br2720_Ant_IF,3,0,1,0,0,4
TACATGCCGGAATTGT-1_Br2720_Ant_IF,6,1,0,0,0,7
GGCACTCAGCCGACCC-1_Br2720_Ant_IF,7,0,4,0,0,11
AAACCGGAAATGTTAA-1_Br2720_Ant_IF,3,0,1,0,0,4
AGACAGGCATCTCAGC-1_Br2720_Ant_IF,3,1,1,0,0,5
GTGGTGATGGTTTGTG-1_Br2720_Ant_IF,3,0,0,2,0,5
CCGATATGACGTAAGG-1_Br2720_Ant_IF,4,0,0,0,0,4
CATACACAAAGTCAGC-1_Br2720_Ant_IF,0,0,0,0,0,0
TGCCGTTCTTAATCGG-1_Br2720_Ant_IF,0,4,0,0,0,4
TCGAGTCTACGATTCG-1_Br2720_Ant_IF,0,2,0,0,0,2
ACTTCCAGTGGAAGCT-1_Br2720_Ant_IF,0,3,0,0,0,3
CAATTGGGCCGCACTC-1_Br2720_Ant_IF,0,2,0,0,0,2
AAATCGCGGAAGGAGT-1_Br2720_Ant_IF,0,4,0,0,0,4
ATATCAATTCCAGCCT-1_Br2720_Ant_IF,1,4,0,0,1,6
CTTTGTCGAATGCTCC-1_Br2720_Ant_IF,0,1,0,0,0,1
TGAGGCATGTACTGTG-1_Br2720_Ant_IF,0,4,0,0,0,4
TTCGCCGCTCGCGCTA-1_Br2720_Ant_IF,1,2,0,0,2,5
GACTCCTTCCAATTGA-1_Br2720_Ant_IF,0,2,0,0,2,4
ACCGAAGAGTCTGGTT-1_Br2720_Ant_IF,0,1,0,0,0,1
TGGCATGAAGTTTGGG-1_Br2720_Ant_IF,0,0,2,0,0,2
ACGAGGTTTACAACGT-1_Br2720_Ant_IF,1,0,0,0,0,1
AACCCATCCCATGATC-1_Br2720_Ant_IF,0,1,0,0,0,1
TCGACAACTGAACCCG-1_Br2720_Ant_IF,0,3,0,0,0,3
TATCTTGCAATACAAC-1_Br2720_Ant_IF,1,1,2,0,0,4
TATTATGTTTGCCTGC-1_Br2720_Ant_IF,0,0,2,0,0,2
GTCAAAGAAGTGGTGT-1_Br2720_Ant_IF,0,0,0,0,0,0
GGGACAGAGTTACTCC-1_Br2720_Ant_IF,0,4,1,0,0,5
AGCAACCGAAAGTAAT-1_Br2720_Ant_IF,0,1,2,0,1,4
CTCTCTAACTGCCTAG-1_Br2720_Ant_IF,1,2,0,0,0,3
ATACGGAACGTCGTTT-1_Br2720_Ant_IF,0,0,0,0,2,2
TCGGTCCCGACAATAG-1_Br2720_Ant_IF,0,1,0,0,2,3
CGCGCAAATGTCCAGA-1_Br2720_Ant_IF,0,1,0,0,0,1
TCTAATACTGCCTCAG-1_Br2720_Ant_IF,0,3,0,0,0,3
CTCGGTTGTCGGCCCT-1_Br2720_Ant_IF,0,2,0,0,0,2
GGTAACCGGGAGGATA-1_Br2720_Ant_IF,0,1,1,0,0,2
CAGGCGCACGGTGGTC-1_Br2720_Ant_IF,0,0,1,0,1,2
TCATCGATGGTCCCAA-1_Br2720_Ant_IF,0,4,0,0,0,4
CAAAGATTATTGGGCC-1_Br2720_Ant_IF,0,1,0,0,0,1
ACAATGAATACGGAGA-1_Br2720_Ant_IF,0,3,0,0,1,4
GCTCCTGACATACTGG-1_Br2720_Ant_IF,0,2,2,0,1,5
GATGACAAGTAGGGCA-1_Br2720_Ant_IF,0,3,1,0,0,4
TACGCCGAGGGTACCC-1_Br2720_Ant_IF,0,2,0,0,0,2
AAGCGTCCCTCATCGA-1_Br2720_Ant_IF,0,2,0,0,1,3
CACTCCTATGTAAGAT-1_Br2720_Ant_IF,4,1,1,0,0,6
TCGAGCCAGGCAGGCC-1_Br2720_Ant_IF,0,5,2,0,0,7
TCGTCAAGTACGCGCA-1_Br2720_Ant_IF,0,4,2,0,1,7
CCCGTAGCTGGGAAGA-1_Br2720_Ant_IF,0,0,0,0,0,0
ACCCTATGCCATATCG-1_Br2720_Ant_IF,1,1,0,0,2,4
GTGGTATAGTCTGCCG-1_Br2720_Ant_IF,0,2,1,0,3,6
CCGGTTTGTAATTGTG-1_Br2720_Ant_IF,0,2,0,0,0,2
GTCGCCGTTGTGTGTT-1_Br2720_Ant_IF,1,2,0,0,0,3
TACTGAACAGATTTAG-1_Br2720_Ant_IF,0,0,0,0,1,1
TATTAACCTGACCGCG-1_Br2720_Ant_IF,0,0,0,0,2,2
CTGTAGCCATCTCACT-1_Br2720_Ant_IF,1,1,0,0,0,2
TACTATGGTTCCTCAG-1_Br2720_Ant_IF,0,3,0,0,0,3
GAGTCAGACCAGAATC-1_Br2720_Ant_IF,0,2,0,0,0,2
TAAGGCATAACATCAA-1_Br2720_Ant_IF,3,1,2,0,0,6
CTTCCGCTCCGTGAAG-1_Br2720_Ant_IF,0,1,0,0,1,2
GGGCTATGATCGATGG-1_Br2720_Ant_IF,0,1,0,0,4,5
GGTCGGTCGTCCACAG-1_Br2720_Ant_IF,3,0,0,0,1,4
GGGACCCGTATATCTT-1_Br2720_Ant_IF,0,2,0,0,1,3
GAAAGCAGTGCACTTT-1_Br2720_Ant_IF,0,3,0,0,0,3
AGCGCATAATGAATCG-1_Br2720_Ant_IF,1,0,2,0,1,4
GCTGCTAAGTAGTCGA-1_Br2720_Ant_IF,0,2,1,0,0,3
AATAGTCCGTCCCGAC-1_Br2720_Ant_IF,0,0,0,0,0,0
AGCAGCCAGATGAATA-1_Br2720_Ant_IF,0,1,0,0,2,3
CCTCGCGCTGTGCGAT-1_Br2720_Ant_IF,0,1,0,0,0,1
TTGTGTATGCCACCAA-1_Br2720_Ant_IF,0,1,0,0,0,1
TGCTCGGCGAAACCCA-1_Br2720_Ant_IF,0,1,0,0,0,1
CGATTAAATATCTCCT-1_Br2720_Ant_IF,0,0,0,0,1,1
TGCCGTGGATCGTCCT-1_Br2720_Ant_IF,0,2,0,0,0,2
GTGGACGCATTTGTCC-1_Br2720_Ant_IF,1,1,3,0,1,6
ACCCGGAAACTCCCAG-1_Br2720_Ant_IF,2,2,3,0,1,8
CCGCATGTGGTACGAT-1_Br2720_Ant_IF,0,1,3,0,1,5
GCAAACCTTGGCCATA-1_Br2720_Ant_IF,0,1,0,0,0,1
ATTCACTGATGTTGGA-1_Br2720_Ant_IF,0,1,0,0,0,1
ACTCCCTAATGCTAAA-1_Br2720_Ant_IF,0,0,0,0,0,0
TCCTAAATTGGGAAGC-1_Br2720_Ant_IF,1,3,0,0,0,4
GAACAGATTACTAAAT-1_Br2720_Ant_IF,1,0,1,0,1,3
ATACAGGCCCTCCAAT-1_Br2720_Ant_IF,1,1,1,0,0,3
CGATTCGCCTGGCTGC-1_Br2720_Ant_IF,1,2,0,0,0,3
TCCGCCTGTCTACAAG-1_Br2720_Ant_IF,0,0,0,0,1,1
CACATCTCACCGACGA-1_Br2720_Ant_IF,1,0,0,0,1,2
CGTCGTCCTTCGCGAA-1_Br2720_Ant_IF,1,1,0,0,1,3
CGTTGAATACCGCGCT-1_Br2720_Ant_IF,0,0,1,0,0,1
ACCAATATGCAAGTTA-1_Br2720_Ant_IF,0,1,0,0,0,1
ACGGATGGTGCGGATA-1_Br2720_Ant_IF,2,0,1,0,2,5
CACCCTAACAAGATCT-1_Br2720_Ant_IF,0,0,0,0,1,1
AAGCTCTTTCATGGTG-1_Br2720_Ant_IF,1,0,0,0,1,2
CATGGGTATGCCTTAT-1_Br2720_Ant_IF,0,3,0,0,2,5
GCGCGTCATTGGTACA-1_Br2720_Ant_IF,0,0,0,0,1,1
TCTGAAGCACGTGGTC-1_Br2720_Ant_IF,0,1,1,0,1,3
AAGTTCACTCCAAGCT-1_Br2720_Ant_IF,2,0,1,0,1,4
TTGGACCTATAACAGT-1_Br2720_Ant_IF,3,1,2,0,1,7
ATCAGCCTCATGCTGC-1_Br2720_Ant_IF,1,0,0,0,0,1
AGTACTCTTATGCCCA-1_Br2720_Ant_IF,0,1,0,0,1,2
GCGCTTAAATAATTGG-1_Br2720_Ant_IF,1,0,0,0,0,1
TTGTGAACCTAATCCG-1_Br2720_Ant_IF,1,1,0,0,0,2
AGTCGTCGACCACCAA-1_Br2720_Ant_IF,1,3,4,0,1,9
TCCTTTAAATCCGCTT-1_Br2720_Ant_IF,1,0,0,0,0,1
ACTGAAACGCCGTTAG-1_Br2720_Ant_IF,0,3,0,0,1,4
GCACACACTGGTAGCC-1_Br2720_Ant_IF,0,2,3,0,0,5
TAAGGGCCTGTCCGAT-1_Br2720_Ant_IF,0,1,1,0,0,2
GCTAGAGTAGAGATGT-1_Br2720_Ant_IF,0,1,1,1,0,3
CACAGGGCCATATAGT-1_Br2720_Ant_IF,0,1,3,0,0,4
CCATGCCCTAGATTTC-1_Br2720_Ant_IF,1,0,0,1,0,2
TCGCGTAGCAGTGTCC-1_Br2720_Ant_IF,0,0,1,0,0,1
GACGAGGCTAATAAAC-1_Br2720_Ant_IF,0,1,3,0,0,4
CTACACTCGCAGATGG-1_Br2720_Ant_IF,1,0,0,0,1,2
ACGCATACGTTTACTA-1_Br2720_Ant_IF,1,1,2,0,0,4
GGAGCAACATTTCAAG-1_Br2720_Ant_IF,2,3,0,0,0,5
CGAGAGGGTAGCCGCG-1_Br2720_Ant_IF,0,1,2,1,0,4
TCGTGTTCGACCACAA-1_Br2720_Ant_IF,2,0,4,0,0,6
TCTACCCAATAGAGAG-1_Br2720_Ant_IF,0,2,1,0,0,3
ATAAACGTTGCACCAC-1_Br2720_Ant_IF,2,0,1,0,0,3
TCAACTGCAGAGTCAG-1_Br2720_Ant_IF,0,0,0,0,0,0
AGCTCCATATATGTTC-1_Br2720_Ant_IF,2,0,1,2,0,5
GTAACATCTAAGATAA-1_Br2720_Ant_IF,3,1,4,0,2,10
CCGACAATAGGCCGCC-1_Br2720_Ant_IF,1,0,2,0,0,3
ATGCTTAGGAGTTGAT-1_Br2720_Ant_IF,3,0,6,0,0,9
AACCCGAGCAGAATCG-1_Br2720_Ant_IF,1,0,2,0,0,3
CGGGTTTGTTAGGGCT-1_Br2720_Ant_IF,4,0,1,0,0,5
AGGCACGTGACTGTCC-1_Br2720_Ant_IF,4,0,1,0,0,5
GACAAGAGATGAGATT-1_Br2720_Ant_IF,4,0,0,1,0,5
AGCCCTTGGACATCCC-1_Br2720_Ant_IF,3,0,0,0,0,3
GCAGTTCGATCCGAGC-1_Br2720_Ant_IF,2,0,3,0,0,5
TCGAGGGCAACAGACG-1_Br2720_Ant_IF,0,0,2,1,0,3
ACTTTGTCGACGCACT-1_Br2720_Ant_IF,1,0,3,0,0,4
GAGTATCAAAGTTACA-1_Br2720_Ant_IF,2,0,1,0,0,3
CCAGGCTGGCGTCTGA-1_Br2720_Ant_IF,3,0,2,0,0,5
GGACTCTTCCGGTTGA-1_Br2720_Ant_IF,4,0,1,0,0,5
TCCCAGCACACGACAT-1_Br2720_Ant_IF,1,0,5,1,0,7
GCTCCATGAGTGCAGA-1_Br2720_Ant_IF,1,0,2,0,1,4
GCAGTGCGGGCGGATG-1_Br2720_Ant_IF,7,0,0,0,0,7
GCGTTCTGACTAAGCG-1_Br2720_Ant_IF,2,0,1,0,0,3
ATTTGGAGATTGCGGT-1_Br2720_Ant_IF,1,4,0,0,0,5
AAGGGTTTGATTTCAG-1_Br2720_Ant_IF,0,0,0,0,0,0
CCGGCCGCGAGCATAT-1_Br2720_Ant_IF,0,4,0,0,0,4
GAGTTCTGTGGGTGCT-1_Br2720_Ant_IF,1,3,0,1,0,5
AAACGAAGATGGAGTA-1_Br2720_Ant_IF,1,3,0,0,0,4
AATTACGAGACCCATC-1_Br2720_Ant_IF,0,4,0,0,0,4
CCTTTGAATTATGGCT-1_Br2720_Ant_IF,0,3,0,0,0,3
CATGGTATTAGTTTGT-1_Br2720_Ant_IF,1,2,1,0,0,4
AACGAAAGTCGTCCCA-1_Br2720_Ant_IF,0,1,0,0,1,2
ACATAAGTCGTGGTGA-1_Br2720_Ant_IF,1,2,0,0,0,3
GCACAACCTCGGGCGT-1_Br2720_Ant_IF,0,2,1,0,0,3
ATGCACGCGCTGTTCA-1_Br2720_Ant_IF,0,3,0,0,1,4
CGATGTTGTTATCTAC-1_Br2720_Ant_IF,1,2,0,0,0,3
GTCTCCTGCCAGTATG-1_Br2720_Ant_IF,0,3,0,0,0,3
GATGCCTTCTGCGGCA-1_Br2720_Ant_IF,1,0,1,0,0,2
ACCGGTCAGGTACACC-1_Br2720_Ant_IF,2,2,1,0,0,5
GTGGAGCGTTTACCGA-1_Br2720_Ant_IF,1,0,0,0,0,1
AGGCGGTTTGTCCCGC-1_Br2720_Ant_IF,0,1,1,0,1,3
TCCCTGGCGTATTAAC-1_Br2720_Ant_IF,0,3,2,0,1,6
AAACACCAATAACTGC-1_Br2720_Ant_IF,1,1,0,0,0,2
TGGACGCAATCCAGCC-1_Br2720_Ant_IF,0,1,1,0,0,2
GGAACCTTGACTCTGC-1_Br2720_Ant_IF,0,1,0,0,0,1
GTATCTCAGTCTTGAC-1_Br2720_Ant_IF,0,0,0,0,0,0
GCTGAATCTTCCAATC-1_Br2720_Ant_IF,0,4,0,0,1,5
AGATGCAAGACGTGCA-1_Br2720_Ant_IF,1,1,0,0,0,2
TTAAGGCCCGTACTTT-1_Br2720_Ant_IF,0,5,0,0,1,6
AGTATGCTGGAGACCA-1_Br2720_Ant_IF,0,2,0,0,0,2
GCGGCAAAGTATTGCC-1_Br2720_Ant_IF,0,1,1,0,0,2
GCGCAAATATATTCAA-1_Br2720_Ant_IF,0,1,0,0,1,2
GAAGAAACGATATTGT-1_Br2720_Ant_IF,0,2,0,0,1,3
GGACCTCTAGGCCGCC-1_Br2720_Ant_IF,0,0,0,0,0,0
AACAGCTGTGTGGCAA-1_Br2720_Ant_IF,1,3,1,0,1,6
TCGAATATCCCGCAGG-1_Br2720_Ant_IF,0,5,0,0,0,5
GCGACCCAACCATCTG-1_Br2720_Ant_IF,0,4,0,0,2,6
AGAGAAGGAGTACAAT-1_Br2720_Ant_IF,0,1,0,0,0,1
GGCTCCTCCACCTGTT-1_Br2720_Ant_IF,1,1,2,0,1,5
TCAGTGTATACGTCAT-1_Br2720_Ant_IF,0,4,0,0,1,5
ATTATTATGTCCGTCA-1_Br2720_Ant_IF,2,1,0,0,1,4
TTAGGTCATAACCGAC-1_Br2720_Ant_IF,0,2,1,0,1,4
AAGATGGCACCGGACC-1_Br2720_Ant_IF,0,1,1,0,0,2
CTACAAGAAATAACCC-1_Br2720_Ant_IF,0,1,3,0,0,4
ACTATTTCCGGGCCCA-1_Br2720_Ant_IF,0,3,1,0,0,4
TTGTTTCACATCCAGG-1_Br2720_Ant_IF,0,4,5,0,1,10
CGCTGTGTGGATGTTG-1_Br2720_Ant_IF,0,3,1,0,2,6
TCAACATAGCGCCCTA-1_Br2720_Ant_IF,1,1,0,1,0,3
GGCCGTTTGGGTTTCA-1_Br2720_Ant_IF,2,5,1,0,2,10
TACTCTTTCGTCTTCA-1_Br2720_Ant_IF,0,1,0,0,3,4
TTCGCGCGCCATACGA-1_Br2720_Ant_IF,1,2,1,0,1,5
CGGAAAGAATCAAACG-1_Br2720_Ant_IF,0,2,2,0,1,5
AGGCAGGGAGCGTACT-1_Br2720_Ant_IF,0,1,1,0,3,5
CCTTTAAGGGAGCACT-1_Br2720_Ant_IF,0,6,0,0,0,6
CGCCCAGCACGCCTAG-1_Br2720_Ant_IF,0,4,1,0,0,5
AGTATTTGGCACGACC-1_Br2720_Ant_IF,0,2,1,0,0,3
TATCCGCACCGTCGGG-1_Br2720_Ant_IF,1,0,0,0,2,3
ACCCGTGTCATCAGTA-1_Br2720_Ant_IF,1,4,1,0,0,6
CAACTGCTCATCCGAT-1_Br2720_Ant_IF,1,0,1,0,2,4
CCGGAGCGTACTTTCT-1_Br2720_Ant_IF,0,0,0,0,2,2
TACCGTAGGTTAACTA-1_Br2720_Ant_IF,0,0,0,0,0,0
TGAGGAGTGCCAGCTT-1_Br2720_Ant_IF,0,2,1,0,1,4
CCAGTCTTGTCATAGA-1_Br2720_Ant_IF,1,0,1,0,3,5
GGGCAGAGCAATCGTT-1_Br2720_Ant_IF,1,3,1,0,1,6
TACCAAATAGCCCAGA-1_Br2720_Ant_IF,0,0,0,0,0,0
TACCTACTCCCAGTAT-1_Br2720_Ant_IF,0,3,2,0,0,5
TGTGAGACTAGCCCAA-1_Br2720_Ant_IF,0,0,0,0,0,0
ATACCTAACCAAGAAA-1_Br2720_Ant_IF,0,2,1,0,1,4
GTCGGGAAGCAGAAAC-1_Br2720_Ant_IF,0,1,1,0,1,3
AATTAACGGATTTCCA-1_Br2720_Ant_IF,1,1,3,0,1,6
GAACCCTCTGTGTTCT-1_Br2720_Ant_IF,0,2,1,0,1,4
ATATAAAGCGCTCGTG-1_Br2720_Ant_IF,0,2,0,0,0,2
CCTGGTCGAATGTGGG-1_Br2720_Ant_IF,1,0,0,0,0,1
CTAGGTTCGGACGTGA-1_Br2720_Ant_IF,0,2,1,0,0,3
TCGGGAGACAGCGTAC-1_Br2720_Ant_IF,0,4,2,0,0,6
CATAAGAAGCTTGGCT-1_Br2720_Ant_IF,2,0,1,0,0,3
AAGCACCCTGCGTATC-1_Br2720_Ant_IF,0,0,0,0,2,2
AGTTTGCACCTGCCTC-1_Br2720_Ant_IF,2,1,0,0,0,3
GACTGCAAATCGAGCT-1_Br2720_Ant_IF,2,0,0,0,0,2
GTGTATATCAGCGGGC-1_Br2720_Ant_IF,0,0,2,0,1,3
CTTCAACTCCACTTGG-1_Br2720_Ant_IF,1,0,0,0,1,2
ACTTACGCATCCACGC-1_Br2720_Ant_IF,0,2,0,0,0,2
CATGAGATGCACTCTC-1_Br2720_Ant_IF,0,1,1,0,0,2
GAGCACCTGTGTCCAG-1_Br2720_Ant_IF,0,1,0,0,2,3
CGCGACCGCGACAGAT-1_Br2720_Ant_IF,0,2,0,0,0,2
GTCCCGCGACGTTATG-1_Br2720_Ant_IF,0,0,3,0,1,4
GCAGTGTGGCTATAGG-1_Br2720_Ant_IF,0,3,1,0,0,4
ATACTGCCTTACACCG-1_Br2720_Ant_IF,0,2,1,0,3,6
TACAGAAACGGTGGGC-1_Br2720_Ant_IF,0,3,0,0,2,5
GGCGCGGAGATCTTTC-1_Br2720_Ant_IF,1,0,0,0,1,2
CGTTAATGTCCCGACG-1_Br2720_Ant_IF,1,1,0,0,0,2
GCTAACTGAAGTCTGA-1_Br2720_Ant_IF,0,1,0,0,2,3
AGTGATAACCTGCGCG-1_Br2720_Ant_IF,0,1,1,0,2,4
TATGATCTTCTCTTTA-1_Br2720_Ant_IF,0,0,2,0,3,5
TGTACCTACACGAGGG-1_Br2720_Ant_IF,1,2,0,0,0,3
ATATCGTTCCTCGAAC-1_Br2720_Ant_IF,0,0,1,0,1,2
CGGCGCCATCAATCCC-1_Br2720_Ant_IF,1,1,2,0,0,4
CCTGTTTGAAGACACG-1_Br2720_Ant_IF,1,1,3,0,0,5
GCCACTCAGAGCGCGA-1_Br2720_Ant_IF,0,0,3,1,0,4
TCGGCTTGTATCGACG-1_Br2720_Ant_IF,0,0,0,1,1,2
TAGATGGTTCCTTACT-1_Br2720_Ant_IF,3,1,0,0,0,4
ATCGTTAGCTAGCGGA-1_Br2720_Ant_IF,2,1,1,0,0,4
ACAGCGACATTCTCAT-1_Br2720_Ant_IF,0,2,1,0,1,4
ATTCAACCATTTAAGG-1_Br2720_Ant_IF,0,0,1,0,0,1
CACTCTTCTGCTAGCC-1_Br2720_Ant_IF,1,2,1,0,0,4
CTAACTGATAATCGCC-1_Br2720_Ant_IF,1,0,2,0,0,3
TGATGTCAATTAAGTG-1_Br2720_Ant_IF,5,0,1,1,0,7
CGCCGTTCAGCATAGT-1_Br2720_Ant_IF,0,1,4,0,1,6
ATACTACCCGTACCAC-1_Br2720_Ant_IF,3,0,0,0,0,3
CCACTGTTTGGATTAA-1_Br2720_Ant_IF,0,0,2,0,0,2
CACTACGGGAGCTGCC-1_Br2720_Ant_IF,4,0,1,1,0,6
GACCAAACGTTGACTG-1_Br2720_Ant_IF,0,0,3,0,1,4
AAGAGGCCCTTTGGAA-1_Br2720_Ant_IF,3,0,3,0,0,6
ACACGTAGGCCACAAG-1_Br2720_Ant_IF,0,1,1,1,0,3
TACTCTTACTTTACTG-1_Br2720_Ant_IF,0,2,0,1,2,5
AGAGCCGCCGAGATTT-1_Br2720_Ant_IF,2,0,1,0,0,3
GGCCTGCTTCTCCCGA-1_Br2720_Ant_IF,0,0,1,0,0,1
TCAAGCGCGGACGGTA-1_Br2720_Ant_IF,0,1,0,0,0,1
ACACTGGGACAGTCGT-1_Br2720_Ant_IF,4,0,6,1,0,11
TGTGTAGTAGCACGTG-1_Br2720_Ant_IF,2,0,1,0,0,3
CTAGCCACAGGCGAGC-1_Br2720_Ant_IF,1,0,2,0,0,3
CTATCGCGTAGAGAAC-1_Br2720_Ant_IF,2,0,3,1,0,6
GTTCCCGTAAACATAT-1_Br2720_Ant_IF,4,0,2,1,1,8
TCTTTCCTTCGAGATA-1_Br2720_Ant_IF,1,0,2,0,1,4
ATATTGGAGAGGCCTT-1_Br2720_Ant_IF,7,2,1,0,0,10
AGGCGATAACTGGCGT-1_Br2720_Ant_IF,0,0,1,0,0,1
ACCCGGAGCACCACAA-1_Br2720_Ant_IF,2,0,3,0,0,5
TGAGCTCAACTGTATA-1_Br2720_Ant_IF,4,2,1,0,0,7
ACGACCCATGAGTTGC-1_Br2720_Ant_IF,1,0,2,0,0,3
CGGTCAGTCCATATTT-1_Br2720_Ant_IF,1,1,3,0,1,6
TCCGGCTGTCGGGTCG-1_Br2720_Ant_IF,0,0,0,0,0,0
ATTCCCGAAGGTACAG-1_Br2720_Ant_IF,1,0,0,0,0,1
CTAACAGCACAATAAC-1_Br2720_Ant_IF,0,4,0,0,0,4
TTGTGCGGAAGCGGAT-1_Br2720_Ant_IF,2,6,1,1,0,10
GGGCACTATTGACCAT-1_Br2720_Ant_IF,1,4,0,0,1,6
CCATAGAGGCTGCCAG-1_Br2720_Ant_IF,0,5,1,0,0,6
CCGAAGCATTGACCAA-1_Br2720_Ant_IF,0,4,0,0,0,4
TACTGAGGGAAGAAAG-1_Br2720_Ant_IF,1,2,0,0,0,3
TATGTAGAAACCCGGC-1_Br2720_Ant_IF,0,4,0,0,0,4
TGGTTAACTTACATTT-1_Br2720_Ant_IF,1,3,0,0,0,4
AGAACCCTCAATTGGG-1_Br2720_Ant_IF,0,3,0,0,1,4
CCTATATCGTGTCACG-1_Br2720_Ant_IF,0,5,0,0,0,5
ACGGCTGGATGTAGAA-1_Br2720_Ant_IF,3,0,0,0,0,3
CTCGCATTGCATAGCC-1_Br2720_Ant_IF,0,2,0,0,0,2
ACTTTGGTCGTGCTCC-1_Br2720_Ant_IF,0,2,0,0,1,3
GCTGGTTTAGGCCATA-1_Br2720_Ant_IF,1,0,1,0,0,2
TGTCGTTATCACATAT-1_Br2720_Ant_IF,0,2,0,0,2,4
ACACATGATCAAATCT-1_Br2720_Ant_IF,0,1,0,0,0,1
TATCCATCTCGGTTAG-1_Br2720_Ant_IF,0,0,1,0,0,1
CTCGTCGAGGGCTCAT-1_Br2720_Ant_IF,1,1,0,0,1,3
ATCAATGCCGTGGCTG-1_Br2720_Ant_IF,0,1,0,0,0,1
GAAACATAGGAAACAG-1_Br2720_Ant_IF,0,0,0,0,0,0
TAATAGGTCACCAGAA-1_Br2720_Ant_IF,0,2,0,0,0,2
CACCAGTCAGCATGCA-1_Br2720_Ant_IF,0,1,0,0,0,1
GAGCGCTGTTAGGTAA-1_Br2720_Ant_IF,0,0,0,0,1,1
CCCTATGTAGAGCAGA-1_Br2720_Ant_IF,1,2,0,0,0,3
GATCGCTATATCTCAG-1_Br2720_Ant_IF,0,1,0,0,0,1
AAGGGACTATGCATTC-1_Br2720_Ant_IF,1,1,2,0,1,5
CTCGGGTTCTCTGGCC-1_Br2720_Ant_IF,1,3,0,0,1,5
TATATATCGAGAAATG-1_Br2720_Ant_IF,0,1,1,0,1,3
ACCCGAGCGAAATTAC-1_Br2720_Ant_IF,0,1,0,0,2,3
TTGTTTCATTAGTCTA-1_Br2720_Ant_IF,0,2,0,0,1,3
ATGGGACCTGCTGAAC-1_Br2720_Ant_IF,0,1,1,0,0,2
TGCGACGGCCGAACGT-1_Br2720_Ant_IF,1,2,1,0,1,5
AGCTAACAAGCAATGT-1_Br2720_Ant_IF,0,2,0,0,0,2
CGTGTCTCGTTACGAC-1_Br2720_Ant_IF,0,1,0,0,1,2
CTAAATCCGGTGTACA-1_Br2720_Ant_IF,0,1,1,0,0,2
GAATAGTGCTCGATTA-1_Br2720_Ant_IF,0,1,1,0,1,3
AACAATACATTGTCGA-1_Br2720_Ant_IF,0,3,0,0,0,3
CACATCGTGCACGCGC-1_Br2720_Ant_IF,0,0,2,0,1,3
ACCGTGACCACGTGGG-1_Br2720_Ant_IF,0,6,0,0,0,6
CCCAATGAGATTTGCA-1_Br2720_Ant_IF,0,1,0,0,1,2
TCAGCAGTAGGCCCTG-1_Br2720_Ant_IF,1,2,0,0,0,3
CTACTCAAGGTATAGT-1_Br2720_Ant_IF,0,4,0,0,0,4
TAGTAGCTTATACCAG-1_Br2720_Ant_IF,0,4,1,0,0,5
ACGTTCGTTCAGGAAA-1_Br2720_Ant_IF,1,3,0,0,0,4
TTAGAATAAGGGTCGG-1_Br2720_Ant_IF,1,2,2,0,1,6
TTCTAGAAAGTCTTAT-1_Br2720_Ant_IF,0,5,1,0,2,8
CCTTCAGTTAAAGTGA-1_Br2720_Ant_IF,0,1,1,0,2,4
TAGCTAGTGATGATGG-1_Br2720_Ant_IF,0,3,1,0,2,6
AGCCCGGTAGCCTGTA-1_Br2720_Ant_IF,1,2,0,0,1,4
TACCTCAGTTGTCTGT-1_Br2720_Ant_IF,1,1,1,0,2,5
GACGGGTTGGCCCGTA-1_Br2720_Ant_IF,0,3,0,0,3,6
GAAACCTATACAAATG-1_Br2720_Ant_IF,2,2,0,0,2,6
TCCACCTCTAGCCTTT-1_Br2720_Ant_IF,0,1,1,0,3,5
AAGACCCAACTGAACA-1_Br2720_Ant_IF,2,2,0,0,0,4
CATACACGGTTCCCAC-1_Br2720_Ant_IF,1,0,2,0,3,6
ACTACGCGTTAGAATT-1_Br2720_Ant_IF,0,0,2,0,3,5
CTTGGCCAAGCTGGGA-1_Br2720_Ant_IF,0,2,1,0,2,5
TTACCCTAGGGATTGG-1_Br2720_Ant_IF,1,3,1,0,0,5
TTCGCACTGTACGACA-1_Br2720_Ant_IF,0,4,0,0,1,5
TAGGTGTTCCACAGAT-1_Br2720_Ant_IF,0,4,2,0,1,7
GAAGCCTGCACATTCC-1_Br2720_Ant_IF,0,2,1,0,1,4
GGCTTTCAATAAGGGT-1_Br2720_Ant_IF,0,0,1,0,2,3
TCCAGGGTATATACGA-1_Br2720_Ant_IF,0,1,0,0,0,1
CTCGCCGAATGTAGGG-1_Br2720_Ant_IF,0,1,1,0,1,3
AGGAAGCTGTCCGCCG-1_Br2720_Ant_IF,0,1,4,0,1,6
GTCTCAAGGCCCGGCT-1_Br2720_Ant_IF,0,2,0,0,0,2
ACCGACACATCTCCCA-1_Br2720_Ant_IF,0,2,0,0,0,2
TATACGCGTCATCACT-1_Br2720_Ant_IF,1,1,1,0,1,4
ATCTGGGCTGTTCTTG-1_Br2720_Ant_IF,0,2,1,0,0,3
TCAAATTTGAGACTCA-1_Br2720_Ant_IF,1,0,0,0,1,2
GTTAAGGGTGCGATGT-1_Br2720_Ant_IF,0,1,0,0,1,2
AGCAAAGGCCGCTAGT-1_Br2720_Ant_IF,0,0,0,0,0,0
TTATAGGTAATTGTCT-1_Br2720_Ant_IF,1,1,1,0,0,3
TTGTGCAGCCACGTCA-1_Br2720_Ant_IF,0,2,1,0,1,4
ACGGACTCTCAAAGCG-1_Br2720_Ant_IF,1,2,0,0,1,4
ATGCTCTGGCGCGGTA-1_Br2720_Ant_IF,0,0,0,0,1,1
ATAATCTTGGAGAACC-1_Br2720_Ant_IF,0,1,1,0,0,2
CTCATTGCTCTAACAA-1_Br2720_Ant_IF,1,2,0,0,0,3
TAGGTGACGATAACCT-1_Br2720_Ant_IF,1,1,0,0,0,2
CGGATCCTCAAGGACT-1_Br2720_Ant_IF,2,1,1,0,3,7
GGGCGTGGTTTCCCAG-1_Br2720_Ant_IF,0,1,0,0,0,1
TGGCTATGTGACATAC-1_Br2720_Ant_IF,2,2,0,0,1,5
CTTAGTGTAGTAGCAT-1_Br2720_Ant_IF,1,2,1,0,0,4
GGATTGCTGTGACTCC-1_Br2720_Ant_IF,0,1,0,0,0,1
ACTTCCATGCGGGACA-1_Br2720_Ant_IF,0,2,1,0,2,5
ACTCAAGTGCAAGGCT-1_Br2720_Ant_IF,0,0,2,0,1,3
ACAAGGATGCTTTAGG-1_Br2720_Ant_IF,0,2,1,0,0,3
TTGAACGACGTGCTGA-1_Br2720_Ant_IF,1,1,0,0,0,2
ATTCATCGTTGAGGCA-1_Br2720_Ant_IF,0,3,0,0,0,3
TGCAACCCATCTGCGG-1_Br2720_Ant_IF,1,1,1,0,0,3
AGTGCTAAACACAGCA-1_Br2720_Ant_IF,0,0,1,0,2,3
AACTCCAGAGCGTGTT-1_Br2720_Ant_IF,0,2,1,0,1,4
TCTCCACAAGTTGAAT-1_Br2720_Ant_IF,0,2,2,0,1,5
CTTTGCATCGCTCTTG-1_Br2720_Ant_IF,1,0,0,0,0,1
TCACAAACCGAGGTAC-1_Br2720_Ant_IF,0,1,0,0,0,1
CCGTAGGAAATCCCTG-1_Br2720_Ant_IF,0,2,0,0,0,2
AAACATTTCCCGGATT-1_Br2720_Ant_IF,0,2,0,0,0,2
GCCTCCGACAATTCAC-1_Br2720_Ant_IF,1,3,0,0,0,4
TCTGCATACCTTGCTT-1_Br2720_Ant_IF,3,0,1,0,1,5
ACCCATTTGTCCCTCT-1_Br2720_Ant_IF,1,0,1,0,0,2
CTGCAGAGAATCAGAG-1_Br2720_Ant_IF,0,1,3,0,1,5
GGAAACTAAATGGGCC-1_Br2720_Ant_IF,2,1,0,0,0,3
CAACCTACCGAGCAGT-1_Br2720_Ant_IF,0,1,4,0,0,5
CCGTAGGGTTGTTTAC-1_Br2720_Ant_IF,0,0,1,0,2,3
GGTTTGTGACCTGAGG-1_Br2720_Ant_IF,3,0,2,1,0,6
TAACCTAGGGAGTCCA-1_Br2720_Ant_IF,0,1,0,0,0,1
TTCCATCGACAGCGTG-1_Br2720_Ant_IF,0,0,1,0,0,1
ATCTCCCACGGAATAT-1_Br2720_Ant_IF,3,1,2,0,1,7
GTTTCAAACGAGTTGT-1_Br2720_Ant_IF,5,1,0,1,0,7
GGAACTTTGGCGATTA-1_Br2720_Ant_IF,0,1,1,1,0,3
CTGCAAGCACGTTCCG-1_Br2720_Ant_IF,0,1,4,0,1,6
CACAGTCCCGCTTCGC-1_Br2720_Ant_IF,2,0,0,0,1,3
TACGCTCGGTATTGGA-1_Br2720_Ant_IF,3,1,2,0,0,6
CTGGTAAAGTGTGGGC-1_Br2720_Ant_IF,0,0,3,0,0,3
CAACCAGTGGCCTACC-1_Br2720_Ant_IF,2,0,1,1,0,4
TCTTCGCGGTGAGAGG-1_Br2720_Ant_IF,1,0,4,1,0,6
TTCGGGTTGCCACGGG-1_Br2720_Ant_IF,2,0,1,0,0,3
ACCGATAGGCATAACC-1_Br2720_Ant_IF,5,0,0,0,1,6
CTTATAGATGGCTGTT-1_Br2720_Ant_IF,4,0,3,1,0,8
AGACGCCCACTTCGCC-1_Br2720_Ant_IF,2,1,0,1,0,4
AGGTCGCCTCCCAACA-1_Br2720_Ant_IF,1,1,2,0,0,4
CCTCACGTCAGCTAAT-1_Br2720_Ant_IF,2,0,2,0,0,4
CCACCTGTATGGAATA-1_Br2720_Ant_IF,0,0,0,0,0,0
GGACTCGAAGCTTTCA-1_Br2720_Ant_IF,0,0,0,0,0,0
AAACATGGTGAGAGGA-1_Br2720_Ant_IF,0,1,2,1,0,4
ATCATTGTACCGCATT-1_Br2720_Ant_IF,0,1,0,2,0,3
TCAGCTTGAGCTTTCG-1_Br2720_Ant_IF,1,3,0,0,0,4
CCGCGCAAGATACCCA-1_Br2720_Ant_IF,0,0,0,0,0,0
CTATACTTAAAGCGAG-1_Br2720_Ant_IF,1,2,0,0,0,3
ACCGTCCACTGGGCCC-1_Br2720_Ant_IF,1,0,0,0,0,1
AAGACCAAATAACTCA-1_Br2720_Ant_IF,0,6,1,0,0,7
TGTTTCTGAAGCGTGC-1_Br2720_Ant_IF,4,4,0,0,0,8
TTCTCTTACAGGTGAT-1_Br2720_Ant_IF,0,4,0,0,0,4
AATTCATTGTCATGCA-1_Br2720_Ant_IF,0,4,0,0,0,4
GCCCGAGAGTCTAAAT-1_Br2720_Ant_IF,1,2,0,0,0,3
ATATAGAGTATTGGTC-1_Br2720_Ant_IF,0,3,0,0,0,3
TTGAAGGATGGGCGCC-1_Br2720_Ant_IF,0,1,0,0,1,2
TAGTACCACAACTTTC-1_Br2720_Ant_IF,0,4,0,0,0,4
ATCCCATCCACAGCGC-1_Br2720_Ant_IF,0,2,0,0,1,3
CTTAGGTATAGACCAG-1_Br2720_Ant_IF,1,5,0,0,0,6
TGACTCCGAATCATAC-1_Br2720_Ant_IF,0,1,1,0,0,2
ACTACATCCCGACAAG-1_Br2720_Ant_IF,0,0,0,0,0,0
TTGCCGCAGACCTACA-1_Br2720_Ant_IF,2,1,0,0,1,4
TAAGAGGGACAGGGAC-1_Br2720_Ant_IF,0,2,0,0,0,2
CGAATGAAGTCATTGC-1_Br2720_Ant_IF,0,2,0,0,1,3
AAGGGAACGACTGGCT-1_Br2720_Ant_IF,0,1,1,0,2,4
CGAATCTGCTCGACGC-1_Br2720_Ant_IF,0,2,0,0,0,2
ATCGTGGAAAGTCTGG-1_Br2720_Ant_IF,0,1,0,0,1,2
CCTATGGCTCCTAGTG-1_Br2720_Ant_IF,0,0,0,0,0,0
CGTCGCTTGGTTATAC-1_Br2720_Ant_IF,1,1,0,0,0,2
TGCTTAGAGAGAATGC-1_Br2720_Ant_IF,1,2,1,0,2,6
GATTGCTCCAGTTGCA-1_Br2720_Ant_IF,1,2,0,0,0,3
CGTGCTTCTACCTAAA-1_Br2720_Ant_IF,0,2,2,0,1,5
ACTCCAATATCATCAT-1_Br2720_Ant_IF,1,3,1,0,0,5
GCCGACCCACGACTGC-1_Br2720_Ant_IF,0,0,0,0,1,1
GAGGGTAGTAACAAAG-1_Br2720_Ant_IF,0,1,0,0,0,1
GGCCGAGACTCTGGTG-1_Br2720_Ant_IF,2,3,1,0,2,8
TATATAGGGCTTTACG-1_Br2720_Ant_IF,0,2,0,0,0,2
TGCCGGATGTACGAGC-1_Br2720_Ant_IF,0,0,1,0,1,2
AGGTAGATCGAGATAT-1_Br2720_Ant_IF,0,0,4,0,0,4
GATCAACATAAAGGGA-1_Br2720_Ant_IF,1,2,0,0,0,3
TAACAGCGTTTGTGCT-1_Br2720_Ant_IF,0,2,0,0,0,2
CTATAGGCGTTGATGT-1_Br2720_Ant_IF,1,2,0,0,0,3
GGTTTAATTACCATCG-1_Br2720_Ant_IF,1,1,0,0,0,2
CTCTTCTGGAAGTTAG-1_Br2720_Ant_IF,1,4,0,0,0,5
ATCTGACATGGAAGGA-1_Br2720_Ant_IF,1,1,1,0,0,3
TACGTACTAGTGCTGA-1_Br2720_Ant_IF,0,0,1,0,0,1
ATGACTATCAGCTGTG-1_Br2720_Ant_IF,0,1,1,0,1,3
CTTTGGGATTGTTGCA-1_Br2720_Ant_IF,0,5,0,0,0,5
AGACTGTTACCGGGTC-1_Br2720_Ant_IF,1,5,0,0,1,7
TCCTAACCGTCGGGCA-1_Br2720_Ant_IF,0,3,0,0,0,3
ACGCAAACTAATAGAT-1_Br2720_Ant_IF,0,1,0,0,0,1
AAGTGAGTCGGGTTTA-1_Br2720_Ant_IF,0,3,0,0,0,3
TAAAGCGGTATTTCCA-1_Br2720_Ant_IF,0,3,0,0,4,7
CTCCTCCAGCTCACAC-1_Br2720_Ant_IF,0,4,1,0,0,5
CGGTCCGTCGCAAGCC-1_Br2720_Ant_IF,0,1,0,0,0,1
CCTATATTTGTCCTGG-1_Br2720_Ant_IF,0,2,0,0,4,6
TCCAATAAAGGCTACC-1_Br2720_Ant_IF,0,1,0,0,1,2
AAAGGCTACGGACCAT-1_Br2720_Ant_IF,0,1,1,0,1,3
CGTGACCAGTCCTCTG-1_Br2720_Ant_IF,0,2,3,0,1,6
GATCTGCTATCTAAGG-1_Br2720_Ant_IF,2,1,1,0,0,4
CGAATGACGCATAATG-1_Br2720_Ant_IF,1,4,0,0,1,6
GCTCAATGTAATACCG-1_Br2720_Ant_IF,1,0,0,0,1,2
CTATGCCCGAATGCAA-1_Br2720_Ant_IF,0,2,0,0,1,3
CACAGGGCCGTTGTCA-1_Br2720_Ant_IF,0,2,0,0,0,2
TCAATACGCCGTCATG-1_Br2720_Ant_IF,0,4,0,0,2,6
AGCGGACACTTCGTAG-1_Br2720_Ant_IF,1,2,0,0,1,4
ATACGTTATGCACGGA-1_Br2720_Ant_IF,1,2,0,0,1,4
GAGTAGATACTAGTTG-1_Br2720_Ant_IF,1,0,0,0,0,1
CCAGCTCGAACGCATT-1_Br2720_Ant_IF,1,1,2,0,0,4
TGCTTCCCAAGCAGTA-1_Br2720_Ant_IF,0,1,0,0,0,1
GTAGACACGCCTGACT-1_Br2720_Ant_IF,2,2,2,0,2,8
CTCACATTTACTAAAT-1_Br2720_Ant_IF,0,1,1,0,0,2
GAATGCGAATCGGTTC-1_Br2720_Ant_IF,0,4,0,0,0,4
TAAGGCCCGTCACCCT-1_Br2720_Ant_IF,1,1,2,0,0,4
GAGTATGCGCGTGCAT-1_Br2720_Ant_IF,1,1,0,0,0,2
ATCCACATCGACAGAA-1_Br2720_Ant_IF,0,2,0,0,0,2
TAGACGAAACGCCAAT-1_Br2720_Ant_IF,0,4,0,0,0,4
CAGCAGTCTGTGCTGC-1_Br2720_Ant_IF,1,0,1,0,1,3
CTCACTGTGATACTTA-1_Br2720_Ant_IF,0,2,0,0,0,2
TTAATTGCTTTGGGTG-1_Br2720_Ant_IF,0,0,0,0,0,0
GTAGTCTACGATATTG-1_Br2720_Ant_IF,1,0,0,0,1,2
TTGCCGCTTTCTAGTA-1_Br2720_Ant_IF,0,2,2,0,0,4
GAACCTTTAACGATCC-1_Br2720_Ant_IF,0,0,0,0,1,1
TGGACCAATCTAAGAT-1_Br2720_Ant_IF,0,1,2,0,0,3
CTAGTAGAAAGGGATT-1_Br2720_Ant_IF,0,0,1,0,1,2
AACCTCGCTTTAGCCC-1_Br2720_Ant_IF,0,1,0,0,2,3
GAGTGTCAACCAGAAA-1_Br2720_Ant_IF,0,0,0,0,0,0
GTGATCCTTGTCATGA-1_Br2720_Ant_IF,0,1,0,0,1,2
CTCAACTAACCCGGAT-1_Br2720_Ant_IF,0,1,4,0,3,8
AGTGGCGTCTGAAGGT-1_Br2720_Ant_IF,1,3,4,0,0,8
GGGAAGGGCTTTCTCA-1_Br2720_Ant_IF,0,1,0,0,0,1
AGGCCTGAGAATCTCG-1_Br2720_Ant_IF,0,0,4,0,1,5
AGCCACAGGTTACCCG-1_Br2720_Ant_IF,0,0,1,0,0,1
TGCAATCTAACACGGT-1_Br2720_Ant_IF,0,2,1,0,1,4
GTTTGGGTTTCGCCCG-1_Br2720_Ant_IF,1,1,4,0,2,8
CCTATGTCCACTCCAC-1_Br2720_Ant_IF,0,3,4,0,0,7
CTGCCTTTCTAGTAAA-1_Br2720_Ant_IF,0,1,1,0,1,3
TTAGTAAACCTGCTCT-1_Br2720_Ant_IF,0,0,2,0,0,2
TTGTGGTGGTACTAAG-1_Br2720_Ant_IF,1,2,1,0,0,4
CCTCCTGTTGTGTCGT-1_Br2720_Ant_IF,0,0,1,0,1,2
ACAAAGCATGACCTAG-1_Br2720_Ant_IF,0,0,2,0,0,2
ATAGCAACTAGGGAAG-1_Br2720_Ant_IF,1,2,0,0,0,3
CCGCTCTTCCGAACTA-1_Br2720_Ant_IF,3,2,4,1,0,10
TAGAATAGCCGATGAA-1_Br2720_Ant_IF,3,2,0,0,0,5
GGTCTCCGTCCAGGTT-1_Br2720_Ant_IF,1,0,0,0,1,2
TAATTACGTCAGTAGA-1_Br2720_Ant_IF,0,0,1,0,0,1
TACGTAAAGCGGAGTG-1_Br2720_Ant_IF,1,1,1,0,1,4
GCTACAATCGAGGATA-1_Br2720_Ant_IF,0,0,1,0,0,1
TCAGCCAATCCGTAAA-1_Br2720_Ant_IF,1,0,0,0,0,1
ATCATAGCCCTATGTA-1_Br2720_Ant_IF,2,0,0,2,0,4
GAGGCCTGTTGATACA-1_Br2720_Ant_IF,2,1,2,0,1,6
ATATACGCTCGTGACG-1_Br2720_Ant_IF,0,0,1,0,0,1
CCCTTTAATGGAGTTC-1_Br2720_Ant_IF,1,0,2,0,0,3
TTACACGATCTGCGAC-1_Br2720_Ant_IF,0,0,2,0,1,3
TCGCATAAAGGGCGCA-1_Br2720_Ant_IF,0,0,1,0,1,2
TGTAGCCATCCCATTC-1_Br2720_Ant_IF,1,1,3,0,0,5
GGGTCTATCGCTTTCC-1_Br2720_Ant_IF,2,0,0,0,0,2
GGAGGGTCAAGTAAGA-1_Br2720_Ant_IF,1,0,0,0,0,1
TACGGCATGGACGCTA-1_Br2720_Ant_IF,3,0,6,0,0,9
CACGTCAATCAATGGA-1_Br2720_Ant_IF,1,2,1,0,0,4
CGCTTGGACGGATAGA-1_Br2720_Ant_IF,0,0,0,0,0,0
CGCGGTACGGTATACA-1_Br2720_Ant_IF,1,0,1,1,0,3
CGTTTGGTGTTGTGGG-1_Br2720_Ant_IF,0,0,0,0,0,0
GGACAAGCCATGATCG-1_Br2720_Ant_IF,0,1,0,0,0,1
TCCAATGCGTCGCCGC-1_Br2720_Ant_IF,1,4,0,3,0,8
AAAGAATGACCTTAGA-1_Br2720_Ant_IF,0,2,1,0,0,3
CCTATTATTCCGGCCG-1_Br2720_Ant_IF,0,1,0,3,0,4
CAGTAAGGGACGTCTC-1_Br2720_Ant_IF,3,0,2,2,1,8
GGGATGGACCCGCGTC-1_Br2720_Ant_IF,3,0,0,0,0,3
GACGCATACCCGTCGG-1_Br2720_Ant_IF,0,1,0,0,0,1
GGGCAGGATTTCTGTG-1_Br2720_Ant_IF,0,1,1,0,0,2
TATCTGAGCCGATATT-1_Br2720_Ant_IF,2,4,1,0,0,7
AATGTATGGCACTGTA-1_Br2720_Ant_IF,2,4,0,0,0,6
GCCTTTGTCAGTGGAC-1_Br2720_Ant_IF,0,4,0,0,0,4
AACCATAGGGTTGAAC-1_Br2720_Ant_IF,0,1,0,0,1,2
AAACTTAATTGCACGC-1_Br2720_Ant_IF,0,1,1,0,0,2
TAGGCGGCTGCAAAGA-1_Br2720_Ant_IF,0,0,1,0,1,2
TCCATCAATACTAATC-1_Br2720_Ant_IF,0,1,0,0,0,1
ACCTCGAACTTATGCT-1_Br2720_Ant_IF,0,2,0,0,0,2
ACAAACCATGCGTCCT-1_Br2720_Ant_IF,0,1,0,0,0,1
ACACCGGTCTGACCGC-1_Br2720_Ant_IF,0,2,2,0,0,4
ATGGCAGCATTACGAT-1_Br2720_Ant_IF,2,2,2,0,0,6
CTGGTGAATGGGCCTA-1_Br2720_Ant_IF,0,2,0,0,1,3
CACAGAGACGAGGACG-1_Br2720_Ant_IF,0,4,0,0,1,5
GCACAAACCCTAGATG-1_Br2720_Ant_IF,1,1,0,0,0,2
ACTATGTCCAGCTGCC-1_Br2720_Ant_IF,0,2,0,0,1,3
AAGCCGCCGTGAAATC-1_Br2720_Ant_IF,0,4,0,0,1,5
ATGGGTGTATACCTCC-1_Br2720_Ant_IF,0,2,0,0,0,2
TAAGCGCGAATCAAAT-1_Br2720_Ant_IF,0,3,1,0,1,5
AGCCCGGCATTAGAGG-1_Br2720_Ant_IF,0,2,0,0,1,3
GTGATCAAGCGTGCAC-1_Br2720_Ant_IF,0,5,0,0,0,5
CTGCCTTTAATACCTT-1_Br2720_Ant_IF,0,0,0,0,0,0
TACCTCCACACCAATG-1_Br2720_Ant_IF,2,1,0,0,1,4
GAGCATCAACAACTTG-1_Br2720_Ant_IF,1,4,0,0,0,5
CATACGAACTAGCTGG-1_Br2720_Ant_IF,0,2,0,0,2,4
GGGAACGGTTTCAGAT-1_Br2720_Ant_IF,1,0,0,0,1,2
AGGGTGCCGTTCTTTA-1_Br2720_Ant_IF,0,1,0,0,0,1
ACGACTGGTCATACTC-1_Br2720_Ant_IF,1,0,0,0,1,2
GGATCTTACTGCCCTT-1_Br2720_Ant_IF,3,2,0,0,0,5
TACTCCTCTAGTTGAC-1_Br2720_Ant_IF,0,3,0,0,0,3
GTAGCTCCGGGAGGCT-1_Br2720_Ant_IF,0,2,0,0,0,2
GGACTCGTGAGTGGTC-1_Br2720_Ant_IF,0,0,0,0,1,1
GTAGTTCGAAGGCGAA-1_Br2720_Ant_IF,0,2,1,0,0,3
CTCAAACCACTGCCCG-1_Br2720_Ant_IF,5,3,0,0,0,8
GAGGGAGTCAGATCGC-1_Br2720_Ant_IF,0,3,1,0,1,5
GCGTCCCTAAGACATA-1_Br2720_Ant_IF,1,0,2,0,0,3
TCTCTTACCGCGAACC-1_Br2720_Ant_IF,0,2,0,0,0,2
GGCTACTATACACTCC-1_Br2720_Ant_IF,1,2,0,0,0,3
CGTTGCCCGCGTGGGA-1_Br2720_Ant_IF,1,1,0,0,0,2
TATAGAGTCGCTTGAA-1_Br2720_Ant_IF,0,3,0,0,1,4
ATGTTGTAGTCTGTTT-1_Br2720_Ant_IF,0,2,0,0,2,4
AGTATACACAGCGACA-1_Br2720_Ant_IF,0,3,0,0,1,4
TGTGGTTGCTAAAGCT-1_Br2720_Ant_IF,0,2,1,0,2,5
TGATTCCCGGTTACCT-1_Br2720_Ant_IF,2,2,0,0,0,4
CACTGACGATTGTGGA-1_Br2720_Ant_IF,2,2,1,0,1,6
AACATTGTGACTCGAG-1_Br2720_Ant_IF,1,6,0,0,2,9
GTCCAATATTTAGCCT-1_Br2720_Ant_IF,0,1,1,0,0,2
GCTCTTTCCGCTAGTG-1_Br2720_Ant_IF,0,1,1,0,1,3
GGGTCAGGAGCTAGAT-1_Br2720_Ant_IF,0,2,1,0,3,6
AGGTGGTGACCTTCGC-1_Br2720_Ant_IF,0,2,0,0,4,6
CCCGGGTCGTTCAGGG-1_Br2720_Ant_IF,0,1,0,0,2,3
AGCCAAGCTTTGTGTC-1_Br2720_Ant_IF,0,2,0,0,1,3
TGTGGCGGGCTTCTGG-1_Br2720_Ant_IF,0,2,2,0,2,6
CGAGGGTATCCAGGTG-1_Br2720_Ant_IF,1,3,0,0,1,5
CGTTCAGACCCGCGAA-1_Br2720_Ant_IF,0,0,1,0,1,2
TCATATGAGCTTTGTT-1_Br2720_Ant_IF,1,1,0,0,1,3
AGTTGACGGTCCTTGC-1_Br2720_Ant_IF,0,1,0,0,2,3
ATAATTAGCTAAGTAG-1_Br2720_Ant_IF,1,3,1,0,1,6
GGTCTTGAGCGCTCTT-1_Br2720_Ant_IF,0,0,0,0,0,0
CGTTGTCGGCAATTGA-1_Br2720_Ant_IF,0,0,1,0,1,2
TCTTGCTCCCGATACT-1_Br2720_Ant_IF,1,3,3,0,0,7
AGCAGAAGGAGAAAGA-1_Br2720_Ant_IF,1,2,0,0,0,3
GAAGCCACTGATTATG-1_Br2720_Ant_IF,0,2,0,0,1,3
TGCTCTTGAGAGTTTG-1_Br2720_Ant_IF,1,5,0,0,1,7
GACATCCGTCGAACTG-1_Br2720_Ant_IF,0,1,0,0,1,2
AGATATAATACGACTA-1_Br2720_Ant_IF,2,3,0,0,1,6
TCGCTACTGGCTTTGA-1_Br2720_Ant_IF,0,3,0,0,1,4
GTGACAGCTTCCCACT-1_Br2720_Ant_IF,0,3,1,0,1,5
GTGACGCAGGTTTCAT-1_Br2720_Ant_IF,3,1,0,0,0,4
GGGAAGACGGTCTGTC-1_Br2720_Ant_IF,0,3,1,0,0,4
CGTCGCATGTGAGCCA-1_Br2720_Ant_IF,0,0,0,0,0,0
AGAAGGTTGTAGGTCG-1_Br2720_Ant_IF,0,1,0,0,0,1
GGCCGGCGTCTGCTAT-1_Br2720_Ant_IF,0,2,1,0,0,3
TTGACCAGGAACAACT-1_Br2720_Ant_IF,0,2,2,0,2,6
AGTCGTATAAAGCAGA-1_Br2720_Ant_IF,0,0,0,0,1,1
GGCGTAGGGAAAGCTG-1_Br2720_Ant_IF,0,2,1,0,1,4
AAACCTAAGCAGCCGG-1_Br2720_Ant_IF,0,0,2,0,0,2
ATTGCCTTTATGTTTG-1_Br2720_Ant_IF,0,1,0,0,2,3
CAGGCAGTCTTACCAG-1_Br2720_Ant_IF,0,1,0,0,1,2
AGCTAAGTACGCAGGC-1_Br2720_Ant_IF,0,1,0,0,0,1
AAATCCGATACACGCC-1_Br2720_Ant_IF,0,3,1,0,0,4
CGAGAGCTTTCACTAC-1_Br2720_Ant_IF,1,0,0,0,0,1
CGCCCAGCGTTTCACG-1_Br2720_Ant_IF,0,1,1,0,1,3
TTAAGTATTGTTATCC-1_Br2720_Ant_IF,1,1,0,0,2,4
AAACGGGCGTACGGGT-1_Br2720_Ant_IF,0,2,1,0,0,3
GTATCCTTTGGTAACC-1_Br2720_Ant_IF,0,0,0,0,1,1
CATAGTCAAATACATA-1_Br2720_Ant_IF,1,2,4,0,0,7
TCTATGCTATAACGAC-1_Br2720_Ant_IF,0,1,2,0,1,4
ACGTTCTGTACAAGTC-1_Br2720_Ant_IF,0,1,0,0,0,1
CGCGAAGTGGCATACT-1_Br2720_Ant_IF,0,1,0,0,2,3
ACCAACCGCACTCCAC-1_Br2720_Ant_IF,1,1,0,0,1,3
GTCATGCGCGAGGGCT-1_Br2720_Ant_IF,0,2,1,0,0,3
TAGGCTAAAGTGGCAC-1_Br2720_Ant_IF,1,1,0,0,0,2
TGGCTACACTCTACCT-1_Br2720_Ant_IF,0,1,2,0,1,4
TGTCCACGGCTCAACT-1_Br2720_Ant_IF,2,1,1,0,0,4
AATTGCAGCAATCGAC-1_Br2720_Ant_IF,1,0,1,0,0,2
GTCAACCAGGCCTATA-1_Br2720_Ant_IF,0,0,1,0,3,4
ATCTTATCGCACACCC-1_Br2720_Ant_IF,0,2,1,0,1,4
GTCTATTGCATGCTCG-1_Br2720_Ant_IF,0,3,1,0,1,5
GCACGTGGTTTACTTA-1_Br2720_Ant_IF,1,0,3,0,0,4
ATTCGCGCCTTGAGAG-1_Br2720_Ant_IF,3,0,0,0,0,3
AGCGATGCGCCTAATA-1_Br2720_Ant_IF,2,0,0,0,1,3
TCTATAGGTGGGTAAT-1_Br2720_Ant_IF,0,0,2,0,2,4
AGATACCAATAGAACC-1_Br2720_Ant_IF,0,2,1,0,0,3
CGTGTATGGGAGCTGA-1_Br2720_Ant_IF,1,1,1,0,0,3
ATGTACATGCGGTGAG-1_Br2720_Ant_IF,1,0,1,0,0,2
GTTCGGAGCACTCAAC-1_Br2720_Ant_IF,2,0,0,0,0,2
TGTAAGACTGATAAGA-1_Br2720_Ant_IF,0,0,0,1,0,1
CGGTTTACTGAACATT-1_Br2720_Ant_IF,0,0,0,0,0,0
GAGATCGATCTTACTC-1_Br2720_Ant_IF,0,0,0,0,0,0
TCTTTCATCCGTCCTT-1_Br2720_Ant_IF,0,1,0,0,0,1
TCGGATCTGGATGACC-1_Br2720_Ant_IF,0,0,0,0,0,0
GTCCTAGGATACCTTA-1_Br2720_Ant_IF,0,0,0,1,0,1
TGTACCCGACCCTAAT-1_Br2720_Ant_IF,1,0,0,0,0,1
AGGTTCTCCTTTCCGG-1_Br2720_Ant_IF,0,1,0,0,0,1
AATTGCGTGGATTACA-1_Br2720_Ant_IF,1,4,0,0,0,5
CGATAGCGATACAGTG-1_Br2720_Ant_IF,0,2,0,0,0,2
CGCCCTAATTGTTCAA-1_Br2720_Ant_IF,4,2,0,0,0,6
ATTATGAGACCCAATT-1_Br2720_Ant_IF,0,4,2,0,0,6
CCTCCTAGCTAGAGTC-1_Br2720_Ant_IF,0,4,0,0,0,4
CGAAGGGTTTCAGATT-1_Br2720_Ant_IF,2,1,0,0,0,3
CACAAGCTAAGAAAGG-1_Br2720_Ant_IF,2,5,0,0,0,7
CACCGGTAGAGACATT-1_Br2720_Ant_IF,0,0,0,0,0,0
ACTCATGGCAGCCTTC-1_Br2720_Ant_IF,0,2,0,0,0,2
CATCCAATATAGTTTG-1_Br2720_Ant_IF,0,2,0,0,1,3
CAGATATGAAGATGAC-1_Br2720_Ant_IF,0,4,0,0,0,4
GCAAAGGGCGTTAGCC-1_Br2720_Ant_IF,0,1,1,0,1,3
CTGTTGTTCAGTCGTA-1_Br2720_Ant_IF,0,2,0,0,2,4
AAAGGCCCTATAATAC-1_Br2720_Ant_IF,0,2,0,0,0,2
AACATTGAAGTTGATC-1_Br2720_Ant_IF,0,0,0,0,1,1
GCTAGCGATAGGTCTT-1_Br2720_Ant_IF,0,2,0,0,0,2
ATTGCCTATTAGACCG-1_Br2720_Ant_IF,0,1,2,0,0,3
GGGCGTTTACATTCAT-1_Br2720_Ant_IF,0,1,0,0,0,1
CCTCTACAAGGATTGG-1_Br2720_Ant_IF,0,0,2,0,0,2
AGTGACTGTGACACAA-1_Br2720_Ant_IF,0,5,0,0,1,6
AGCCCTCCCTGGTGGC-1_Br2720_Ant_IF,2,1,0,0,1,4
CGGTTGAGTATCCTTC-1_Br2720_Ant_IF,0,0,1,0,3,4
CATTATCCCATTAACG-1_Br2720_Ant_IF,0,2,0,0,0,2
AATGTGCTAATCTGAG-1_Br2720_Ant_IF,1,1,1,0,0,3
CTTAGTTGAGGAATCG-1_Br2720_Ant_IF,0,0,2,0,1,3
CTTCTGGGCGTACCTA-1_Br2720_Ant_IF,1,2,0,0,0,3
AGTCAAATGATGTGAT-1_Br2720_Ant_IF,0,2,0,0,1,3
TGAACAAGCAGGGACT-1_Br2720_Ant_IF,0,1,0,0,1,2
AATACCGGAGGGCTGT-1_Br2720_Ant_IF,0,0,0,0,0,0
GTTTGGTGATCGGTGC-1_Br2720_Ant_IF,0,2,0,0,0,2
GACTGCTGGTGAGAAA-1_Br2720_Ant_IF,1,1,0,0,1,3
CGATCCTCGCAACATA-1_Br2720_Ant_IF,0,1,0,0,0,1
CCAACCTTATGTAACT-1_Br2720_Ant_IF,0,1,0,0,0,1
CGTGGTACCCAAAGGC-1_Br2720_Ant_IF,1,2,0,0,0,3
AACCCGACAACCCGTG-1_Br2720_Ant_IF,0,0,3,0,1,4
TATGTAAAGTGCTTAA-1_Br2720_Ant_IF,1,2,0,0,1,4
GCAAGTGTAAAGCATG-1_Br2720_Ant_IF,0,1,1,0,1,3
GTAACTGCCCAAGGAG-1_Br2720_Ant_IF,1,1,0,0,1,3
GGTGCATAAATGATTA-1_Br2720_Ant_IF,0,4,1,0,1,6
TAGTCCCGGAGACCAC-1_Br2720_Ant_IF,0,0,0,0,0,0
CGGCCAGAGCGACCAT-1_Br2720_Ant_IF,0,1,1,0,0,2
TGAATGAGTGTTTCCC-1_Br2720_Ant_IF,1,1,0,0,0,2
TTCACTTCCTAGAACG-1_Br2720_Ant_IF,0,2,4,0,2,8
CGCTTAGTATTGATAC-1_Br2720_Ant_IF,0,0,0,0,1,1
AACGCGACCTTGGGCG-1_Br2720_Ant_IF,1,1,0,0,0,2
GTGCACCAGCTTCAAC-1_Br2720_Ant_IF,1,3,4,0,1,9
TTCTATTAAACGCAGC-1_Br2720_Ant_IF,3,4,0,0,0,7
TGGCAAGCACAAGTCG-1_Br2720_Ant_IF,0,2,1,0,6,9
ATCTGCTGTTATCGCC-1_Br2720_Ant_IF,1,1,2,0,1,5
AATTCCAAGCATGTAC-1_Br2720_Ant_IF,1,1,0,0,0,2
AAACGGTTGCGAACTG-1_Br2720_Ant_IF,1,3,0,0,1,5
GAAGGAGTCGAGTGCG-1_Br2720_Ant_IF,0,1,0,0,1,2
GGCAAGCCCATAGTGG-1_Br2720_Ant_IF,1,3,0,0,0,4
TGACCAAATCTTAAAC-1_Br2720_Ant_IF,0,1,0,0,1,2
TTCGGTACTGTAGAGG-1_Br2720_Ant_IF,0,2,0,0,2,4
ATGTACGATGACGTCG-1_Br2720_Ant_IF,2,0,0,0,0,2
ATCTAGCTTGTGAGGG-1_Br2720_Ant_IF,0,1,0,0,1,2
AGCGGGTCTGACACTC-1_Br2720_Ant_IF,0,1,0,0,1,2
GAGGTACGCGTGTCCC-1_Br2720_Ant_IF,0,1,0,0,2,3
GCACTGCCTACCTTTA-1_Br2720_Ant_IF,1,1,0,0,0,2
GGAGCGAGGCCTACTT-1_Br2720_Ant_IF,1,0,0,0,0,1
AAACTCGGTTCGCAAT-1_Br2720_Ant_IF,2,2,0,0,0,4
GGCGCTTCATTCCCTG-1_Br2720_Ant_IF,1,0,1,0,1,3
TGCTCGGTGGGTCACC-1_Br2720_Ant_IF,0,3,1,0,0,4
AAGCGCAGGGCTTTGA-1_Br2720_Ant_IF,0,3,2,0,1,6
GACCTTCCACGTCTAC-1_Br2720_Ant_IF,0,1,0,0,0,1
GTTAGCCCATGACATC-1_Br2720_Ant_IF,0,1,1,0,1,3
AATTCGATTCGAGGAT-1_Br2720_Ant_IF,1,2,0,0,1,4
AGTCTTTAAAGTGTCC-1_Br2720_Ant_IF,0,1,1,0,3,5
GACTAGGCCGTTAGGT-1_Br2720_Ant_IF,0,7,0,0,0,7
TCCAAGCCTAGACACA-1_Br2720_Ant_IF,1,1,0,0,1,3
GATTGGGAAAGGTTGT-1_Br2720_Ant_IF,0,0,0,0,1,1
GATGAGGAACCTTCGG-1_Br2720_Ant_IF,0,0,0,0,0,0
TGAATACCGACGCGTA-1_Br2720_Ant_IF,7,1,0,1,0,9
AATCGTGAGCCGAGCA-1_Br2720_Ant_IF,8,2,0,0,0,10
GCGAAGAATCTGACGG-1_Br2720_Ant_IF,0,1,0,0,0,1
GAACAACTGGGATGAA-1_Br2720_Ant_IF,0,4,0,0,0,4
TCGCCGACATATTCGC-1_Br2720_Ant_IF,2,0,2,0,0,4
CGTAGAGAGTAATTAT-1_Br2720_Ant_IF,2,3,1,0,1,7
CGATAGTCGTACTGCA-1_Br2720_Ant_IF,0,4,1,0,1,6
CGCATGCCGAATGCGT-1_Br2720_Ant_IF,0,3,0,0,0,3
CTCTAGCCCTCGGAAA-1_Br2720_Ant_IF,0,0,1,0,2,3
TCCAACTCAGCTATCT-1_Br2720_Ant_IF,0,3,1,0,0,4
GTCTAGTGAGCCGCTT-1_Br2720_Ant_IF,0,2,0,0,2,4
TACCGAATAATTGTAA-1_Br2720_Ant_IF,0,1,0,0,1,2
ATATAACACGGGCGCA-1_Br2720_Ant_IF,0,0,1,0,2,3
GCATGCTAATAACGAT-1_Br2720_Ant_IF,1,3,1,0,0,5
TCCGGGCTTGACGGGA-1_Br2720_Ant_IF,0,1,1,0,1,3
ATTATTCAGAGTCACT-1_Br2720_Ant_IF,0,1,0,0,1,2
TAGCAGTATGACTAAA-1_Br2720_Ant_IF,0,1,0,0,0,1
TATGAAGAATTAAGGT-1_Br2720_Ant_IF,2,0,2,0,1,5
CAAGGCCAGTGGTGCA-1_Br2720_Ant_IF,0,2,1,0,1,4
TGCGTACGGCTAATTG-1_Br2720_Ant_IF,0,0,0,0,1,1
CAGATAATGGGCGGGT-1_Br2720_Ant_IF,2,1,0,5,0,8
GAGAACGGTTCTGACT-1_Br2720_Ant_IF,1,0,1,0,0,2
CGCTTCGGTCTAAGAC-1_Br2720_Ant_IF,1,0,0,0,0,1
AGCATTACGAGGCAAG-1_Br2720_Ant_IF,0,0,0,0,0,0
AAGTTGTGATGTTATA-1_Br2720_Ant_IF,2,1,1,0,0,4
TACTTAAACATGTACA-1_Br2720_Ant_IF,2,0,2,0,0,4
ATTACGGGCTACGGTT-1_Br2720_Ant_IF,0,0,0,0,0,0
GCAAACGTAAGCGACC-1_Br2720_Ant_IF,0,1,0,2,0,3
TTCGGACTGGGCATGG-1_Br2720_Ant_IF,0,3,0,3,0,6
GGGCCATTCGTGCTGG-1_Br2720_Ant_IF,0,3,0,2,0,5
GAGTTGTCACCAGTCT-1_Br2720_Ant_IF,0,1,1,0,0,2
AGTAATTTGCAAGCGT-1_Br2720_Ant_IF,0,0,0,0,0,0
GTGGCCGGTTTCTCGG-1_Br2720_Ant_IF,0,4,0,0,0,4
ATCTTAGGGCATTAAT-1_Br2720_Ant_IF,3,1,0,0,0,4
CTACATATCGCGGGAC-1_Br2720_Ant_IF,0,2,1,0,0,3
ATGGTATTTACTGATT-1_Br2720_Ant_IF,2,0,0,0,0,2
CCGTCAACCTCTGGCG-1_Br2720_Ant_IF,0,6,0,0,0,6
GCTTCGACGTTCAATC-1_Br2720_Ant_IF,0,5,0,0,0,5
GACCGATTAAATATGT-1_Br2720_Ant_IF,0,0,0,0,1,1
GTCGAATTTGGGCGCT-1_Br2720_Ant_IF,0,2,1,0,1,4
TCACGGCCCAAGAGAG-1_Br2720_Ant_IF,0,3,0,0,0,3
CTACGATCCTATCCTA-1_Br2720_Ant_IF,8,2,0,1,0,11
TGCAGTGGTAGGGAAC-1_Br2720_Ant_IF,0,0,0,0,1,1
TTGCCTAATCCAAAGT-1_Br2720_Ant_IF,0,2,0,0,0,2
AGCGAGACGTGAAGGC-1_Br2720_Ant_IF,1,5,0,0,0,6
TTCTACCTCAATCGGT-1_Br2720_Ant_IF,0,3,0,0,0,3
TACGCTGCTGTGTTAA-1_Br2720_Ant_IF,0,2,0,0,0,2
TAGTCCTGCACTAAGC-1_Br2720_Ant_IF,0,0,0,0,4,4
AGCACACGTTTAGACT-1_Br2720_Ant_IF,0,0,0,0,0,0
GTTCGACAATTGTATA-1_Br2720_Ant_IF,1,2,1,0,0,4
CCATGTTCATCTATAT-1_Br2720_Ant_IF,0,0,0,0,1,1
CCCTCGATAATACACA-1_Br2720_Ant_IF,0,1,0,0,0,1
ACTGCCCGCCATTCTC-1_Br2720_Ant_IF,1,2,0,0,0,3
CTATATCCAGCCTGGC-1_Br2720_Ant_IF,0,0,0,0,0,0
CGCACGTCTGTTTATG-1_Br2720_Ant_IF,0,0,0,0,1,1
AATCAGGTTTCATTTA-1_Br2720_Ant_IF,0,1,1,0,1,3
AGAGAAACACCAGAAA-1_Br2720_Ant_IF,2,4,4,0,0,10
ACCCGATTGGTTCCGA-1_Br2720_Ant_IF,3,4,0,0,0,7
TACCAGGAATCCCGTC-1_Br2720_Ant_IF,2,1,0,0,0,3
AAGTGCTTCTCTATTG-1_Br2720_Ant_IF,0,1,0,0,0,1
TGCATGTGACCCATAG-1_Br2720_Ant_IF,1,2,0,0,0,3
TAGATTCAAAGTGCGG-1_Br2720_Ant_IF,1,1,0,0,0,2
AGGGTCAGAGCACTCG-1_Br2720_Ant_IF,0,0,1,0,1,2
GTGAGATAACCTTATA-1_Br2720_Ant_IF,1,0,0,0,0,1
GTGTCAGTGTACGTGG-1_Br2720_Ant_IF,8,4,0,0,0,12
CTGTAGTGAGGATCGA-1_Br2720_Ant_IF,1,4,0,0,0,5
GATAGTGCGAGTAAGT-1_Br2720_Ant_IF,0,2,2,0,2,6
AGGGTTCAGACGGTCC-1_Br2720_Ant_IF,0,2,0,0,0,2
GGACTCGACAGCGCAT-1_Br2720_Ant_IF,1,1,0,0,0,2
CACTCTCAAGCATCGA-1_Br2720_Ant_IF,0,2,0,0,1,3
GAGCGGAATGCGGTGT-1_Br2720_Ant_IF,0,4,1,0,1,6
CAGTTCGAGGACCCGA-1_Br2720_Ant_IF,0,3,1,0,0,4
CGTAACTTCGACACTT-1_Br2720_Ant_IF,0,0,0,0,0,0
TGATCACCACACTGAC-1_Br2720_Ant_IF,0,0,0,0,3,3
CATACTTCTTTCTCCG-1_Br2720_Ant_IF,0,1,0,0,0,1
CAAGTAAGTGATAGAC-1_Br2720_Ant_IF,0,1,0,0,0,1
AGCCCGCAACAAGCAG-1_Br2720_Ant_IF,2,1,0,0,0,3
GCTCCATGCAAAGCAA-1_Br2720_Ant_IF,0,2,5,0,1,8
TCGTACCGACGTCAAG-1_Br2720_Ant_IF,0,2,2,0,0,4
ATTATCGGAATGTACG-1_Br2720_Ant_IF,0,2,1,0,0,3
ACCTACTATAAATCTA-1_Br2720_Ant_IF,1,0,0,0,1,2
TATCCTATCAACTGGT-1_Br2720_Ant_IF,2,1,3,0,0,6
GCGCGGTCTAGTAACT-1_Br2720_Ant_IF,0,1,1,0,2,4
CCTTCGTATAGAATCC-1_Br2720_Ant_IF,2,4,0,0,0,6
TGGGCGATACAATAAG-1_Br2720_Ant_IF,0,0,0,0,0,0
TGACATGTAACGTGAC-1_Br2720_Ant_IF,0,3,0,0,0,3
TTGGGAAGACGAGCCG-1_Br2720_Ant_IF,0,1,0,0,2,3
GGTGTAAATCGATTGT-1_Br2720_Ant_IF,0,0,0,0,2,2
GAACTGTGGAGAGACA-1_Br2720_Ant_IF,0,2,1,0,1,4
TCCACATCGTATATTG-1_Br2720_Ant_IF,0,3,0,0,1,4
CCTATGGTCAAAGCTG-1_Br2720_Ant_IF,3,1,1,0,0,5
TCCTTGTCCTTTAATT-1_Br2720_Ant_IF,0,2,0,0,1,3
AAGTTTATGGGCCCAA-1_Br2720_Ant_IF,0,1,0,0,1,2
GTCCGGGTTCACATTA-1_Br2720_Ant_IF,0,2,0,0,2,4
ATGTAGCGCGCGTAGG-1_Br2720_Ant_IF,0,1,0,0,0,1
TACGGAAGCCAAACCA-1_Br2720_Ant_IF,0,4,0,0,1,5
GCCCTGAGGATGGGCT-1_Br2720_Ant_IF,1,4,0,0,1,6
CGGGCGATGGATCACG-1_Br2720_Ant_IF,0,2,0,0,0,2
TGCGGACTTGACTCCG-1_Br2720_Ant_IF,0,0,0,0,1,1
TAATACTAGAACAGAC-1_Br2720_Ant_IF,0,2,1,0,0,3
TCAAATTGTTGTGCCG-1_Br2720_Ant_IF,0,3,0,0,0,3
GGGCAGTCAACGCCAA-1_Br2720_Ant_IF,0,1,0,0,0,1
TCGCTGCCAATGCTGT-1_Br2720_Ant_IF,0,1,0,0,0,1
TACGTGGGCCCAGGGC-1_Br2720_Ant_IF,0,1,1,0,0,2
GCCTACGTTCTGTGCA-1_Br2720_Ant_IF,1,1,3,0,0,5
TTGCGTGTGTAGGCAT-1_Br2720_Ant_IF,1,0,1,0,2,4
TCCTAAAGATTCAGAC-1_Br2720_Ant_IF,2,1,1,0,0,4
TGGGTGCACAAGCCAT-1_Br2720_Ant_IF,0,1,0,0,0,1
GGGAGCGACCGTAGTG-1_Br2720_Ant_IF,1,6,0,0,0,7
CATAGAGGAGATACTA-1_Br2720_Ant_IF,0,0,2,0,0,2
CTTCGATTGCGCAAGC-1_Br2720_Ant_IF,0,0,0,0,0,0
GTGCCTGAGACCAAAC-1_Br2720_Ant_IF,1,1,2,0,1,5
TCATCCTCAGCTGCTT-1_Br2720_Ant_IF,0,0,1,0,1,2
TGCAACTACTGGTTGA-1_Br2720_Ant_IF,3,1,0,0,0,4
ATGTTGATTAGAGACT-1_Br2720_Ant_IF,1,3,0,0,0,4
GTTTCTAGAGGCGCGG-1_Br2720_Ant_IF,1,4,0,0,0,5
TACAAGGGCTTCTTTA-1_Br2720_Ant_IF,3,0,2,0,2,7
ACAGGCACGGATCCTT-1_Br2720_Ant_IF,1,0,0,0,2,3
CCCAAGTCATTACACT-1_Br2720_Ant_IF,0,1,1,0,1,3
ACTCTGACCTAATAGA-1_Br2720_Ant_IF,0,1,0,0,1,2
GGATGGCTTGAAGTAT-1_Br2720_Ant_IF,1,0,1,0,1,3
ACCCTCCCGTCAGGGC-1_Br2720_Ant_IF,0,0,1,0,1,2
AGCTTCTTCTCGAGCA-1_Br2720_Ant_IF,0,1,1,0,1,3
TGGGTGTAATAGATTT-1_Br2720_Ant_IF,2,0,1,0,1,4
TTGCCTTCTCGCCGGG-1_Br2720_Ant_IF,0,0,0,0,0,0
GCTGAAGGGTTCTTGG-1_Br2720_Ant_IF,0,0,0,1,0,1
TAATTGCGCTGATTAC-1_Br2720_Ant_IF,0,0,0,0,0,0
TCGCGCGTTTACATGA-1_Br2720_Ant_IF,0,1,0,0,0,1
TAACTGAAATACGCCT-1_Br2720_Ant_IF,0,0,0,0,0,0
CCTGTCGTGTATGAAG-1_Br2720_Ant_IF,0,1,1,0,0,2
CGGGAACGCCCTGCAT-1_Br2720_Ant_IF,0,1,1,3,0,5
AGTTGCGGTCCTCAAC-1_Br2720_Ant_IF,0,1,0,2,0,3
GGGTCCTTGGAAGAAG-1_Br2720_Ant_IF,0,1,0,0,0,1
CGGGAAGTACCGTGGC-1_Br2720_Ant_IF,0,0,0,0,0,0
ACGGTCACCGAGAACA-1_Br2720_Ant_IF,0,0,0,0,0,0
TAGACTCAGTTGGCCT-1_Br2720_Ant_IF,0,3,0,0,0,3
CCTTCCGCAACGCTGC-1_Br2720_Ant_IF,0,3,0,0,0,3
CAGTGTTAATCTCTCA-1_Br2720_Ant_IF,0,0,0,0,0,0
CAGGCCAGTACCACCT-1_Br2720_Ant_IF,1,3,0,0,0,4
GATCGCTGTGGTGCGT-1_Br2720_Ant_IF,0,1,0,0,0,1
GTATCTCGGGCGCTTT-1_Br2720_Ant_IF,0,1,0,0,0,1
CCGGGCTAAGAATTTC-1_Br2720_Ant_IF,3,8,0,0,0,11
CTTCACGCCCTGGTAC-1_Br2720_Ant_IF,0,3,0,0,0,3
CGGATGAATGCTGTGA-1_Br2720_Ant_IF,0,3,1,0,0,4
CTCTGCAGGCATTCTT-1_Br2720_Ant_IF,0,3,1,0,0,4
TCAAAGTCACGGCGTC-1_Br2720_Ant_IF,0,1,0,0,0,1
TGGGTTTCGGGCGTAC-1_Br2720_Ant_IF,0,0,0,0,0,0
TGCTATGGCAAAGGGA-1_Br2720_Ant_IF,0,0,1,0,0,1
TTCACGGTCGTCACGT-1_Br2720_Ant_IF,0,2,1,0,0,3
CGTAAAGCAAGAAATC-1_Br2720_Ant_IF,1,3,0,0,1,5
CTGATCCCTTTATGCA-1_Br2720_Ant_IF,2,3,0,0,0,5
GAGTATACCCTAATCA-1_Br2720_Ant_IF,0,3,1,0,0,4
CCACGGCAGGTGTAGG-1_Br2720_Ant_IF,1,1,0,0,0,2
ACGTACTTTGGCACGG-1_Br2720_Ant_IF,0,0,1,0,0,1
CCTGAGAATAAATGCA-1_Br2720_Ant_IF,0,2,1,0,0,3
TTGATGCCGCTCGTCG-1_Br2720_Ant_IF,2,1,1,0,1,5
GCCAGGAAAGAACACT-1_Br2720_Ant_IF,1,1,0,0,1,3
TCCGACCGCTAATCAA-1_Br2720_Ant_IF,1,1,1,0,1,4
TATATCAAAGTGATCT-1_Br2720_Ant_IF,0,3,0,0,0,3
CCTCGGTTTCCTTGCC-1_Br2720_Ant_IF,0,1,0,0,0,1
TAAATTTAGTAACACC-1_Br2720_Ant_IF,0,1,0,0,0,1
CTCGTTACGGCTACCA-1_Br2720_Ant_IF,0,1,1,0,0,2
GCCGTCGGTTTCGGGC-1_Br2720_Ant_IF,1,1,1,0,1,4
GTTCCGTCCGCCTGCA-1_Br2720_Ant_IF,1,4,0,0,0,5
CTAGGGATAGGGACAA-1_Br2720_Ant_IF,0,4,2,0,0,6
GTCCAGGCACGTGTGC-1_Br2720_Ant_IF,0,2,0,0,1,3
GAGGAATATCTCTTTG-1_Br2720_Ant_IF,0,2,0,0,1,3
CGTTCAAGGAAACGGA-1_Br2720_Ant_IF,0,2,2,0,1,5
GTGGGAACAAACCGGG-1_Br2720_Ant_IF,0,1,0,0,0,1
GGGCACGTAGTACTGT-1_Br2720_Ant_IF,0,3,1,0,0,4
ACTACAAAGAGAGGTG-1_Br2720_Ant_IF,0,1,0,0,1,2
GGTGTAGGTAAGTAAA-1_Br2720_Ant_IF,1,2,1,0,2,6
CCTGTTCAACCTCGGG-1_Br2720_Ant_IF,0,1,0,0,0,1
TGAGGTGTGTGGCGGA-1_Br2720_Ant_IF,0,1,1,0,0,2
ATTGTCTGTTTCATGT-1_Br2720_Ant_IF,2,1,0,0,0,3
GCCGGTCGTATCTCTC-1_Br2720_Ant_IF,0,0,1,0,0,1
ATATGGGATAGCAACT-1_Br2720_Ant_IF,1,1,2,0,1,5
GATAGAACCCGCTAGG-1_Br2720_Ant_IF,1,2,1,0,1,5
ATCCCATTTCCGTGGG-1_Br2720_Ant_IF,1,1,3,0,0,5
GATGCTACCTTCGATG-1_Br2720_Ant_IF,0,2,0,0,1,3
TGCAAAGTTCGTCTGT-1_Br2720_Ant_IF,0,1,0,0,0,1
GTTCAGTCGCCAAATG-1_Br2720_Ant_IF,0,1,0,0,0,1
GTCTCCGCCTCAATAC-1_Br2720_Ant_IF,0,1,2,0,0,3
AGTAGAAGGCGCCTCA-1_Br2720_Ant_IF,1,1,0,0,0,2
GTTGTAGATTTATGAG-1_Br2720_Ant_IF,2,4,1,0,0,7
CTATTTGCTTGGAGGA-1_Br2720_Ant_IF,0,2,0,0,0,2
AGCCATATAGTATGTG-1_Br2720_Ant_IF,2,1,1,0,1,5
TGTTCCGGCCTGAGCT-1_Br2720_Ant_IF,0,2,0,0,0,2
TGCCGTGGGACCCAAT-1_Br2720_Ant_IF,1,1,0,0,1,3
TTGCAAGAAGACTCCT-1_Br2720_Ant_IF,1,2,0,0,1,4
CCGCTCCAGGGCGATC-1_Br2720_Ant_IF,1,1,0,0,1,3
CAAACCCTCCGGCGGG-1_Br2720_Ant_IF,0,2,0,0,1,3
CGGACCTTTACGTCCC-1_Br2720_Ant_IF,0,0,0,0,0,0
ACGTAGGAGAGTCGCT-1_Br2720_Ant_IF,0,0,0,0,1,1
CTGCGACCTCGCCGAA-1_Br2720_Ant_IF,0,2,0,0,2,4
GGCCCAGCTGGTTTGC-1_Br2720_Ant_IF,0,2,0,0,0,2
GGATTAATCATGGACC-1_Br2720_Ant_IF,0,4,1,0,0,5
GAGATGGCTTTAATCA-1_Br2720_Ant_IF,0,1,0,0,0,1
AGTACAGAAGCTTATA-1_Br2720_Ant_IF,2,2,0,0,1,5
GCGGCTTTAGCAAGTT-1_Br2720_Ant_IF,0,0,1,0,2,3
ACCGAGTCTCCTTATT-1_Br2720_Ant_IF,1,2,1,0,1,5
GACCACACTTCCCTTT-1_Br2720_Ant_IF,0,5,2,0,0,7
TGTAGCCAATTCCGTT-1_Br2720_Ant_IF,1,0,1,0,1,3
CTCGTCTGTGCCTTCG-1_Br2720_Ant_IF,0,0,0,0,0,0
GGACTCTTTGACTAAG-1_Br2720_Ant_IF,1,0,0,0,2,3
TCATCGACGACCGTCG-1_Br2720_Ant_IF,1,3,0,0,0,4
TACTACGTGCAATGCG-1_Br2720_Ant_IF,0,0,0,0,1,1
CCCTACTTGAACAATG-1_Br2720_Ant_IF,3,0,0,0,1,4
GCAGCTGTCAACGCAT-1_Br2720_Ant_IF,1,0,0,0,0,1
ATCTACCATCTGCTCC-1_Br2720_Ant_IF,0,0,0,0,2,2
TCTCAAATCAATCGGG-1_Br2720_Ant_IF,1,1,0,0,2,4
ACTCCGGCCGACCACT-1_Br2720_Ant_IF,1,1,3,0,0,5
TACACCTCTTCGAATC-1_Br2720_Ant_IF,2,0,2,0,1,5
GTGGCTGTTTCTGTTC-1_Br2720_Ant_IF,3,4,1,0,2,10
ACGACTCTAGGGCCGA-1_Br2720_Ant_IF,0,0,0,0,0,0
TCGTTTACGCGACCCT-1_Br2720_Ant_IF,0,3,1,0,1,5
GACACTTCCAATTACC-1_Br2720_Ant_IF,2,2,0,0,0,4
TGACAGAAATCTTGCT-1_Br2720_Ant_IF,0,0,0,3,0,3
TAGCCATGATTGCCTA-1_Br2720_Ant_IF,0,0,0,3,0,3
CGAAGCCACAGCATGG-1_Br2720_Ant_IF,0,0,0,1,0,1
ACCCGTAGCAGAGAAT-1_Br2720_Ant_IF,0,0,0,1,0,1
AGCTTGATCAGGGTAG-1_Br2720_Ant_IF,0,1,0,0,0,1
CTATAAGTAGGGTTTG-1_Br2720_Ant_IF,0,4,0,0,0,4
TATAGTTAGGTGTACT-1_Br2720_Ant_IF,0,1,0,2,0,3
TACGCTGATAGTTGTA-1_Br2720_Ant_IF,0,0,0,0,0,0
TTCTCAATTGCTACAA-1_Br2720_Ant_IF,0,2,0,0,0,2
GTTGCCCTAACGGGTG-1_Br2720_Ant_IF,0,1,1,0,0,2
GACATTTCGCCCAGCC-1_Br2720_Ant_IF,0,2,0,0,0,2
GTAACTACGTAGACCT-1_Br2720_Ant_IF,0,1,0,0,0,1
CCAGTGTACAGACCGA-1_Br2720_Ant_IF,0,4,1,0,0,5
GCCCGATGCCCAGTTC-1_Br2720_Ant_IF,0,1,0,0,0,1
CGAACCTCTTTCCTAG-1_Br2720_Ant_IF,0,5,0,0,0,5
CATGCACATGAGAGGC-1_Br2720_Ant_IF,2,2,0,0,0,4
CCAAATCAAAGGGCAA-1_Br2720_Ant_IF,1,1,1,0,0,3
GTAGTTTAAGCACACG-1_Br2720_Ant_IF,0,4,0,0,0,4
TAAGTGAATAGTCTAC-1_Br2720_Ant_IF,0,1,0,0,1,2
GGTCCACGTCTATTTG-1_Br2720_Ant_IF,1,2,1,0,0,4
CCCTCAGATCGAGAAC-1_Br2720_Ant_IF,0,2,0,0,0,2
ACATTCGCGCGGAATA-1_Br2720_Ant_IF,1,0,0,0,0,1
CTATGAACACCTTGCC-1_Br2720_Ant_IF,1,1,0,0,1,3
CGAATGGTAGGTCGTC-1_Br2720_Ant_IF,0,0,0,0,1,1
TCGACATAGCGTAGCG-1_Br2720_Ant_IF,0,2,0,0,0,2
GACGTTGCTCGGCGGC-1_Br2720_Ant_IF,0,3,0,0,1,4
CTCGAGGCAAGTTTCA-1_Br2720_Ant_IF,0,3,1,0,0,4
GCTGGGAGCGCGTCAA-1_Br2720_Ant_IF,0,0,0,0,0,0
GACGATATCACTGGGT-1_Br2720_Ant_IF,0,5,0,0,0,5
CAGCTCTGGGCTCACT-1_Br2720_Ant_IF,0,3,0,0,0,3
TAGTCTGCGGCACATT-1_Br2720_Ant_IF,0,1,1,0,1,3
TGGTCGATATACCTCT-1_Br2720_Ant_IF,0,3,0,0,1,4
TTCAGTTCAAGAGGAG-1_Br2720_Ant_IF,2,0,0,0,2,4
GTCTGTAGGTTGAACA-1_Br2720_Ant_IF,1,3,1,0,0,5
GAGAGTCTCGGGAGAG-1_Br2720_Ant_IF,1,0,1,0,0,2
TTGTTTGTATTACACG-1_Br2720_Ant_IF,0,1,1,0,1,3
GCACAGCACGGGCCGA-1_Br2720_Ant_IF,2,0,0,0,0,2
AAACAGTGTTCCTGGG-1_Br2720_Ant_IF,0,3,0,0,1,4
TGGAGAATAATCGTCC-1_Br2720_Ant_IF,1,2,0,0,0,3
CGCCGCGTTCTGAACG-1_Br2720_Ant_IF,1,0,0,0,1,2
CATGCGTTGAGAGGAG-1_Br2720_Ant_IF,1,3,0,0,1,5
TACGCTCCTAGAACTG-1_Br2720_Ant_IF,0,0,1,0,1,2
CCTTGTGAACGTGGTT-1_Br2720_Ant_IF,0,5,1,0,0,6
TTAAAGGCGATGCTCG-1_Br2720_Ant_IF,0,1,0,0,2,3
TAAAGTGCACGTCTCG-1_Br2720_Ant_IF,2,3,2,0,0,7
TGTCCGCAAACAATTC-1_Br2720_Ant_IF,0,2,0,0,0,2
AGGCCTATCATACCAA-1_Br2720_Ant_IF,0,0,0,0,0,0
ACTGGGATGCCAGTGC-1_Br2720_Ant_IF,0,2,0,0,0,2
CGATCCACCATTGTTG-1_Br2720_Ant_IF,0,2,3,0,0,5
GGGCATGCATGTCGAG-1_Br2720_Ant_IF,1,2,2,0,1,6
TCCAGGCAGGACGATC-1_Br2720_Ant_IF,0,1,2,0,1,4
CAATGACCCTTAATTT-1_Br2720_Ant_IF,0,2,2,0,1,5
ATCAAGATCCCAGGAC-1_Br2720_Ant_IF,0,0,0,0,1,1
CTCAGAGCTAATGTCG-1_Br2720_Ant_IF,0,2,0,0,0,2
CTGCGATTTCGAGATT-1_Br2720_Ant_IF,1,0,0,0,0,1
ATGGTATTGGGAACCG-1_Br2720_Ant_IF,0,1,1,0,0,2
TAGGTTCTGCTGAGAA-1_Br2720_Ant_IF,0,0,0,0,0,0
GCCTGTCCCGGTGCAT-1_Br2720_Ant_IF,0,1,0,0,2,3
GGCCTGCTCTGATGTT-1_Br2720_Ant_IF,0,2,0,0,0,2
TAGAGGGAGTTTATCT-1_Br2720_Ant_IF,1,6,0,0,0,7
CTCTACATCCTGCGTG-1_Br2720_Ant_IF,2,2,0,0,0,4
ACACATTTCCGTAGAC-1_Br2720_Ant_IF,0,1,0,0,1,2
TGGGTGTTAAGTAGAA-1_Br2720_Ant_IF,2,1,0,0,0,3
GAGCTCAACATGAGCG-1_Br2720_Ant_IF,1,3,2,0,4,10
GCACACAGCTATTACC-1_Br2720_Ant_IF,0,3,0,0,2,5
GCGACGGTAGTCTCCT-1_Br2720_Ant_IF,0,2,1,0,3,6
GTATCAAGGTACTTCC-1_Br2720_Ant_IF,0,1,1,0,1,3
GGAAAGGGAATTGAGC-1_Br2720_Ant_IF,0,0,0,0,1,1
TACACAGCCGTGGTGC-1_Br2720_Ant_IF,2,2,3,0,0,7
CGGTTGGGCAGGGTCC-1_Br2720_Ant_IF,0,1,2,0,5,8
GCACGCCGATTCCCGC-1_Br2720_Ant_IF,0,1,0,0,1,2
CGCTTTCCGCCAAGGT-1_Br2720_Ant_IF,0,0,2,0,1,3
TGCCCGATAGTTAGAA-1_Br2720_Ant_IF,0,3,3,0,2,8
TCAGAACGGCGGTAAT-1_Br2720_Ant_IF,1,3,0,0,1,5
CCACTCAGATCCGCAA-1_Br2720_Ant_IF,0,2,0,0,0,2
GAAGGGTCATTAAGAC-1_Br2720_Ant_IF,0,1,0,0,3,4
GCGGTCTTGCTTTCAC-1_Br2720_Ant_IF,1,1,1,0,1,4
GGAAGGACACCGTATA-1_Br2720_Ant_IF,0,1,0,0,0,1
CGCGGGAATTCCTTTC-1_Br2720_Ant_IF,0,2,0,0,1,3
TCTATCCGATTGCACA-1_Br2720_Ant_IF,5,0,0,0,1,6
TACTCGTTTGAATCAA-1_Br2720_Ant_IF,1,1,0,0,0,2
GTCTGCCGACTCGACG-1_Br2720_Ant_IF,0,0,0,0,0,0
TACGGGTAATAACATA-1_Br2720_Ant_IF,0,0,1,0,0,1
CGTGCACACCACTGTA-1_Br2720_Ant_IF,0,0,0,0,0,0
CGCCAGTAGTACCTTG-1_Br2720_Ant_IF,0,1,0,1,0,2
CTCCCTTGTATCAAGG-1_Br2720_Ant_IF,0,0,0,0,0,0
ACTTTATACACCACTT-1_Br2720_Ant_IF,0,3,1,0,0,4
AGATCTGGAGAGGATA-1_Br2720_Ant_IF,0,0,0,0,0,0
TCATCCATCTGATCAC-1_Br2720_Ant_IF,0,1,0,0,0,1
AGAACACGGCGATGGT-1_Br2720_Ant_IF,1,5,0,0,0,6
CCGCTCCGGATAAGCT-1_Br2720_Ant_IF,1,1,0,0,0,2
TGGTCGGGTACAGGGC-1_Br2720_Ant_IF,0,1,0,0,0,1
ACGGACGCAGCGACAA-1_Br2720_Ant_IF,0,0,0,0,0,0
ACATGCTTACGGCAGC-1_Br2720_Ant_IF,0,2,0,0,0,2
CAGGGAGATAGGCCAG-1_Br2720_Ant_IF,0,3,0,0,0,3
TCGCCACCCGGATTAC-1_Br2720_Ant_IF,0,1,0,0,0,1
TCTTGGTCAATGATAC-1_Br2720_Ant_IF,1,4,0,0,0,5
CATAGGGACACTTGTG-1_Br2720_Ant_IF,0,5,0,0,0,5
CACGAGCAAACCAGAC-1_Br2720_Ant_IF,0,2,0,0,0,2
GGGATATTGATCGCCA-1_Br2720_Ant_IF,0,7,0,0,0,7
TAATGTCGGTTCATGG-1_Br2720_Ant_IF,0,5,0,0,0,5
CGATTTGTCATTAATG-1_Br2720_Ant_IF,1,3,1,0,0,5
TTAAGATACCCAGAGA-1_Br2720_Ant_IF,1,4,0,0,0,5
CGACCGTTGGTATTCG-1_Br2720_Ant_IF,0,3,1,0,1,5
ACTACCATCCGAGGGC-1_Br2720_Ant_IF,0,0,0,0,0,0
TCTACGCACGATCTCC-1_Br2720_Ant_IF,1,2,0,0,1,4
AAGCCACTTGCAGGTA-1_Br2720_Ant_IF,0,5,0,0,0,5
ACGTTGTCGTTGAAAG-1_Br2720_Ant_IF,2,1,0,0,1,4
ACCGCTAGTCATTGGT-1_Br2720_Ant_IF,1,1,1,0,1,4
CATGAGTCCATCACGG-1_Br2720_Ant_IF,0,0,0,0,1,1
ATGTCTTGTTTGACTC-1_Br2720_Ant_IF,2,0,0,0,0,2
TCCCAAACATCCTCTA-1_Br2720_Ant_IF,0,0,0,0,0,0
CAACGCGATGAGCCAA-1_Br2720_Ant_IF,1,0,0,0,0,1
GACACCCAAAGACGCG-1_Br2720_Ant_IF,0,4,0,0,2,6
ACGTTCACTATGCCGC-1_Br2720_Ant_IF,0,2,0,0,0,2
ATGGACTGCTTAGTTG-1_Br2720_Ant_IF,0,0,0,0,0,0
CCATGGCAAACGCTCA-1_Br2720_Ant_IF,0,4,0,0,1,5
TTGTCTCGGCAAGATG-1_Br2720_Ant_IF,1,1,0,0,0,2
TTCGAACGAAACATGC-1_Br2720_Ant_IF,0,1,1,0,2,4
GGAAAGTCTTGATTGT-1_Br2720_Ant_IF,1,0,0,0,0,1
ATCATAGATCGACGAG-1_Br2720_Ant_IF,0,1,0,0,1,2
GATTAGAAACAAGCGT-1_Br2720_Ant_IF,0,2,1,0,1,4
GCTGCGAAGAATTATT-1_Br2720_Ant_IF,0,1,2,0,0,3
TTCCAGTGGGTTTCGT-1_Br2720_Ant_IF,0,3,0,0,0,3
GCTCATTGATCATATC-1_Br2720_Ant_IF,1,2,1,0,1,5
ATACGAGGTTTGTAAG-1_Br2720_Ant_IF,0,0,1,0,0,1
GTCTATACACGCATGG-1_Br2720_Ant_IF,0,0,0,0,1,1
GATTTGCGCTAACACC-1_Br2720_Ant_IF,0,2,0,0,2,4
TGGTGCCCTGCCTTAC-1_Br2720_Ant_IF,0,2,1,0,1,4
TCGAATCGCAGGGTAG-1_Br2720_Ant_IF,5,3,2,0,0,10
GGTAGGCCAATATCAC-1_Br2720_Ant_IF,0,0,0,0,0,0
CGTAAATAACAAAGGG-1_Br2720_Ant_IF,1,1,0,0,0,2
GACTCTAGAGTTCCAA-1_Br2720_Ant_IF,0,1,1,0,0,2
ACTTGTTACCGGATCA-1_Br2720_Ant_IF,0,2,0,0,0,2
GGCATTGAACATCTCA-1_Br2720_Ant_IF,1,3,0,0,0,4
AACCCGCTGTATTCCA-1_Br2720_Ant_IF,0,5,2,0,1,8
TAACAGGTTCCCTTAG-1_Br2720_Ant_IF,1,2,0,0,2,5
GTTCTTGTAACTCAAT-1_Br2720_Ant_IF,0,0,0,0,0,0
GATTCTGTTAATGAGT-1_Br2720_Ant_IF,0,1,0,0,0,1
GGACACCTCGGTGTTG-1_Br2720_Ant_IF,0,0,0,0,0,0
CGATCGAGAAGCACCA-1_Br2720_Ant_IF,0,2,2,0,1,5
CTGCTCTGACGGCAAA-1_Br2720_Ant_IF,0,0,0,0,3,3
CCCAGGAAGAATTCGA-1_Br2720_Ant_IF,0,1,0,0,1,2
TGTCGTGGGTATAGGC-1_Br2720_Ant_IF,0,1,1,0,1,3
ATATGTCTAGAGCGTG-1_Br2720_Ant_IF,1,4,0,0,0,5
GCGGGCAGACGGGTGA-1_Br2720_Ant_IF,0,1,0,0,0,1
CGAAGATCAGTTTCAT-1_Br2720_Ant_IF,0,3,0,0,0,3
ACGCCACTCGAAACAG-1_Br2720_Ant_IF,1,2,0,0,1,4
CTTAGATGTTTCATCC-1_Br2720_Ant_IF,0,3,0,0,3,6
GCGAATGGACTAGCGA-1_Br2720_Ant_IF,0,4,3,0,0,7
TAAATTGTGGGTAAAG-1_Br2720_Ant_IF,0,4,3,0,1,8
ATTTATACTGGTAAAG-1_Br2720_Ant_IF,0,1,0,0,0,1
GCGTCGTAACATGGTC-1_Br2720_Ant_IF,0,5,1,0,0,6
CGGTATGGGCACTCTG-1_Br2720_Ant_IF,2,2,0,0,0,4
CTATCACAACGCTGGA-1_Br2720_Ant_IF,0,1,3,0,3,7
ACCACACGGTTGATGG-1_Br2720_Ant_IF,0,1,3,0,1,5
TCAGCGCACGCCGTTT-1_Br2720_Ant_IF,0,0,0,0,2,2
AATGTTAAGACCCTGA-1_Br2720_Ant_IF,0,0,0,0,1,1
CTTACATAGATTTCTT-1_Br2720_Ant_IF,0,0,4,0,0,4
AGCAGTCGAAGCATGC-1_Br2720_Ant_IF,3,1,0,0,1,5
CAACGAGCTTATTATG-1_Br2720_Ant_IF,0,0,0,0,0,0
GATCCAACCTTTAAAC-1_Br2720_Ant_IF,0,0,0,0,0,0
TTGTGGAGACAGCCGG-1_Br2720_Ant_IF,0,0,0,0,0,0
AGATAATCACACCTAT-1_Br2720_Ant_IF,0,4,0,0,0,4
GGTTAGGGATGCTAAT-1_Br2720_Ant_IF,0,3,0,0,0,3
TCATGAAGCGCTGCAT-1_Br2720_Ant_IF,0,0,0,0,0,0
CCAGGCGAGATGGTCT-1_Br2720_Ant_IF,0,3,0,0,0,3
CGACTTGCCGGGAAAT-1_Br2720_Ant_IF,2,4,0,0,0,6
GTGCCAAACGTTTCGA-1_Br2720_Ant_IF,1,0,1,0,1,3
TGCTCAAAGGATGCAC-1_Br2720_Ant_IF,0,1,0,0,0,1
GCCTCAGGTACCGGTC-1_Br2720_Ant_IF,0,1,0,0,0,1
ACAAGTAATTGTAAGG-1_Br2720_Ant_IF,0,1,0,0,0,1
TTAGAGTATTGTCGAG-1_Br2720_Ant_IF,0,4,1,0,0,5
GTCATCCCAAACTCAC-1_Br2720_Ant_IF,0,3,0,0,0,3
CTCCTAGTAATCGTGA-1_Br2720_Ant_IF,0,1,0,0,0,1
GGAAACAGAGCTTGGG-1_Br2720_Ant_IF,0,0,0,0,0,0
TTAGCCATAGGGCTCG-1_Br2720_Ant_IF,1,0,0,0,0,1
TTGTTGGCAATGACTG-1_Br2720_Ant_IF,1,3,0,0,0,4
GGTGGGATTAGGTCCC-1_Br2720_Ant_IF,0,1,0,0,2,3
GAGGTCCGTTCGCTGT-1_Br2720_Ant_IF,0,5,0,0,0,5
AGCTAAGCTCCGTCCG-1_Br2720_Ant_IF,0,2,1,0,1,4
CCCAGATTCCCGTGAC-1_Br2720_Ant_IF,0,0,0,0,1,1
ACAAACTCCATCAGAG-1_Br2720_Ant_IF,0,2,0,0,0,2
TTGCGGAAAGCTGCCC-1_Br2720_Ant_IF,0,0,0,0,1,1
GGTTACCGCTCCCTAC-1_Br2720_Ant_IF,0,0,0,0,0,0
CCGTTTCCTTTCCGTG-1_Br2720_Ant_IF,0,3,0,0,0,3
CAAGTCGTTGAAATCT-1_Br2720_Ant_IF,1,1,0,0,0,2
GGCTGTCCTACTGCGG-1_Br2720_Ant_IF,1,2,0,0,2,5
CGGACCTCTGTAGTTA-1_Br2720_Ant_IF,0,4,0,0,2,6
GTAACAGGTTAACGGC-1_Br2720_Ant_IF,0,3,0,0,1,4
AATCCCGCTCAGAGCC-1_Br2720_Ant_IF,0,4,0,0,0,4
CTCGTGGCACTGAAAG-1_Br2720_Ant_IF,0,2,1,0,1,4
AAATGACTGATCAAAC-1_Br2720_Ant_IF,0,2,1,0,0,3
ATCAAAGAGCCGTGGT-1_Br2720_Ant_IF,0,4,1,0,0,5
ATGTCATAATAAACGA-1_Br2720_Ant_IF,1,0,0,0,1,2
CTTAATCGACTTAGTA-1_Br2720_Ant_IF,0,0,0,0,0,0
CTAAAGGATGAGATAC-1_Br2720_Ant_IF,0,3,0,0,0,3
GTGCTATCCAGCTGGA-1_Br2720_Ant_IF,0,3,0,0,1,4
GACAGAGGTCTTCAGT-1_Br2720_Ant_IF,1,4,0,0,0,5
TCGATTTACGAAACGA-1_Br2720_Ant_IF,0,0,0,0,0,0
AGGCTTAAGTTGCACA-1_Br2720_Ant_IF,0,1,0,0,1,2
TAGGATCTTAACCGCA-1_Br2720_Ant_IF,0,5,1,0,0,6
GACTTTCGAGCGGTTC-1_Br2720_Ant_IF,0,5,0,0,0,5
CCCTGGGAGGGATCCT-1_Br2720_Ant_IF,0,2,1,0,0,3
TAGTAGTTGCCGGACA-1_Br2720_Ant_IF,2,10,0,0,1,13
GCCCTAAGTGCAGGAT-1_Br2720_Ant_IF,1,0,3,0,4,8
ACTTGGGCTTTCGCCA-1_Br2720_Ant_IF,0,2,0,0,1,3
CATGATACGGTGAAAC-1_Br2720_Ant_IF,5,1,3,0,3,12
TCCTGCAGCCGCCAAT-1_Br2720_Ant_IF,0,0,0,0,0,0
GTCCGTTAGAGGGCCT-1_Br2720_Ant_IF,2,1,1,0,1,5
AATCGAGGTCTCAAGG-1_Br2720_Ant_IF,0,0,0,0,0,0
