key,other,neuron,oligo,micro,astro,n_cells
ACGCCTGACACGCGCT-1_Br8667_Post_IF,0,0,0,0,0,0
TACCGATCCAACACTT-1_Br8667_Post_IF,0,0,0,0,0,0
ATTAAAGCGGACGAGC-1_Br8667_Post_IF,0,0,0,0,0,0
GATAAGGGACGATTAG-1_Br8667_Post_IF,0,0,0,0,0,0
GTGCAAATCACCAATA-1_Br8667_Post_IF,0,0,0,0,0,0
TGTTGGCTGGCGGAAG-1_Br8667_Post_IF,0,0,0,0,0,0
GCATCCTCTCCTATTA-1_Br8667_Post_IF,0,0,0,0,0,0
GCGAGGGACTGCTAGA-1_Br8667_Post_IF,0,0,0,0,0,0
TGGTACCGGCACAGCC-1_Br8667_Post_IF,0,0,0,0,0,0
GCGCGTTTAAATCGTA-1_Br8667_Post_IF,0,1,1,0,0,2
TGCCTTGCCCTTACGG-1_Br8667_Post_IF,0,0,0,0,0,0
GACGACTTTCCAAGAA-1_Br8667_Post_IF,0,0,0,0,0,0
CCAGTGAGCTCCTTGT-1_Br8667_Post_IF,0,0,0,0,0,0
ATACCCTGGCTCAAAT-1_Br8667_Post_IF,0,2,0,0,0,2
GGGTTTCCGGCTTCCA-1_Br8667_Post_IF,1,0,0,0,0,1
TAACCGTCCAGTTCAT-1_Br8667_Post_IF,2,0,1,0,0,3
AAACAACGAATAGTTC-1_Br8667_Post_IF,3,1,2,0,0,6
CAAGGGAGTGTATTTG-1_Br8667_Post_IF,1,0,1,0,0,2
CCAAGCTTGATCTCCT-1_Br8667_Post_IF,5,0,2,0,0,7
TTATTTCATCCCAAAC-1_Br8667_Post_IF,2,0,0,0,0,2
GAGCGCTATGTCAGGC-1_Br8667_Post_IF,2,0,0,1,0,3
TATGGCAGACTTTCGA-1_Br8667_Post_IF,1,1,0,0,0,2
CTTCGTGCCCGCATCG-1_Br8667_Post_IF,4,1,0,0,0,5
AAACGGGTTGGTATCC-1_Br8667_Post_IF,1,0,1,0,0,2
TGCAAACCCACATCAA-1_Br8667_Post_IF,2,3,2,0,0,7
GACGGGATGTCTTATG-1_Br8667_Post_IF,1,1,0,0,0,2
GGCGAGCATCGAGGAC-1_Br8667_Post_IF,4,0,2,0,0,6
CGCGTGCTATCAACGA-1_Br8667_Post_IF,3,0,0,0,0,3
TGAAACCTCAACTCAC-1_Br8667_Post_IF,2,1,1,0,0,4
CACATAAGGCGACCGT-1_Br8667_Post_IF,3,0,1,0,0,4
TGACCCAACTCACATT-1_Br8667_Post_IF,1,1,0,0,0,2
ATACGCCGATCTACCG-1_Br8667_Post_IF,1,2,0,0,0,3
ACTTATCTGATCTATA-1_Br8667_Post_IF,1,1,1,0,0,3
GTGTGAGCCGAGGTGC-1_Br8667_Post_IF,2,2,2,0,0,6
GATGATTTGAAACTGG-1_Br8667_Post_IF,3,1,2,0,0,6
GGGAACCACCTGTTTC-1_Br8667_Post_IF,1,0,2,0,0,3
GTTCGTTGCGGACCAG-1_Br8667_Post_IF,0,0,0,0,0,0
TGAGGTTGATCCCAAG-1_Br8667_Post_IF,0,3,1,0,0,4
GATGCCACACTACAGC-1_Br8667_Post_IF,4,1,1,0,0,6
AGGCAAAGAGGAATCA-1_Br8667_Post_IF,3,1,1,0,0,5
AAGTAAGCTTCCAAAC-1_Br8667_Post_IF,4,2,1,0,0,7
AACGTAGTCTACCCAT-1_Br8667_Post_IF,3,2,2,0,0,7
GTTTGAGCGGTTATGT-1_Br8667_Post_IF,7,1,2,0,0,10
GAAGCAAGGCAATGTT-1_Br8667_Post_IF,0,0,0,0,0,0
TCACTCAGCGCATTAG-1_Br8667_Post_IF,5,1,2,0,0,8
TACAATGAAACCAGCA-1_Br8667_Post_IF,2,0,1,0,0,3
GTGCGCTTACAAATGA-1_Br8667_Post_IF,1,1,0,0,0,2
GCACTCCCACAGTCCC-1_Br8667_Post_IF,1,2,1,0,0,4
CGAAGACTGCCCGGGA-1_Br8667_Post_IF,1,3,1,0,0,5
CAGGATCCGCCCGACC-1_Br8667_Post_IF,0,3,3,1,0,7
CACGATTGGTCGTTAA-1_Br8667_Post_IF,0,2,0,0,0,2
GGTTGTATCGTGAAAT-1_Br8667_Post_IF,2,1,0,0,0,3
TCTTATGGGTAGTACC-1_Br8667_Post_IF,4,2,1,0,0,7
TACAAGCTGTTCACTG-1_Br8667_Post_IF,2,3,2,0,0,7
GTATCTTGTTGCTCAC-1_Br8667_Post_IF,1,1,0,0,0,2
ATACCAGGTGAGCGAT-1_Br8667_Post_IF,1,1,3,0,0,5
CCTAAACAGGGTCCGT-1_Br8667_Post_IF,1,0,0,0,0,1
ATGGTGCTCAAAGCCA-1_Br8667_Post_IF,0,0,0,0,0,0
CAAATGCGGAGTGTTC-1_Br8667_Post_IF,2,0,2,1,0,5
CGTGCCCGACATTTGT-1_Br8667_Post_IF,1,1,2,0,0,4
GTATCTCCCTAACTGT-1_Br8667_Post_IF,1,1,0,0,0,2
ATTTGCCTAGTTACGA-1_Br8667_Post_IF,2,0,5,0,0,7
ACGTCCTAAACGAGAT-1_Br8667_Post_IF,2,0,0,0,0,2
CTGGGATCGCCCAGAT-1_Br8667_Post_IF,2,1,1,0,0,4
CTGCAAATGGGCTCCA-1_Br8667_Post_IF,1,1,2,0,0,4
CATTATAACAGGGTCC-1_Br8667_Post_IF,4,1,1,0,0,6
ACCTTTCCTTTAGAAG-1_Br8667_Post_IF,1,2,0,0,0,3
ATAGATTTGCAGTCGG-1_Br8667_Post_IF,0,1,0,0,0,1
CTCGGGCATCGTCGGG-1_Br8667_Post_IF,2,0,0,0,0,2
GTGGCGGGCCGTAGCT-1_Br8667_Post_IF,4,1,2,0,0,7
CAACAGTGCCAAACGG-1_Br8667_Post_IF,2,0,0,0,0,2
TGCGGGTATTGGGATC-1_Br8667_Post_IF,3,1,2,1,0,7
GTCTCGCCAACACGCC-1_Br8667_Post_IF,2,0,0,0,0,2
CTGGGCGGCCAAATGT-1_Br8667_Post_IF,0,1,0,1,0,2
TAAAGGAGAAACTAGT-1_Br8667_Post_IF,0,1,0,0,0,1
TCCCACGGAGGGAGCT-1_Br8667_Post_IF,2,2,1,0,0,5
AGCTTCAATACTTTGA-1_Br8667_Post_IF,2,3,0,0,0,5
TTCCACATTTCTCGTC-1_Br8667_Post_IF,3,2,2,0,0,7
ACAAACCGACAAGGCG-1_Br8667_Post_IF,2,1,0,0,0,3
AGACGGGATTGGTATA-1_Br8667_Post_IF,2,0,0,0,0,2
AACCTAAAGCCGTCCG-1_Br8667_Post_IF,2,1,0,0,0,3
TACAAATTGCGGAGGT-1_Br8667_Post_IF,1,3,0,0,0,4
CCCGCTAGAGGGTTAA-1_Br8667_Post_IF,2,0,1,0,0,3
CATTGCAAAGCATAAT-1_Br8667_Post_IF,3,0,2,0,0,5
TGTACGCTATCAGCTT-1_Br8667_Post_IF,1,0,0,0,0,1
TTCTTCGCAATAGAGC-1_Br8667_Post_IF,1,0,0,0,0,1
TGTGATTCCAGCGCTT-1_Br8667_Post_IF,2,1,0,1,0,4
ATTCAGGATCGCCTCT-1_Br8667_Post_IF,1,0,0,0,0,1
GCCCATGGGTGCAATG-1_Br8667_Post_IF,1,2,1,0,0,4
TTCCCGACGCTTCACT-1_Br8667_Post_IF,3,1,1,1,0,6
AGCGGTTGAGATGTAC-1_Br8667_Post_IF,1,0,0,0,1,2
GCTGTCTGTGATCGAC-1_Br8667_Post_IF,0,0,0,0,0,0
AAAGACATGAAGTTTA-1_Br8667_Post_IF,3,0,1,0,0,4
CAACAGAATAACGCTA-1_Br8667_Post_IF,1,0,1,1,0,3
TGCGGTCTACGAGTAA-1_Br8667_Post_IF,1,0,3,0,0,4
AAGACTCACGCCCACT-1_Br8667_Post_IF,3,2,2,0,0,7
CTTTGAAACATATTCC-1_Br8667_Post_IF,1,2,1,0,0,4
CTGGGCACTAGTCGGA-1_Br8667_Post_IF,0,3,1,0,0,4
CGCCCTTACATCCACC-1_Br8667_Post_IF,2,0,0,0,0,2
CACGACCACAGACTTT-1_Br8667_Post_IF,2,1,0,0,0,3
CAATCCATTATCCGTT-1_Br8667_Post_IF,0,1,0,0,0,1
GTGGCGTGCACCAGAG-1_Br8667_Post_IF,4,1,2,0,0,7
CGGAGTCCTAACCTGG-1_Br8667_Post_IF,1,0,1,0,0,2
GGTCCCATAACATAGA-1_Br8667_Post_IF,0,2,2,1,0,5
ATCTCATAAACCTACC-1_Br8667_Post_IF,2,2,1,0,0,5
TGCATGGCAGTCTTGC-1_Br8667_Post_IF,1,3,2,1,0,7
TTGCAGGTCATGAAGT-1_Br8667_Post_IF,0,3,0,0,0,3
AGCTGCATTTGAGGTG-1_Br8667_Post_IF,0,1,0,0,1,2
TAATCAGGAATGCTGC-1_Br8667_Post_IF,0,0,0,0,0,0
CCATCATAAGAACAGG-1_Br8667_Post_IF,2,2,1,0,0,5
TCGTATCACCAAGCTA-1_Br8667_Post_IF,2,1,1,0,0,4
ATTCAGATGAATCCCT-1_Br8667_Post_IF,1,1,3,0,0,5
AAAGGTCAACGACATG-1_Br8667_Post_IF,0,3,3,1,0,7
AGCTGCTGTGCCGAAT-1_Br8667_Post_IF,0,0,1,0,0,1
CTAGCGCCAATCCTAC-1_Br8667_Post_IF,1,0,1,0,2,4
GCTCGACCGAACTGAA-1_Br8667_Post_IF,0,0,1,0,0,1
ACAGTGCAGCGCATTT-1_Br8667_Post_IF,0,0,1,0,0,1
CGGCTGAAGGTTACGC-1_Br8667_Post_IF,0,2,1,0,0,3
CACCTCTACGAGTGTG-1_Br8667_Post_IF,0,0,1,0,0,1
ATACGACAGATGGGTA-1_Br8667_Post_IF,2,1,0,0,0,3
ACTTCCTGTCGTGCGA-1_Br8667_Post_IF,0,1,0,0,0,1
CGTAACGGAACGATCA-1_Br8667_Post_IF,0,0,2,0,0,2
AAATCACTCCTAAACG-1_Br8667_Post_IF,1,1,2,0,0,4
CTCCGAGTAAATCCGC-1_Br8667_Post_IF,2,0,4,0,0,6
ACGCTAGTATCAGTGC-1_Br8667_Post_IF,1,1,1,0,0,3
AGAGTGAACAGACACC-1_Br8667_Post_IF,3,0,2,1,0,6
ACACCCGTAAATCTGT-1_Br8667_Post_IF,2,0,0,0,0,2
GCTTTGCTGCCGGGTA-1_Br8667_Post_IF,1,1,0,0,0,2
ACAGGAGGCGCAGCCG-1_Br8667_Post_IF,0,0,0,0,0,0
AGGCAATACGGAGGAC-1_Br8667_Post_IF,0,0,0,0,0,0
TGGTGTGACAGACGAT-1_Br8667_Post_IF,0,0,0,0,0,0
ATCTATCGATGATCAA-1_Br8667_Post_IF,0,1,1,0,0,2
CGGTAACAAGATACAT-1_Br8667_Post_IF,2,1,0,0,0,3
TCGCCGGAGAGTCTTA-1_Br8667_Post_IF,4,1,1,0,0,6
GGAGGAGTGTGTTTAT-1_Br8667_Post_IF,2,2,0,0,0,4
TTAGGTGTGACTGGTC-1_Br8667_Post_IF,0,0,0,1,0,1
CAGGGCTAACGAAACC-1_Br8667_Post_IF,2,0,0,0,0,2
CCCGTGGGTTAATTGA-1_Br8667_Post_IF,9,1,0,1,0,11
GACCGACCGCTAATAT-1_Br8667_Post_IF,3,0,1,0,0,4
GGTATCAAGCATAGAA-1_Br8667_Post_IF,1,1,0,0,0,2
TGCATGAGTAGATTCG-1_Br8667_Post_IF,0,0,3,0,0,3
AATTCCAACTTGGTGA-1_Br8667_Post_IF,2,3,1,0,0,6
TGCCGATGTCATCAAT-1_Br8667_Post_IF,3,1,0,0,0,4
GCTGGGTCCGCTGTTA-1_Br8667_Post_IF,1,2,1,0,0,4
TGAACACCCGAAGCAG-1_Br8667_Post_IF,0,0,0,0,0,0
AACATTGGTCAGCCGT-1_Br8667_Post_IF,2,2,0,0,0,4
GTGGGTCTTCTTTGCG-1_Br8667_Post_IF,1,2,0,0,0,3
CATCGAATGGATCTCT-1_Br8667_Post_IF,2,0,1,0,0,3
GCTACACTGTCCGAAC-1_Br8667_Post_IF,3,0,0,0,0,3
CGGGTTGTAGCTTTGG-1_Br8667_Post_IF,3,0,0,0,0,3
CCTAAGTGTCTAACCG-1_Br8667_Post_IF,1,0,0,1,0,2
TCTGTGACTGACCGTT-1_Br8667_Post_IF,2,0,0,0,0,2
TTATCATACTCGCAAA-1_Br8667_Post_IF,5,0,0,0,0,5
AGCGTAGCGCTAGACC-1_Br8667_Post_IF,3,0,1,0,0,4
TCCCTCCGAAATCGTT-1_Br8667_Post_IF,3,1,0,0,0,4
AGGTCGCCACTTCGGT-1_Br8667_Post_IF,3,0,1,0,0,4
CTAGCAACTAATTTAC-1_Br8667_Post_IF,2,2,1,0,0,5
TTGCTAGCTACCAATC-1_Br8667_Post_IF,5,2,2,0,0,9
GCCGGTTTGGGCGGAT-1_Br8667_Post_IF,0,1,4,0,0,5
TGTAACTTGTCAACCT-1_Br8667_Post_IF,0,3,1,0,0,4
CGAGATGTTGCCTATA-1_Br8667_Post_IF,7,0,1,0,0,8
GTTACGAAATCCACGC-1_Br8667_Post_IF,3,1,1,0,0,5
CTTGTCGTACGTGTCA-1_Br8667_Post_IF,4,2,0,0,0,6
GCGTCCAGCTCGTGGC-1_Br8667_Post_IF,3,3,2,0,0,8
CCCTTCTCGTACGCGA-1_Br8667_Post_IF,3,1,0,0,0,4
CCAAAGTCCCGCTAAC-1_Br8667_Post_IF,4,2,2,0,0,8
CCGCTTCGCGGTTAAC-1_Br8667_Post_IF,0,2,0,0,0,2
GTTACGGCCCGACTGC-1_Br8667_Post_IF,1,0,0,0,0,1
CCCGCTTGCCCTCGTC-1_Br8667_Post_IF,1,1,0,0,0,2
TAGTGAGAAGTGGTTG-1_Br8667_Post_IF,3,0,0,0,0,3
CGCTACCGCCCTATGA-1_Br8667_Post_IF,2,2,0,0,0,4
AAACAATCTACTAGCA-1_Br8667_Post_IF,0,3,2,0,0,5
GCGCGATGGGTCAAGT-1_Br8667_Post_IF,2,0,0,0,0,2
ATAAACCATTGGACGG-1_Br8667_Post_IF,1,2,0,0,0,3
TCGGGCACTTCTGGAT-1_Br8667_Post_IF,1,1,0,0,0,2
TCTGTGGCTACATTTC-1_Br8667_Post_IF,3,1,2,0,0,6
CTCTGTGCCTGCTATG-1_Br8667_Post_IF,3,2,2,0,0,7
CACGACTAAAGTTCTG-1_Br8667_Post_IF,2,0,3,0,0,5
GAGGAGTAATTCCTAC-1_Br8667_Post_IF,0,3,0,1,0,4
AGAGGTATCTCGGTCC-1_Br8667_Post_IF,3,1,4,1,0,9
GGCGTACCCTATATAA-1_Br8667_Post_IF,1,1,2,0,0,4
GCCGGAAACACATCTT-1_Br8667_Post_IF,3,1,1,0,0,5
AAATGTGGGTGCTCCT-1_Br8667_Post_IF,2,1,0,0,0,3
ACCAGGAGTGTGATCT-1_Br8667_Post_IF,5,2,1,0,0,8
TGTGGAGGAAGCTTAA-1_Br8667_Post_IF,4,0,4,0,3,11
AAGGAGAACTTATAAG-1_Br8667_Post_IF,3,1,1,1,0,6
CCCTCGGGAGCCTTGT-1_Br8667_Post_IF,0,1,0,0,0,1
ACTGTTTAGTGTAGGC-1_Br8667_Post_IF,1,2,0,0,0,3
CGTCAGTTTATCGTCT-1_Br8667_Post_IF,1,0,1,0,0,2
GCGTGTATGTCGTATT-1_Br8667_Post_IF,1,1,0,0,0,2
ACAATCGATCTTTATA-1_Br8667_Post_IF,2,1,3,0,0,6
CAGCCCTCACAGGCAG-1_Br8667_Post_IF,1,1,0,0,0,2
CGCGTCATATTAAACC-1_Br8667_Post_IF,0,0,1,0,0,1
GAAGACTTCAATGCCG-1_Br8667_Post_IF,2,2,3,0,0,7
TTGCGGCGACTCATGC-1_Br8667_Post_IF,0,2,0,0,0,2
ACCAAACTAGAAATCC-1_Br8667_Post_IF,3,0,0,0,0,3
TTACTGTTTCTCTACG-1_Br8667_Post_IF,2,0,0,0,0,2
GACCAGGTCATTCATA-1_Br8667_Post_IF,2,1,3,0,0,6
TTCTTCCCTTTGATAT-1_Br8667_Post_IF,0,1,0,0,0,1
ACGCCCAGCTGTCGAT-1_Br8667_Post_IF,0,1,0,0,0,1
AGTAGCGTGAACGAAC-1_Br8667_Post_IF,0,1,1,0,0,2
CCTCGACCCACTGCCT-1_Br8667_Post_IF,0,0,1,0,0,1
AGTTATTGAAAGGTAA-1_Br8667_Post_IF,2,1,0,0,0,3
TCAGTTACGGAATGAT-1_Br8667_Post_IF,2,0,1,0,0,3
GAATCTATACTCGGAC-1_Br8667_Post_IF,0,0,1,0,0,1
TCGGCTAACTTCCCTT-1_Br8667_Post_IF,2,3,1,0,0,6
ACGTGGTCGAATGTGC-1_Br8667_Post_IF,0,0,1,0,0,1
ATATCGTGCCAGACCC-1_Br8667_Post_IF,2,1,1,0,0,4
GTAGCTAGTAAGCGCG-1_Br8667_Post_IF,3,2,0,0,0,5
ACGCTTAGTGTCTCTC-1_Br8667_Post_IF,2,0,0,0,0,2
TCCGGCCTGCATCGAT-1_Br8667_Post_IF,1,0,0,0,0,1
TAGTGGAACTCATACA-1_Br8667_Post_IF,2,2,0,0,0,4
ATCATCTGCCCAGTGT-1_Br8667_Post_IF,2,1,0,0,0,3
GTTATTAAATACGACC-1_Br8667_Post_IF,2,0,0,3,0,5
GCGCTAAGTATGCATG-1_Br8667_Post_IF,1,1,1,0,0,3
CCTGACGCAACCTTTA-1_Br8667_Post_IF,3,1,1,0,0,5
CCCAAGAATGCACGGT-1_Br8667_Post_IF,1,0,0,0,0,1
AACTGGGTTCGAGCCG-1_Br8667_Post_IF,1,3,1,0,0,5
GGTTCCACCCGCTTCT-1_Br8667_Post_IF,0,1,1,0,0,2
CATGCACGTGTTACTG-1_Br8667_Post_IF,2,0,1,0,0,3
AGCGTTCCGATTTAAA-1_Br8667_Post_IF,1,1,0,0,0,2
CCTACGCGACCTTACA-1_Br8667_Post_IF,3,2,1,0,0,6
CGAATTACATGGTGTT-1_Br8667_Post_IF,3,1,1,0,0,5
GAGGTCTTAGTGGGTC-1_Br8667_Post_IF,1,0,0,0,0,1
GCCGCTAGATACGCAG-1_Br8667_Post_IF,0,1,1,0,0,2
GTCACCTGTCTATGTC-1_Br8667_Post_IF,3,4,0,0,0,7
CCGATTGGTCAATGAA-1_Br8667_Post_IF,0,0,3,0,0,3
CCTGTGCGGATTGTAA-1_Br8667_Post_IF,0,1,0,0,0,1
TTACGTAGCGCGTGCT-1_Br8667_Post_IF,1,0,3,1,0,5
GGAGGCGAAGAACCGC-1_Br8667_Post_IF,2,1,1,0,0,4
GGGTCACGTGCTTATG-1_Br8667_Post_IF,2,0,0,0,0,2
GCTCCGGACGTTGATA-1_Br8667_Post_IF,0,1,0,0,0,1
ATGTTTGTAAGATCAT-1_Br8667_Post_IF,0,2,1,1,0,4
TGACCCAGCATTCCCG-1_Br8667_Post_IF,1,1,1,0,0,3
TGGTCGTTTGATAGAT-1_Br8667_Post_IF,2,2,0,0,0,4
TGTAATGCCTTCGGAC-1_Br8667_Post_IF,0,3,0,0,0,3
TGCTCACACAACAACC-1_Br8667_Post_IF,1,2,0,0,0,3
TACGATCCAAGCCACT-1_Br8667_Post_IF,2,0,2,0,0,4
TTGTAACTTCATAGCG-1_Br8667_Post_IF,1,0,0,0,1,2
AGATTCAAGCGGGTCG-1_Br8667_Post_IF,2,1,0,1,0,4
CTCAGCAGACTGCCGA-1_Br8667_Post_IF,2,2,0,0,0,4
GTAACATCAGCTCATC-1_Br8667_Post_IF,1,0,2,0,0,3
ATGGAACAGAATAAAC-1_Br8667_Post_IF,1,1,0,0,0,2
GGGCCTATACAACCGG-1_Br8667_Post_IF,3,0,3,0,0,6
TCAAACAATTAGGACA-1_Br8667_Post_IF,0,1,0,0,0,1
AAACCACTACACAGAT-1_Br8667_Post_IF,0,1,0,0,1,2
AAACGACAGTCTTGCC-1_Br8667_Post_IF,3,0,1,0,0,4
TTGAGGGTCGAACGCG-1_Br8667_Post_IF,1,0,0,0,0,1
TGTTGATCACTGTTTA-1_Br8667_Post_IF,0,1,0,0,0,1
AGGGTGTGCTACACGC-1_Br8667_Post_IF,2,1,0,0,0,3
GTAGTTAGACAATATA-1_Br8667_Post_IF,0,1,3,2,0,6
AATGGCCGCCAATGCG-1_Br8667_Post_IF,2,1,1,1,0,5
TCGGCGGTATTAGATT-1_Br8667_Post_IF,0,1,1,0,0,2
GGGTCACTGAGTAGTG-1_Br8667_Post_IF,0,1,2,0,0,3
GAATTATGCAACCTAC-1_Br8667_Post_IF,2,0,2,0,0,4
GATCTTAGTGAACGTG-1_Br8667_Post_IF,0,1,2,0,0,3
CTAATGCGCCCAACAA-1_Br8667_Post_IF,3,1,0,0,0,4
GCCACCCATTCCACTT-1_Br8667_Post_IF,2,0,0,0,0,2
TACTCACAACGTAGTA-1_Br8667_Post_IF,0,0,0,0,0,0
GTTCGGTGTGGATTTA-1_Br8667_Post_IF,4,1,1,0,0,6
TCTTTCGGCGGGACAC-1_Br8667_Post_IF,5,1,1,0,0,7
GGAGACATTCACGGGC-1_Br8667_Post_IF,0,2,1,1,0,4
GGGATTATCTCACAAC-1_Br8667_Post_IF,1,1,1,0,0,3
TAGAACGCCAGTAACG-1_Br8667_Post_IF,0,0,0,0,0,0
ACGAGTCGCCGGCGTT-1_Br8667_Post_IF,1,0,0,0,0,1
TGATGGGACTAAGTCA-1_Br8667_Post_IF,1,1,2,0,0,4
TGCGAGAAACGTTACG-1_Br8667_Post_IF,1,0,2,0,0,3
TCGCCTCGACCTGTTG-1_Br8667_Post_IF,0,1,1,0,0,2
AACTCGATAAACACGT-1_Br8667_Post_IF,3,0,0,0,0,3
AGGAAAGCCTCTGATG-1_Br8667_Post_IF,0,1,1,0,0,2
GAAGGACTAAATTGAA-1_Br8667_Post_IF,4,2,2,0,0,8
GTATCGGGACGAGCTG-1_Br8667_Post_IF,3,1,0,0,0,4
CCTGTGCATAGGAGAC-1_Br8667_Post_IF,0,2,1,0,0,3
CATACGGGTGCATGAT-1_Br8667_Post_IF,1,0,1,0,0,2
CCACTAAACTGAATCG-1_Br8667_Post_IF,0,1,2,0,0,3
AAATTGCGGCGGTTCT-1_Br8667_Post_IF,3,2,0,0,0,5
AGTCCAGCGGGTACGT-1_Br8667_Post_IF,2,0,0,0,0,2
CATTCAGGTCAGTGCG-1_Br8667_Post_IF,3,1,1,0,0,5
CTAAAGTCCGAAGCTA-1_Br8667_Post_IF,2,0,0,0,0,2
AATCAGACTGCAGGAC-1_Br8667_Post_IF,1,2,1,0,0,4
AGTATCCATAATAACG-1_Br8667_Post_IF,6,0,0,0,0,6
CTGGCTGCTAACGTAA-1_Br8667_Post_IF,2,0,1,0,0,3
GTTCCAAGACAGCGAC-1_Br8667_Post_IF,0,0,0,0,0,0
AAGACTAACCCGTTGT-1_Br8667_Post_IF,1,0,1,0,0,2
GATTAATCCTGGCTCA-1_Br8667_Post_IF,4,1,2,0,0,7
CGCGCAAGGAACTACA-1_Br8667_Post_IF,2,0,1,0,0,3
CAGTAGCGAGGTAGTA-1_Br8667_Post_IF,3,0,2,0,0,5
ACGGCGGGTTGCCCTG-1_Br8667_Post_IF,2,1,0,0,0,3
CTAGGCGGCAGAGAAT-1_Br8667_Post_IF,3,1,1,0,0,5
GTGCGCAGCTTGCTCC-1_Br8667_Post_IF,2,0,0,0,0,2
TCACTATCGTGCAATC-1_Br8667_Post_IF,3,2,1,0,0,6
TATGATTCTGCTTGGT-1_Br8667_Post_IF,3,0,5,0,0,8
TAAGATTTAGCGGGAG-1_Br8667_Post_IF,0,1,0,0,0,1
TTACGGTGTCACCGAG-1_Br8667_Post_IF,1,0,0,0,0,1
CTACACTAGCTTGTTC-1_Br8667_Post_IF,0,2,1,0,0,3
TGAGCAGTCGTGAAGT-1_Br8667_Post_IF,2,0,0,0,0,2
CGCTGAGGACGTCCAA-1_Br8667_Post_IF,1,1,0,0,0,2
GTGTATGACTTTAAAG-1_Br8667_Post_IF,1,0,0,0,0,1
CTAAACGGGTGTAATC-1_Br8667_Post_IF,0,1,0,0,0,1
TGTACTGTGCCAAAGT-1_Br8667_Post_IF,3,0,0,0,0,3
GGCCACAAGCGATGGC-1_Br8667_Post_IF,4,0,0,0,0,4
GTCAATTGTACTGAAG-1_Br8667_Post_IF,1,1,2,0,0,4
AGGGACAGCACGGCGG-1_Br8667_Post_IF,0,0,2,0,0,2
AGCTTATAGAGACCTG-1_Br8667_Post_IF,2,1,1,0,0,4
AACTAGCGTATCGCAC-1_Br8667_Post_IF,2,2,0,0,0,4
AACTTTAGCTGCTGAG-1_Br8667_Post_IF,5,0,0,0,0,5
CCCAAGACAGAGTATG-1_Br8667_Post_IF,3,4,0,0,0,7
GGCATCAACGAGCACG-1_Br8667_Post_IF,3,2,1,0,0,6
ATGCATTCCGTGATGG-1_Br8667_Post_IF,2,1,1,0,0,4
TTATAGATGCACATTA-1_Br8667_Post_IF,0,0,3,0,0,3
GAACCATCTGGGAGAC-1_Br8667_Post_IF,1,2,1,0,0,4
TGCTATACAAACGGAC-1_Br8667_Post_IF,0,3,0,0,0,3
ACTTGCCATATTGTAC-1_Br8667_Post_IF,2,1,7,0,0,10
TATTCCGGCAGTCCTA-1_Br8667_Post_IF,2,4,0,0,0,6
GACGGACCGCGTTCCT-1_Br8667_Post_IF,1,1,0,0,0,2
ATGTGTAGTTTAGTCA-1_Br8667_Post_IF,2,1,0,0,0,3
ATACCAGCAAATTGCT-1_Br8667_Post_IF,4,0,1,0,0,5
AAGTTTACTAATGGCA-1_Br8667_Post_IF,0,2,2,0,0,4
CTCTCGATGTGCGCCT-1_Br8667_Post_IF,0,1,2,0,0,3
GATTGACACTCTGCTC-1_Br8667_Post_IF,2,2,2,0,0,6
TATCACAGCACGGGCA-1_Br8667_Post_IF,2,1,1,1,0,5
ACCGTTCCCGCTCTGA-1_Br8667_Post_IF,3,0,0,0,0,3
CCGCCACCACAATCCA-1_Br8667_Post_IF,2,0,1,0,0,3
CATTCACTGACAGCTA-1_Br8667_Post_IF,3,1,1,0,0,5
CGGCTGCAAGATTAAG-1_Br8667_Post_IF,2,2,2,1,0,7
CATGAACCTCTTATCA-1_Br8667_Post_IF,4,0,0,1,0,5
TTAATGCGAGGTAACT-1_Br8667_Post_IF,2,1,1,0,0,4
AATAAGTCCTCGAGAC-1_Br8667_Post_IF,1,0,0,0,0,1
ACCAGCCCGGTCTTTG-1_Br8667_Post_IF,0,1,0,0,0,1
CTACGAACTAGGTCGA-1_Br8667_Post_IF,2,1,5,0,0,8
ACATCTCAACGCGTAA-1_Br8667_Post_IF,0,1,0,0,0,1
CACTACTCAGTTCTGT-1_Br8667_Post_IF,4,0,0,0,0,4
CCGACTCGCATAGTCT-1_Br8667_Post_IF,2,2,0,0,0,4
CATTTATCGTTCAAGA-1_Br8667_Post_IF,0,1,0,1,0,2
CAAACGTGGTCTTGCG-1_Br8667_Post_IF,1,0,0,0,0,1
TAGAAACCACTAAGTA-1_Br8667_Post_IF,2,1,0,0,0,3
ACTGATTTAGTGATTC-1_Br8667_Post_IF,0,0,1,0,0,1
TCGTATTTCGTCCGGA-1_Br8667_Post_IF,3,2,0,1,0,6
CGGAAATTTCACATCC-1_Br8667_Post_IF,3,0,1,0,0,4
ATCCACGCTAAATGTT-1_Br8667_Post_IF,4,0,0,0,0,4
GTTCAATCTATGTCAA-1_Br8667_Post_IF,2,3,0,0,0,5
ATAAAGGTCAAGTACG-1_Br8667_Post_IF,2,1,0,1,0,4
CAACTCCAACGTTTAG-1_Br8667_Post_IF,1,0,1,0,0,2
TAGGAACAGCCTCCAG-1_Br8667_Post_IF,2,1,1,0,1,5
ATGGGAACGGAAGCGG-1_Br8667_Post_IF,1,1,1,0,0,3
CACACGTTTCAATGGG-1_Br8667_Post_IF,2,0,0,1,0,3
GGTGTTCTGTTTCTAC-1_Br8667_Post_IF,4,2,0,1,0,7
AGTAACGTTCATCCTG-1_Br8667_Post_IF,0,2,0,0,0,2
GTATAGTGGCCCATGT-1_Br8667_Post_IF,2,2,2,0,0,6
TCTACACGTTCATGCA-1_Br8667_Post_IF,12,0,0,0,0,12
AATCTGGGTAGACCCT-1_Br8667_Post_IF,0,2,0,1,1,4
TCGGTTAGCCATGTAG-1_Br8667_Post_IF,2,0,0,0,0,2
TGCCATGGCTTATAAG-1_Br8667_Post_IF,2,3,1,0,0,6
TAAGTAAATGTGCCGC-1_Br8667_Post_IF,2,0,1,0,0,3
GTGTCCGATAAGGCAT-1_Br8667_Post_IF,1,0,0,0,0,1
TGGCACGAGCTCGAGT-1_Br8667_Post_IF,1,1,0,0,0,2
ACCGGTCTGAGTACGG-1_Br8667_Post_IF,1,0,1,0,0,2
GAACTTAGCGCCCGGT-1_Br8667_Post_IF,1,0,1,0,0,2
AGTAGCTAGACGCCGA-1_Br8667_Post_IF,1,1,0,0,0,2
ATAGGAATCTAAGCTT-1_Br8667_Post_IF,3,3,0,0,0,6
CTTCCTGCATATTTAC-1_Br8667_Post_IF,1,1,0,0,0,2
CAATATGTAGATTTAC-1_Br8667_Post_IF,0,1,1,0,0,2
ACAAGGCCTACCAGCC-1_Br8667_Post_IF,2,0,3,0,0,5
TTATAGTCCAAGGTGC-1_Br8667_Post_IF,2,1,0,0,0,3
AAACGCCCGAGATCGG-1_Br8667_Post_IF,1,1,0,0,0,2
CCTCGTTACGCCTGTT-1_Br8667_Post_IF,2,0,0,0,0,2
GAACGGTGTAAAGCAG-1_Br8667_Post_IF,1,0,0,1,0,2
ACGCATAAATGACATG-1_Br8667_Post_IF,1,2,1,0,0,4
GGTTCGATGCTGAGTT-1_Br8667_Post_IF,4,1,2,1,0,8
CTTTGGCAGACAGAGT-1_Br8667_Post_IF,2,0,2,0,0,4
TTCGTGGGCTGGAAGC-1_Br8667_Post_IF,1,1,0,0,0,2
CAAAGGTTAAATTCAG-1_Br8667_Post_IF,2,0,0,0,0,2
GTTTGGCGTCAGGCAC-1_Br8667_Post_IF,0,0,1,1,0,2
GCTTTCTATCTCAACT-1_Br8667_Post_IF,3,3,1,0,0,7
TGCATCTCCGGATCTT-1_Br8667_Post_IF,1,0,0,0,0,1
CTGAAACGGCCCTCAG-1_Br8667_Post_IF,2,1,3,0,0,6
TAGCAGTAAATACGCG-1_Br8667_Post_IF,1,0,0,0,2,3
CGGGCTACTTAAATTG-1_Br8667_Post_IF,1,0,2,0,0,3
ATTATGCTCAGTATTG-1_Br8667_Post_IF,0,1,0,1,0,2
TGATGCTCACGTAGTC-1_Br8667_Post_IF,1,1,3,0,0,5
GTCTAAGATGCCCAGC-1_Br8667_Post_IF,1,0,1,0,0,2
AACCCGATAGGGCTTC-1_Br8667_Post_IF,1,1,4,0,0,6
CGCTATCGTGGCTTTA-1_Br8667_Post_IF,0,2,2,0,0,4
CGTCTCTCGCCGAGGC-1_Br8667_Post_IF,5,2,2,0,0,9
AGTGGGAGTATACACG-1_Br8667_Post_IF,0,0,0,0,0,0
GGTCTTGGTGTTAACT-1_Br8667_Post_IF,2,1,1,0,0,4
GGCTGGCAGCTTTATG-1_Br8667_Post_IF,3,1,1,0,0,5
CGCCAATTATTGCGTT-1_Br8667_Post_IF,1,2,1,0,0,4
GGTAACCGGCAAAGGT-1_Br8667_Post_IF,3,1,1,0,0,5
TGGGACCATTGGGAGT-1_Br8667_Post_IF,0,1,0,0,0,1
CTGCAGGTGCTCGGCC-1_Br8667_Post_IF,2,3,4,0,0,9
CCGGTGCGAGTGATAG-1_Br8667_Post_IF,1,0,0,0,0,1
GGGTACACTCTGGAGG-1_Br8667_Post_IF,1,1,0,0,0,2
TAGCCAGAGGGTCCGG-1_Br8667_Post_IF,0,0,0,0,0,0
CTTGTGAGGACAGCGG-1_Br8667_Post_IF,5,0,0,0,0,5
GAAGGGCATAACCATG-1_Br8667_Post_IF,2,0,0,0,0,2
CAACATGGCCTGATAA-1_Br8667_Post_IF,4,2,0,0,0,6
CAATTTGACCGGGAAG-1_Br8667_Post_IF,2,1,0,0,0,3
TCTGACTGTAATGGTT-1_Br8667_Post_IF,2,1,0,0,0,3
TTCATAGCCTTGTAAC-1_Br8667_Post_IF,1,0,0,0,0,1
TGGAAACGGAGTGAAC-1_Br8667_Post_IF,2,2,4,0,0,8
ATCGCACGATTGTTCA-1_Br8667_Post_IF,3,1,2,0,0,6
CGCCACCCGCATTAAC-1_Br8667_Post_IF,1,0,0,1,0,2
TGGACCACGGCGTTGA-1_Br8667_Post_IF,2,1,0,0,0,3
GTATATGTTACGGCGG-1_Br8667_Post_IF,0,1,0,0,0,1
GTATTCTTACCGTGCT-1_Br8667_Post_IF,8,0,0,1,0,9
TTCAGAGTAACCTGAC-1_Br8667_Post_IF,3,1,1,0,0,5
GCGGTAACCCAAATGA-1_Br8667_Post_IF,0,2,2,0,0,4
CTACGTGTTGCCACCA-1_Br8667_Post_IF,2,0,0,0,0,2
CTAGATAAACTCCTCG-1_Br8667_Post_IF,1,0,0,0,0,1
TCCATTAGTTGGATAG-1_Br8667_Post_IF,3,1,0,0,0,4
CTGGCTCCTGCGGGAT-1_Br8667_Post_IF,1,1,4,0,0,6
CAGTCTCTCGGCTAAT-1_Br8667_Post_IF,5,0,0,0,0,5
GTATGACGTGGGAAAC-1_Br8667_Post_IF,0,1,0,0,0,1
AGTCACTCCGCCTCAT-1_Br8667_Post_IF,0,0,4,0,0,4
GCAGCGGTGGGCATTA-1_Br8667_Post_IF,3,1,2,0,0,6
TATGGAGTTTCTCGTT-1_Br8667_Post_IF,1,1,0,0,0,2
ACTCAACGAATGTATT-1_Br8667_Post_IF,5,1,0,0,0,6
AACACGCGGCCGCGAA-1_Br8667_Post_IF,3,2,0,0,0,5
CGATATTAGCCGCAGG-1_Br8667_Post_IF,1,0,2,0,0,3
AGCGTCTGAACCCGCA-1_Br8667_Post_IF,0,1,0,0,0,1
GATGTCCGGATCACAT-1_Br8667_Post_IF,1,0,0,0,0,1
GGTCACGTTAGATTCA-1_Br8667_Post_IF,0,0,2,0,0,2
TTAAGGATACGGAGGT-1_Br8667_Post_IF,11,2,0,0,0,13
GTGCGGGACCATCGGC-1_Br8667_Post_IF,9,0,2,0,1,12
CCATCTTGTTCACAAT-1_Br8667_Post_IF,0,2,1,0,0,3
TCCGAGAAGGCTAAGC-1_Br8667_Post_IF,2,0,0,1,0,3
TGGCGGTGTGCGATTG-1_Br8667_Post_IF,2,1,1,0,0,4
ATCCTGCTGCAGATAG-1_Br8667_Post_IF,2,6,2,0,0,10
TTATGCGTCCCGGTCC-1_Br8667_Post_IF,2,1,0,1,0,4
CATAATGAGCGGGCGA-1_Br8667_Post_IF,1,1,2,0,0,4
AGACATAGATCCTTCC-1_Br8667_Post_IF,3,0,1,0,0,4
GGTGAAACCGGGAATG-1_Br8667_Post_IF,5,3,0,0,0,8
AACTGGTGTGGGCCTT-1_Br8667_Post_IF,2,0,0,0,0,2
GTAGCGCTGTTGTAGT-1_Br8667_Post_IF,3,3,1,0,0,7
TTGTTTGTGTAAATTC-1_Br8667_Post_IF,0,2,1,0,0,3
GGATCAAAGGACGAGG-1_Br8667_Post_IF,3,1,0,0,0,4
CGTAGCGCCGACGTTG-1_Br8667_Post_IF,1,2,0,0,0,3
CAAGTGAACTTTGGTT-1_Br8667_Post_IF,0,1,3,0,0,4
GTAGACAACCGATGAA-1_Br8667_Post_IF,2,3,0,0,0,5
CAATGGTCGGCCTGGG-1_Br8667_Post_IF,2,1,0,0,0,3
ACAGATTAGGTTAGTG-1_Br8667_Post_IF,1,3,0,0,0,4
GTTATCACCTTCTGAA-1_Br8667_Post_IF,4,2,3,0,0,9
TGGTATCGGTCTGTAT-1_Br8667_Post_IF,0,2,0,0,0,2
GGAATAACCTCAAGAA-1_Br8667_Post_IF,1,2,0,0,0,3
ATTATCTCGACAGATC-1_Br8667_Post_IF,3,5,0,0,0,8
CCGAGGGATGTTAGGC-1_Br8667_Post_IF,2,0,4,0,0,6
TGAGATCAAATACTCA-1_Br8667_Post_IF,4,2,1,0,0,7
AAACGAAGAACATACC-1_Br8667_Post_IF,1,1,1,0,0,3
CTGGTCCTAACTTGGC-1_Br8667_Post_IF,1,3,1,0,0,5
TGCACGAGTCGGCAGC-1_Br8667_Post_IF,1,1,0,0,0,2
ATAGTCTTTGACGTGC-1_Br8667_Post_IF,1,3,0,0,0,4
TGGAGCTAAAGTTCCC-1_Br8667_Post_IF,2,0,2,0,0,4
GGGTGGTCCAGCCTGT-1_Br8667_Post_IF,4,2,0,0,0,6
CATGCATGGAGACCCT-1_Br8667_Post_IF,2,3,0,1,0,6
ACACGGCACTATGCAT-1_Br8667_Post_IF,2,0,2,0,0,4
CCCTGGTATGGGCGGC-1_Br8667_Post_IF,3,1,0,0,0,4
GGAGGATTGAAAGGAG-1_Br8667_Post_IF,1,0,2,0,0,3
CCGCTGGTGCCATTCA-1_Br8667_Post_IF,1,1,1,1,0,4
GTTAGAGTGTGCCGCT-1_Br8667_Post_IF,3,1,2,0,0,6
TCGGAATGACCATCAA-1_Br8667_Post_IF,3,0,2,0,0,5
TTCAATTAGCCATAAT-1_Br8667_Post_IF,1,0,2,1,0,4
GATGTGTTGTCACAAG-1_Br8667_Post_IF,1,2,2,0,0,5
TCTTTCTCTTAAGGAG-1_Br8667_Post_IF,3,1,0,0,0,4
ACCCTTTAGTTCTCCA-1_Br8667_Post_IF,1,1,1,0,0,3
ACCACAACTCAGAACA-1_Br8667_Post_IF,0,1,0,0,0,1
TATGATAAATCTAACG-1_Br8667_Post_IF,1,1,1,0,0,3
GATCCTCTTGCGCTTA-1_Br8667_Post_IF,2,1,1,0,0,4
TTCTACCTTTATGTTG-1_Br8667_Post_IF,3,0,1,0,0,4
GAAATACCTGCTGGCT-1_Br8667_Post_IF,1,1,0,0,0,2
ATTCTGAGTATGAACT-1_Br8667_Post_IF,2,0,0,0,0,2
GGATTAAGCTAAGGTC-1_Br8667_Post_IF,0,1,0,0,0,1
AGTACGTGGCCTGTCT-1_Br8667_Post_IF,0,0,1,0,1,2
TCAGGGTGCACGAAAC-1_Br8667_Post_IF,2,0,0,1,0,3
AAATTTACCGAAATCC-1_Br8667_Post_IF,3,0,1,0,0,4
TTGAGGCATTTAACTC-1_Br8667_Post_IF,3,0,1,0,0,4
AACCAGTATCACTCTT-1_Br8667_Post_IF,1,1,0,0,0,2
CACCGGAGATATCTCC-1_Br8667_Post_IF,0,1,0,0,0,1
GACTGGGCGCCGCAAC-1_Br8667_Post_IF,2,1,1,0,0,4
CACGTCTATGATGTGG-1_Br8667_Post_IF,2,4,1,0,0,7
TTAAGACGAACGAACC-1_Br8667_Post_IF,1,1,0,1,0,3
TGACCAGCTTCAAAGT-1_Br8667_Post_IF,1,2,2,0,0,5
AGAGTTAGAGACCGAT-1_Br8667_Post_IF,1,0,0,1,0,2
TTCGGACTGATGCCTT-1_Br8667_Post_IF,2,0,3,0,0,5
CTCGAATGGAACGTAT-1_Br8667_Post_IF,1,1,1,0,0,3
GGACGGCTTGCGCAAC-1_Br8667_Post_IF,1,1,2,0,0,4
CTAAGTACAGGGCTAC-1_Br8667_Post_IF,0,0,0,0,0,0
ACAAATTCAGATCTGA-1_Br8667_Post_IF,3,0,0,0,0,3
CATGGAAATGGGACCA-1_Br8667_Post_IF,1,1,2,0,0,4
GGTGGACCACGTGTTA-1_Br8667_Post_IF,3,1,1,0,0,5
CACGACGTAATAGTAA-1_Br8667_Post_IF,1,1,1,0,0,3
CGGGTTCGGCACGTAT-1_Br8667_Post_IF,1,0,3,1,0,5
CTGGGCTATCCTTTGG-1_Br8667_Post_IF,1,0,2,1,0,4
GTATTAGGGTTCGCGT-1_Br8667_Post_IF,1,0,2,0,0,3
TCATTCGTATAATTTG-1_Br8667_Post_IF,2,1,4,0,0,7
AATAGCAAGCCTCCTG-1_Br8667_Post_IF,1,0,2,0,0,3
CATCTACCCGAGAACG-1_Br8667_Post_IF,2,0,3,0,0,5
GCTTCAGTGGGATTAC-1_Br8667_Post_IF,3,1,0,0,0,4
TCTGTGATGGAGGTTG-1_Br8667_Post_IF,1,1,3,0,0,5
ATCCACTTTCAGACTA-1_Br8667_Post_IF,4,0,0,0,0,4
ATGGTTACGAAACATG-1_Br8667_Post_IF,1,0,1,0,0,2
GGCCCAATCTAGAGGG-1_Br8667_Post_IF,1,2,2,0,0,5
GATGGTGAAATAACCC-1_Br8667_Post_IF,0,1,0,0,0,1
AGAGGGACAATTGTCC-1_Br8667_Post_IF,1,1,0,1,0,3
CGCGTACATTCTGGAA-1_Br8667_Post_IF,1,1,3,0,0,5
CAAGAAACCCTAAACT-1_Br8667_Post_IF,1,2,2,0,0,5
TTGGTGCGGTGTTGAA-1_Br8667_Post_IF,1,1,1,0,0,3
GGTTCCCTAGTGTCTC-1_Br8667_Post_IF,0,0,0,0,0,0
CGATAACCAATTTGAG-1_Br8667_Post_IF,1,0,2,0,0,3
GCCCACTGGTCCACAA-1_Br8667_Post_IF,5,1,0,0,0,6
GAGGGCCGGCAGAGTC-1_Br8667_Post_IF,1,1,2,0,0,4
CGACACGGATGCCCAC-1_Br8667_Post_IF,1,1,1,2,0,5
CTGTCTGTGGCTGGCT-1_Br8667_Post_IF,1,0,1,0,0,2
ATATTATCCCGTATTT-1_Br8667_Post_IF,7,0,0,0,0,7
GCGCTGGCGGAAAGTC-1_Br8667_Post_IF,1,1,1,0,0,3
ATCTAACGTCCCTATG-1_Br8667_Post_IF,1,0,1,0,0,2
GTCAGACAGCGTTGGA-1_Br8667_Post_IF,1,1,0,0,0,2
GCCAGGCTTAGTGGTA-1_Br8667_Post_IF,4,0,2,1,0,7
ATTCAAAGTACCTGTT-1_Br8667_Post_IF,1,0,0,0,0,1
TGGACGTAGGCGAATC-1_Br8667_Post_IF,2,0,0,0,0,2
ACACATTGACGCAACA-1_Br8667_Post_IF,4,2,0,0,0,6
GATATCAGTATGTATC-1_Br8667_Post_IF,1,1,3,0,0,5
TGGGCCTTGCCTGCAT-1_Br8667_Post_IF,1,0,2,0,0,3
CAAAGTCAGGTTAGCT-1_Br8667_Post_IF,3,1,0,0,0,4
GGATCCCTACCAGCTA-1_Br8667_Post_IF,2,0,2,0,0,4
ATCGTCCAATCGAGTC-1_Br8667_Post_IF,4,0,1,0,0,5
ACATGGCTCAATTTAG-1_Br8667_Post_IF,2,1,0,0,0,3
AGGCCCAGTGACTGGT-1_Br8667_Post_IF,3,0,0,0,0,3
GCTTCCAGCTTAGATT-1_Br8667_Post_IF,3,0,0,0,0,3
TGCTTGAAACCATGCA-1_Br8667_Post_IF,4,1,0,0,0,5
CAATATTGGACTAGTG-1_Br8667_Post_IF,3,1,2,0,0,6
CGTGCTGGCCTAGTCG-1_Br8667_Post_IF,2,2,1,0,0,5
CCTGCGATAGAACTGT-1_Br8667_Post_IF,1,0,0,0,0,1
GGGTAATGCTGTGTTT-1_Br8667_Post_IF,3,0,0,0,0,3
AACGCGAACGGCAACA-1_Br8667_Post_IF,4,1,0,0,0,5
TGTCGGCATGGTGGAA-1_Br8667_Post_IF,1,2,1,0,0,4
AGCGTACGAGAGCTAG-1_Br8667_Post_IF,0,1,1,0,0,2
ATACTCTCGCCACTCT-1_Br8667_Post_IF,3,1,0,0,0,4
AATCCATGCAAGGGTG-1_Br8667_Post_IF,4,1,0,0,0,5
TTAAACAGAGTCCCGC-1_Br8667_Post_IF,1,0,1,0,0,2
CCACAGCTGAAATCAT-1_Br8667_Post_IF,2,0,2,0,0,4
CGGTTCCGGCTTCTTG-1_Br8667_Post_IF,1,1,1,0,0,3
GACGTGAGACTCCATG-1_Br8667_Post_IF,1,0,0,0,0,1
TCGTTGGCTCGTCAAT-1_Br8667_Post_IF,2,0,1,0,0,3
GGTGAACGGGCTAGCC-1_Br8667_Post_IF,2,1,1,0,0,4
GCACTGTGCAAATGTA-1_Br8667_Post_IF,1,1,0,0,0,2
ACGAGAACCCATCACG-1_Br8667_Post_IF,4,0,1,0,0,5
CCAGCTACGCCTCATA-1_Br8667_Post_IF,1,1,0,0,0,2
TCCCGGTCAGGAATTT-1_Br8667_Post_IF,1,0,1,0,0,2
TCGCATTCAATGACTT-1_Br8667_Post_IF,1,2,0,0,0,3
CTGGTTCAACGCATCA-1_Br8667_Post_IF,1,0,0,0,0,1
GGTGATTTCATCTTGT-1_Br8667_Post_IF,1,2,0,0,0,3
CACCCTTTCCTCGCTC-1_Br8667_Post_IF,2,2,0,0,0,4
CAACTTGTAGTGGGCA-1_Br8667_Post_IF,1,2,2,0,0,5
AATATCAAGGTCGGAT-1_Br8667_Post_IF,2,1,1,0,0,4
ACTCAGACCTGCTTCT-1_Br8667_Post_IF,1,3,1,0,0,5
TTGGAGTCTCCCTTCT-1_Br8667_Post_IF,3,1,0,0,0,4
GGATACTCATGAATTG-1_Br8667_Post_IF,0,2,0,0,0,2
TGGGCACAAACAGAAC-1_Br8667_Post_IF,2,1,1,1,0,5
GAGCCACGGTAGTAGG-1_Br8667_Post_IF,0,2,3,1,0,6
TCGATAGGCTAGTCGC-1_Br8667_Post_IF,2,0,2,0,0,4
TAACCGCCCGCAGTGC-1_Br8667_Post_IF,3,2,3,0,0,8
GCCTATTTGCTACACA-1_Br8667_Post_IF,6,1,0,0,0,7
TTGACGATTCAGCACG-1_Br8667_Post_IF,0,0,1,0,0,1
TTAAACCGGTAGCGAC-1_Br8667_Post_IF,0,1,0,0,0,1
ACCGAAAGGGCCCTGC-1_Br8667_Post_IF,4,1,1,0,0,6
ACGTTCCGCGCTCCGT-1_Br8667_Post_IF,1,2,1,0,0,4
ATACCAGGCTAATAGA-1_Br8667_Post_IF,2,2,1,0,0,5
CGGCTTTGTATGATAA-1_Br8667_Post_IF,3,2,2,0,0,7
CTTGACCCGAAAGATA-1_Br8667_Post_IF,1,0,0,0,0,1
CGCAGAAACATTTGCG-1_Br8667_Post_IF,2,3,4,1,0,10
GACCCGTCGCCGGCTA-1_Br8667_Post_IF,1,0,2,0,0,3
AATCGGGACACTACGA-1_Br8667_Post_IF,1,3,3,0,0,7
GTCACAAAGTTTCCAA-1_Br8667_Post_IF,2,2,1,1,0,6
TATATTCGCGTCGATA-1_Br8667_Post_IF,2,0,0,0,0,2
CCTCCCGACAATCCCT-1_Br8667_Post_IF,0,2,3,0,0,5
CGACATGCGATCTTCT-1_Br8667_Post_IF,2,0,0,0,0,2
AACACGACTGTACTGA-1_Br8667_Post_IF,3,1,1,0,0,5
CCCAACCACACTAACA-1_Br8667_Post_IF,5,1,1,0,0,7
CACCGCCGACCAGCGA-1_Br8667_Post_IF,2,4,1,0,0,7
TGGTATCGCATCCCAA-1_Br8667_Post_IF,2,2,0,0,1,5
CAGAGTGATTTAACGT-1_Br8667_Post_IF,0,1,0,0,0,1
AACCCTGGTGGAACCA-1_Br8667_Post_IF,1,1,0,0,0,2
GTCAGTTGTGCTCGTT-1_Br8667_Post_IF,0,2,2,0,0,4
ATTGACGTAACTCGGT-1_Br8667_Post_IF,2,1,0,0,0,3
GATGTCGGTCAACTGC-1_Br8667_Post_IF,4,0,2,0,0,6
AGGGCAGCGGCGTGGT-1_Br8667_Post_IF,1,1,0,1,0,3
ACATCGTTAACCTAGT-1_Br8667_Post_IF,1,2,2,0,0,5
TCCATTGTGACCTCGT-1_Br8667_Post_IF,4,0,1,0,0,5
TGTTTAATACTTCATC-1_Br8667_Post_IF,1,0,4,0,0,5
TTGCTGGCCGGGCTTC-1_Br8667_Post_IF,1,0,3,0,0,4
CATATTATTTGCCCTA-1_Br8667_Post_IF,2,0,0,0,0,2
CTGCCTAGCCACCAAG-1_Br8667_Post_IF,0,4,0,0,0,4
ACGAGATATTTGCTTA-1_Br8667_Post_IF,5,1,1,1,0,8
GACTACAATTGCTCGT-1_Br8667_Post_IF,1,1,1,1,0,4
AACGTGATGAAGGACA-1_Br8667_Post_IF,2,1,0,0,0,3
ACTCTCTTATACACGA-1_Br8667_Post_IF,2,1,1,0,0,4
CGCATCATGGCTTCAG-1_Br8667_Post_IF,2,3,2,0,0,7
CGGCTCTTCGTCGAAC-1_Br8667_Post_IF,4,1,1,0,0,6
ATTCTTCGTACTTATG-1_Br8667_Post_IF,2,2,2,0,0,6
AGTGAGGGTTTCTGAC-1_Br8667_Post_IF,1,1,1,0,0,3
GCCAGGCGTTCGCATG-1_Br8667_Post_IF,2,2,2,0,0,6
GACTAACACAGCACCT-1_Br8667_Post_IF,2,1,0,0,0,3
CAATGGAATCTACATA-1_Br8667_Post_IF,3,2,0,0,0,5
GTGGTCAGCGAAGTAT-1_Br8667_Post_IF,0,1,3,0,0,4
ATGGCTGGAAATGGCC-1_Br8667_Post_IF,2,0,0,2,0,4
ATCAGGTCGCCATTGC-1_Br8667_Post_IF,1,0,0,0,0,1
TATCACCATGTAAAGT-1_Br8667_Post_IF,4,0,2,1,0,7
AGCGCTTATGGGCAAG-1_Br8667_Post_IF,1,1,0,1,0,3
AAGCGGCGTCATGGGT-1_Br8667_Post_IF,2,0,0,0,0,2
ACTAATACGTCAGGCG-1_Br8667_Post_IF,1,1,0,1,0,3
GGCTGAGCATCGTAAG-1_Br8667_Post_IF,1,0,0,0,0,1
CGGTTGGGTTCAAGTT-1_Br8667_Post_IF,5,2,0,0,0,7
GACTGATTGGTCACAA-1_Br8667_Post_IF,0,0,0,0,0,0
AGACGGGCCGATTTAA-1_Br8667_Post_IF,3,0,2,0,0,5
ACCAGTGCCCGGTCAA-1_Br8667_Post_IF,1,0,1,0,0,2
GTCCTTTAATGACTTC-1_Br8667_Post_IF,4,1,2,0,0,7
CCTACAAGTCCGGAAT-1_Br8667_Post_IF,0,1,0,0,0,1
GCCTGCTACACTGAGA-1_Br8667_Post_IF,0,1,2,0,0,3
GACTCGGTCGGCGGAT-1_Br8667_Post_IF,3,1,0,0,0,4
CTAGACATATATGTAG-1_Br8667_Post_IF,1,0,1,0,0,2
TCGCCCAACTGACTCC-1_Br8667_Post_IF,0,0,5,0,0,5
AAACTAACGTGGCGAC-1_Br8667_Post_IF,0,3,2,0,0,5
AACTGAGGTCAGCGTC-1_Br8667_Post_IF,0,1,2,1,0,4
ACAATGATTCTTCTAC-1_Br8667_Post_IF,2,0,2,0,0,4
ATAAGTACCCGATTGT-1_Br8667_Post_IF,2,1,1,0,0,4
ATTGGGAGTTCTGTAA-1_Br8667_Post_IF,0,0,2,0,0,2
CGAACATAGTCAGAAA-1_Br8667_Post_IF,1,1,3,0,0,5
TAGCTCAGATCCTAGT-1_Br8667_Post_IF,1,1,1,1,0,4
GTGTCGTATTCACCTT-1_Br8667_Post_IF,2,1,1,0,0,4
CTCACCGATCCAAACT-1_Br8667_Post_IF,1,1,0,0,0,2
ATATGTGCACAAACCA-1_Br8667_Post_IF,1,3,0,0,0,4
CAGTCCAACGCCTTCT-1_Br8667_Post_IF,1,4,0,0,0,5
TCGTCCGGGTACACTC-1_Br8667_Post_IF,2,1,1,0,0,4
GCAGAAACGTAATCCA-1_Br8667_Post_IF,1,2,1,0,0,4
TTCGAGCCGGCGCTAC-1_Br8667_Post_IF,3,0,1,0,0,4
GGAAGATAAGACTGTA-1_Br8667_Post_IF,0,1,3,0,0,4
ATAAGCAAACACCGAG-1_Br8667_Post_IF,2,2,0,0,0,4
GCATAAATTGAACGCC-1_Br8667_Post_IF,3,2,0,0,0,5
CGCCGGTGTCGCAGTA-1_Br8667_Post_IF,3,1,0,0,0,4
GACCTGGTCTGGGCGT-1_Br8667_Post_IF,1,0,0,0,0,1
AGCCGCTTGATTAGCG-1_Br8667_Post_IF,0,0,0,0,0,0
CCCGGCTAGGTGAGAA-1_Br8667_Post_IF,3,0,1,0,0,4
CGAGCCGAGCACTCGA-1_Br8667_Post_IF,1,0,0,0,0,1
TAGTGCTTGAATCCTT-1_Br8667_Post_IF,2,3,0,0,0,5
CAACCGCACCTAGACA-1_Br8667_Post_IF,1,1,1,0,0,3
ACCACTGTTCAAGAAG-1_Br8667_Post_IF,1,2,1,0,0,4
AGATGCTATAACGAGC-1_Br8667_Post_IF,2,2,1,0,0,5
AATTACTCGTACGCTC-1_Br8667_Post_IF,2,2,0,0,0,4
CGTCAATCTTTAACAT-1_Br8667_Post_IF,1,0,0,0,0,1
CCAAAGCAGTTGGTTG-1_Br8667_Post_IF,1,1,2,0,0,4
CCATATTGGATCATGA-1_Br8667_Post_IF,0,0,1,0,0,1
CGTACCGAAAGTCTAG-1_Br8667_Post_IF,0,0,2,0,0,2
CTCGAGATCCAAAGCA-1_Br8667_Post_IF,3,2,2,0,0,7
TGGATAGAGTAACAGA-1_Br8667_Post_IF,1,0,0,0,0,1
TCACAGATCCTCAAAC-1_Br8667_Post_IF,1,0,2,0,0,3
AGAGCTACGAAAGCAT-1_Br8667_Post_IF,2,0,1,0,0,3
TGCGTGATTGGGTGTC-1_Br8667_Post_IF,0,1,2,0,0,3
CACATGTTTGGACATG-1_Br8667_Post_IF,2,2,1,0,0,5
TTCGCATCCGGAAGCA-1_Br8667_Post_IF,4,0,0,0,0,4
CCCTAGTGTCAGGTGT-1_Br8667_Post_IF,1,1,0,0,0,2
TTACCGCCTTAGGGAA-1_Br8667_Post_IF,1,0,0,0,0,1
CCAGTCCATTATTCGA-1_Br8667_Post_IF,5,0,1,0,0,6
CGTAAACGCTTGAGTG-1_Br8667_Post_IF,0,0,0,0,0,0
ATTCCTTCCAGGCGGT-1_Br8667_Post_IF,2,0,0,0,0,2
TTCCTTTCTGTGTTGC-1_Br8667_Post_IF,1,0,0,0,0,1
AGTTGACATCGGCTGG-1_Br8667_Post_IF,2,1,0,0,0,3
AACTCGATGGCGCAGT-1_Br8667_Post_IF,2,0,0,0,0,2
GATAAGGCAGATGCAA-1_Br8667_Post_IF,1,1,2,0,0,4
GGCTGGCTAGCTTAAA-1_Br8667_Post_IF,3,1,0,0,0,4
CCTCATGCAGCTACGA-1_Br8667_Post_IF,3,1,1,0,0,5
GACGCCTGTTGCAGGG-1_Br8667_Post_IF,3,0,1,0,0,4
TAATTAGATGGATATG-1_Br8667_Post_IF,1,2,1,0,0,4
GAGGGCATCGCGTATC-1_Br8667_Post_IF,1,0,0,0,0,1
CTTGTGAGTCTTTGAC-1_Br8667_Post_IF,1,3,0,0,0,4
TCAACACATTGGGTAA-1_Br8667_Post_IF,0,0,2,0,0,2
ACTGTATACGCGAGCA-1_Br8667_Post_IF,0,2,0,0,0,2
GTGAAACGTGCTCCAC-1_Br8667_Post_IF,3,0,0,0,0,3
CGAGTGCTATAGTTCG-1_Br8667_Post_IF,2,4,2,0,0,8
GTACTGCATGAAGCGT-1_Br8667_Post_IF,2,1,1,0,0,4
GTAACTTGCGGCAGTC-1_Br8667_Post_IF,5,1,3,0,0,9
GAATCGCCGGACACGG-1_Br8667_Post_IF,2,1,1,0,0,4
GGGAGTAATGGCTGGC-1_Br8667_Post_IF,2,0,2,1,0,5
CATGAACCGACATTTG-1_Br8667_Post_IF,0,1,1,0,0,2
TCTGTCATACAAGAGC-1_Br8667_Post_IF,0,1,0,0,0,1
GTCGTCAATTATAAGG-1_Br8667_Post_IF,2,1,0,0,0,3
TAAAGAGCCCGAAACC-1_Br8667_Post_IF,2,2,1,2,0,7
GTACTGAGGTCGTAAC-1_Br8667_Post_IF,3,0,0,0,0,3
AAAGACCCAAGTCGCG-1_Br8667_Post_IF,0,3,1,0,0,4
CGTCAGTGCGCACAAG-1_Br8667_Post_IF,4,0,0,0,0,4
TGTATCCTTATTCCAT-1_Br8667_Post_IF,4,0,4,0,0,8
ATTCTCGTCTCTTTAG-1_Br8667_Post_IF,4,1,1,0,0,6
AAAGTCACTGATGTAA-1_Br8667_Post_IF,2,3,0,1,0,6
TGTCTACAGTTTCTGT-1_Br8667_Post_IF,2,2,4,0,0,8
TTAACGTCGCAAGACC-1_Br8667_Post_IF,2,1,1,0,0,4
CTATGTCTATTGAAAC-1_Br8667_Post_IF,3,1,3,0,0,7
TCGGGTGAAACTGCTA-1_Br8667_Post_IF,3,0,0,1,0,4
TGTCCCGACATAGCAC-1_Br8667_Post_IF,1,1,1,0,0,3
ACAGCATAGAGCCAGT-1_Br8667_Post_IF,3,0,2,0,0,5
ATATTCCCACAGGTCA-1_Br8667_Post_IF,2,2,1,0,0,5
TTGGATCGACTTCTGG-1_Br8667_Post_IF,6,2,0,0,0,8
CACCATCGGAGGAGAC-1_Br8667_Post_IF,0,1,0,0,0,1
TCGTTCGTTATTATGT-1_Br8667_Post_IF,2,2,1,0,0,5
CTTAACTTCGAAGTAC-1_Br8667_Post_IF,3,0,1,0,0,4
GCACAAGTGTCGGAAG-1_Br8667_Post_IF,2,0,0,0,0,2
TACCAGCTAGGTTTAA-1_Br8667_Post_IF,1,0,3,0,0,4
ACGTACAGATTTCTCT-1_Br8667_Post_IF,2,3,1,0,0,6
AATTTGGTTCCAAAGA-1_Br8667_Post_IF,3,0,1,0,0,4
GTAAGGATTTGTCGGA-1_Br8667_Post_IF,2,2,1,0,0,5
CATCATCTACCCGGAC-1_Br8667_Post_IF,2,2,0,0,0,4
ACGATGGATCCGATGC-1_Br8667_Post_IF,4,1,4,0,0,9
CACTCAGCTCTTGAGG-1_Br8667_Post_IF,4,2,0,0,0,6
TAGATCCGAAGTCGCA-1_Br8667_Post_IF,1,2,0,0,0,3
TGAAACTTATGCAAGC-1_Br8667_Post_IF,0,0,1,0,0,1
GCGATTCTGGAAGCAG-1_Br8667_Post_IF,3,1,1,0,0,5
CAAACTATTGAGCTTC-1_Br8667_Post_IF,2,1,1,1,0,5
TAGAATTAAGGGCAAC-1_Br8667_Post_IF,3,0,0,0,1,4
CGAAACATAGATGGCA-1_Br8667_Post_IF,8,1,1,1,0,11
GATGGTGCCCTAGGCA-1_Br8667_Post_IF,4,1,2,4,0,11
CCCGCAGGGCCCAAAG-1_Br8667_Post_IF,2,0,0,0,0,2
ACAGCGCACCCGCAGC-1_Br8667_Post_IF,5,1,0,0,0,6
GGTAAATGTGCGTTAC-1_Br8667_Post_IF,0,3,2,1,0,6
GTCCTTCTAGTGGGTT-1_Br8667_Post_IF,1,1,2,0,0,4
GGAAGCTCGCTTACAG-1_Br8667_Post_IF,4,3,2,1,0,10
CACCGATACACCGAGC-1_Br8667_Post_IF,2,2,0,0,0,4
CAGCCGGGCCCTCTAT-1_Br8667_Post_IF,4,0,1,0,0,5
CGGAGCTTATAACACC-1_Br8667_Post_IF,0,1,0,1,0,2
ATTACAACTACCGGCC-1_Br8667_Post_IF,2,0,0,0,0,2
TCCTCTGGCCCATTAG-1_Br8667_Post_IF,1,3,3,1,0,8
CGGCACCGTTAGCGCC-1_Br8667_Post_IF,3,2,1,0,0,6
TCGGTCCCTGACTCCA-1_Br8667_Post_IF,1,3,2,0,0,6
TGGTTGGAGGATCCTG-1_Br8667_Post_IF,1,0,3,0,0,4
CTGCGGTAGTCACGTG-1_Br8667_Post_IF,2,1,2,0,0,5
GTGCCTCAGTGTACGG-1_Br8667_Post_IF,3,3,2,0,0,8
ATCGTTCACTTTCGCC-1_Br8667_Post_IF,2,1,1,1,0,5
ACTTACCGGGCGCGCA-1_Br8667_Post_IF,3,3,6,0,0,12
CTAGACTGCATTTCGT-1_Br8667_Post_IF,2,3,0,0,0,5
TTGCCGGTGATCCCTC-1_Br8667_Post_IF,1,0,1,0,0,2
CTGTCACGCCAGGCGC-1_Br8667_Post_IF,0,0,0,2,0,2
CGGTATAGGTATTAGC-1_Br8667_Post_IF,1,0,1,0,0,2
CCAACGCTTGCCAGGG-1_Br8667_Post_IF,1,3,1,0,0,5
CGTTGAGTAATTGCGT-1_Br8667_Post_IF,1,2,1,0,0,4
TGTATTTACCTAATGC-1_Br8667_Post_IF,0,2,1,0,0,3
TAAATGCCGTCTCATG-1_Br8667_Post_IF,2,2,2,0,0,6
CGGTTTATGAAGGAAC-1_Br8667_Post_IF,1,0,0,0,0,1
GCAAGATGTGTTCGCG-1_Br8667_Post_IF,0,0,0,0,0,0
AAAGGTAAGCTGTACC-1_Br8667_Post_IF,3,2,0,0,0,5
GTACGTCACGTATTAA-1_Br8667_Post_IF,1,4,1,0,0,6
AGTACCTTCGAGTGCT-1_Br8667_Post_IF,2,0,1,0,0,3
ATTGTGACTTCGCTGC-1_Br8667_Post_IF,5,4,2,0,0,11
TGTATCAGACTGAAGC-1_Br8667_Post_IF,2,2,1,0,0,5
GAGACCCTGCAACGCC-1_Br8667_Post_IF,0,2,0,0,0,2
TGGGTGGGATGTCATT-1_Br8667_Post_IF,1,3,2,0,0,6
GGCTAATGATTGAAAT-1_Br8667_Post_IF,3,2,1,0,0,6
ATAACGTTACCTCCAC-1_Br8667_Post_IF,2,3,2,0,0,7
TGCGAGATGGCGGCCA-1_Br8667_Post_IF,1,1,0,0,0,2
CACACTTGTATTGCGA-1_Br8667_Post_IF,2,4,2,0,0,8
GCTGGTGACTCGTAGT-1_Br8667_Post_IF,1,3,1,0,0,5
CGACACCGCTTAAGGA-1_Br8667_Post_IF,2,0,0,0,0,2
GTAACAACTGACCTTG-1_Br8667_Post_IF,5,0,2,0,0,7
CAACTGAGGGTATGAC-1_Br8667_Post_IF,2,1,2,0,0,5
CTAATTATGAAGCGTA-1_Br8667_Post_IF,1,1,1,0,0,3
CCGATCTTAAGAGGCT-1_Br8667_Post_IF,1,0,0,0,0,1
CGACTCGGTACACGGT-1_Br8667_Post_IF,2,3,0,0,0,5
TGCTGCGTCAGAGTTA-1_Br8667_Post_IF,1,1,0,0,0,2
AGAGTTGCAGGCCTCC-1_Br8667_Post_IF,0,0,2,0,0,2
ACTGGCGAACCTGCGT-1_Br8667_Post_IF,2,1,1,0,0,4
ACTAAGGACGCACACC-1_Br8667_Post_IF,0,0,1,0,0,1
CGTCCAGATGGCTCCA-1_Br8667_Post_IF,1,0,2,0,0,3
ACTATCGCCGGCTAAA-1_Br8667_Post_IF,1,0,1,0,0,2
GATAGCGTACCACGCG-1_Br8667_Post_IF,2,1,2,0,0,5
AGGACTTATAGGAGAA-1_Br8667_Post_IF,2,1,1,0,0,4
TAGTCGGGATTCTTCG-1_Br8667_Post_IF,0,1,0,0,0,1
ACCATTAAGGGTGTCA-1_Br8667_Post_IF,3,0,1,0,0,4
TTAATGTGTTTGCAGG-1_Br8667_Post_IF,2,1,0,0,0,3
TCCGCAGCCACCTAGC-1_Br8667_Post_IF,4,0,1,1,0,6
GAGGAGATCCTCATGC-1_Br8667_Post_IF,1,1,0,0,0,2
GGTCCTTCATACGACT-1_Br8667_Post_IF,1,1,0,0,0,2
CCCTGTTGGCAAAGAC-1_Br8667_Post_IF,1,2,1,0,0,4
GTGCCTAGCTATGCTT-1_Br8667_Post_IF,0,1,1,0,0,2
GTCATCTCCTACAGCT-1_Br8667_Post_IF,2,1,0,0,0,3
GCGAGAAACGGGAGTT-1_Br8667_Post_IF,1,1,1,0,0,3
CGTCGCGGCGGGATTT-1_Br8667_Post_IF,2,1,1,0,0,4
CATTGTGTGCTAGATC-1_Br8667_Post_IF,1,1,0,0,0,2
CGCGGCAGTATTACGG-1_Br8667_Post_IF,1,3,1,0,0,5
GAAATGGGATGTAAAC-1_Br8667_Post_IF,4,0,0,0,0,4
CATTCCCTAAGTACAA-1_Br8667_Post_IF,1,3,0,0,0,4
AGTTCTGCGTTGTATC-1_Br8667_Post_IF,1,2,3,0,0,6
ACCCTATAGGACTGAG-1_Br8667_Post_IF,1,1,0,0,0,2
TTAGATAGGTCGATAC-1_Br8667_Post_IF,1,1,0,0,0,2
ATTGATAGCAACGAGA-1_Br8667_Post_IF,0,0,0,0,0,0
TCTCGGCTCCAGGACT-1_Br8667_Post_IF,3,2,2,0,0,7
CTTGAGGTTATCCCGA-1_Br8667_Post_IF,0,1,0,0,0,1
AAGAAGGATCAGTTAG-1_Br8667_Post_IF,2,0,1,0,0,3
GTACGACGGCGCTGCG-1_Br8667_Post_IF,1,2,0,0,0,3
CTTATGTTGACTACCA-1_Br8667_Post_IF,3,0,0,0,0,3
CGGCACTCAAGAAAGT-1_Br8667_Post_IF,2,1,0,0,0,3
GTCAAAGTTTACATAG-1_Br8667_Post_IF,0,1,0,0,0,1
CTCCTAAGTTATGTCT-1_Br8667_Post_IF,2,0,0,0,0,2
ACTGTGCTAGTAGATC-1_Br8667_Post_IF,2,0,0,0,0,2
GTTTGGCCGCTCAGCG-1_Br8667_Post_IF,2,2,1,0,0,5
TTATCCAATCGAACTC-1_Br8667_Post_IF,0,0,2,0,0,2
CCGTACCCAAGCGCCA-1_Br8667_Post_IF,1,1,2,0,0,4
CATACAAAGCCGAACC-1_Br8667_Post_IF,1,1,0,0,0,2
GGTCGGTAATTAGACA-1_Br8667_Post_IF,5,0,0,0,0,5
AGCGGGAAGGGTCCAT-1_Br8667_Post_IF,0,0,1,1,0,2
GCCCACCAAGGCTGTC-1_Br8667_Post_IF,3,1,0,0,0,4
GTAGACGTCGTTACAT-1_Br8667_Post_IF,4,2,4,0,0,10
GAGCATCATCCCTGGG-1_Br8667_Post_IF,0,1,0,0,0,1
AGGTAACCTCCTATTC-1_Br8667_Post_IF,3,0,1,0,0,4
GGTTTGAGTGCTGGAA-1_Br8667_Post_IF,1,2,1,0,0,4
GCACTAGTCGCGCTAT-1_Br8667_Post_IF,1,2,2,0,0,5
GGTAACTATGTATCTG-1_Br8667_Post_IF,3,1,1,0,0,5
GCGGTCCCTAGACGCA-1_Br8667_Post_IF,2,2,2,0,0,6
CGAGCGTTGATCAGCC-1_Br8667_Post_IF,2,0,0,1,0,3
AATCCAAGGGCCTGAG-1_Br8667_Post_IF,4,0,0,0,0,4
CCGTGCCCATGACGGC-1_Br8667_Post_IF,5,2,0,0,0,7
GAAATTCACATCGCTG-1_Br8667_Post_IF,0,2,0,0,0,2
CTCTGCGAAGCAAGCA-1_Br8667_Post_IF,6,0,2,0,0,8
AGTAGGTAACATACAT-1_Br8667_Post_IF,2,1,2,0,0,5
ATTGGGAATATCTTGG-1_Br8667_Post_IF,2,3,0,0,0,5
TAGAGCTACGAAGAAC-1_Br8667_Post_IF,1,1,0,0,0,2
TGCGGCATAGTTCAAC-1_Br8667_Post_IF,2,1,0,0,0,3
CCGCCGGTCAACACAC-1_Br8667_Post_IF,4,1,1,0,0,6
TCGTATAGTGCAATTA-1_Br8667_Post_IF,5,1,2,0,0,8
TAGTTTATTCTTGCTT-1_Br8667_Post_IF,2,0,0,0,0,2
GATATCTCATGCAATA-1_Br8667_Post_IF,0,0,1,0,0,1
CGTTTAAGCGGAGCAC-1_Br8667_Post_IF,2,0,0,0,0,2
CATGCTGGCTCCAATT-1_Br8667_Post_IF,0,1,2,0,0,3
GAAACAGCCATGCAGT-1_Br8667_Post_IF,2,0,2,0,0,4
AGTTTCGCAGGTCGGA-1_Br8667_Post_IF,1,2,1,0,0,4
CTCATGGCTCACAATC-1_Br8667_Post_IF,3,1,2,0,0,6
AACCGTTGTGTTTGCT-1_Br8667_Post_IF,0,0,0,0,0,0
ACCCTTCATCTGCGAA-1_Br8667_Post_IF,2,3,1,0,0,6
TGCGGTGAAATTTCAT-1_Br8667_Post_IF,3,0,1,0,0,4
CAAATTGTCAGCAAGC-1_Br8667_Post_IF,1,0,2,0,0,3
GAGGTACATCCATCTT-1_Br8667_Post_IF,2,1,0,0,0,3
AAATGGCATGTCTTGT-1_Br8667_Post_IF,4,0,1,0,0,5
TCATCCCAGAGGGTGG-1_Br8667_Post_IF,3,0,0,0,0,3
CGTAGCGAATTGTCAG-1_Br8667_Post_IF,4,2,0,0,0,6
CCTAGTTAGTCGCATG-1_Br8667_Post_IF,6,1,2,0,0,9
GAAACTCTAATGAAGG-1_Br8667_Post_IF,5,0,1,0,0,6
TTGTATCACACAGAAT-1_Br8667_Post_IF,3,0,0,0,0,3
TTCAAGCCGAGCTGAG-1_Br8667_Post_IF,3,1,0,0,0,4
AGGTACGATATTGCCA-1_Br8667_Post_IF,1,1,2,0,0,4
TTAAGCCGACAACTTC-1_Br8667_Post_IF,4,0,1,0,0,5
GTCTTAGTACAGCCGG-1_Br8667_Post_IF,6,0,0,0,0,6
TGGGTAAGGTTCCCGC-1_Br8667_Post_IF,2,2,1,0,0,5
CTACGCCATTTCCGAT-1_Br8667_Post_IF,1,1,1,0,0,3
GACCGTCAGGTCGTGA-1_Br8667_Post_IF,0,3,1,1,0,5
TAGTTAAGATAGGATA-1_Br8667_Post_IF,0,2,2,1,0,5
GAATATTCGGAGTCCC-1_Br8667_Post_IF,3,0,1,0,0,4
CAAACTACGATAGAGA-1_Br8667_Post_IF,3,2,1,0,0,6
CAGGAAGACTTTATAT-1_Br8667_Post_IF,0,2,0,0,0,2
TTCGTAATCCCAGCGG-1_Br8667_Post_IF,4,2,0,0,0,6
GTGAGGAGCGGTTGAG-1_Br8667_Post_IF,1,2,1,0,0,4
CAATCCCTATACCAGC-1_Br8667_Post_IF,1,0,0,0,0,1
AGGGAAACGAGGTACT-1_Br8667_Post_IF,4,0,0,0,0,4
TCCTGCCAACTGGAGA-1_Br8667_Post_IF,2,2,1,0,0,5
AATTTGGGACATAGTA-1_Br8667_Post_IF,1,2,1,0,0,4
AACTCCTAATCCCATG-1_Br8667_Post_IF,2,1,3,1,0,7
GCTCATTACTGCATGT-1_Br8667_Post_IF,2,1,1,0,0,4
TCTCGAACGAGGTCAC-1_Br8667_Post_IF,4,1,1,0,0,6
TCACTACGACCAATGC-1_Br8667_Post_IF,1,0,1,1,0,3
GTGATGCACAACATCT-1_Br8667_Post_IF,2,0,0,0,0,2
CCGACGTAAACACAAC-1_Br8667_Post_IF,1,0,1,0,0,2
TGGGATGCACTCATTC-1_Br8667_Post_IF,1,1,0,0,0,2
TTCCATCATGCGGTGA-1_Br8667_Post_IF,2,0,2,0,0,4
TGCACAGTGAAGTTAT-1_Br8667_Post_IF,1,0,2,0,0,3
CTATTGTGTTTGGTCA-1_Br8667_Post_IF,2,0,0,0,0,2
TGCGAGCCCTTCCGCG-1_Br8667_Post_IF,2,0,0,0,0,2
TTGAAAGGTGTAAAGG-1_Br8667_Post_IF,3,0,0,0,0,3
GGTGCAGAGCCTATCG-1_Br8667_Post_IF,6,0,0,0,0,6
ACTATATGCTGTGTTC-1_Br8667_Post_IF,1,0,1,0,0,2
TCCTGGCGCTGCCTGG-1_Br8667_Post_IF,0,1,1,0,0,2
GAGCCGAGCGTTTATT-1_Br8667_Post_IF,0,1,4,0,0,5
AGAATGCGGGTTCGGA-1_Br8667_Post_IF,1,1,1,0,0,3
ATGCGACAATTGGTCC-1_Br8667_Post_IF,3,1,0,0,0,4
TTCCGGCTCGACTTCT-1_Br8667_Post_IF,1,3,0,1,0,5
TGATTATGGCACGCAG-1_Br8667_Post_IF,0,0,1,0,0,1
GGTTTGACAAGAAGCT-1_Br8667_Post_IF,1,0,2,0,0,3
GCAGCTATGGACAGGT-1_Br8667_Post_IF,0,0,0,0,0,0
CACCATGATCGCAAAG-1_Br8667_Post_IF,1,0,0,0,0,1
GTCGGAAGGATACCAG-1_Br8667_Post_IF,3,2,4,1,0,10
GGCCCAGTTATCAGCA-1_Br8667_Post_IF,1,0,0,0,0,1
GGGCCTATTTAAGTAT-1_Br8667_Post_IF,2,0,1,0,0,3
GTTGTTACATTGCGCT-1_Br8667_Post_IF,7,0,1,0,0,8
CAACTCCGTAACTTGC-1_Br8667_Post_IF,2,2,1,0,0,5
GATCTTTGCTCAAAGA-1_Br8667_Post_IF,1,0,2,0,0,3
TCGCTTAATTACGAAG-1_Br8667_Post_IF,0,0,0,0,0,0
CGATCATTAGAGGCAC-1_Br8667_Post_IF,2,4,0,1,0,7
TGTTCTCTACTCCCTA-1_Br8667_Post_IF,3,1,1,0,0,5
GCTTAGGGAAGCGGTA-1_Br8667_Post_IF,3,0,0,0,0,3
CAGGTTTAGTACTACA-1_Br8667_Post_IF,2,2,1,0,0,5
AAGCGGAGTGCGCGCA-1_Br8667_Post_IF,3,0,2,0,0,5
TCAGATGGAGACGTAG-1_Br8667_Post_IF,3,1,0,0,0,4
TCGCACTAACGTTTGT-1_Br8667_Post_IF,3,0,0,0,0,3
CACGTCGGGTTCTAGA-1_Br8667_Post_IF,0,2,1,0,0,3
GGAGTACACATGAGCT-1_Br8667_Post_IF,2,1,0,0,0,3
GTGTGTCGACGTCGCT-1_Br8667_Post_IF,0,0,0,0,0,0
GAAGCTCTTTGCTTAG-1_Br8667_Post_IF,3,2,0,0,0,5
ACACCGAGCGCTCTTT-1_Br8667_Post_IF,1,1,1,0,0,3
CGTAATAATTACGAGT-1_Br8667_Post_IF,3,0,0,0,0,3
CATCAACACCTACTAA-1_Br8667_Post_IF,5,0,0,0,0,5
CCAAGTTTCTACAGAT-1_Br8667_Post_IF,4,0,1,0,0,5
ACGGGTCATGTGACTT-1_Br8667_Post_IF,2,0,1,0,0,3
AGTGTGCTAAGATCGC-1_Br8667_Post_IF,3,1,3,0,0,7
GGCGGTTTGCCGGTGC-1_Br8667_Post_IF,5,0,0,0,0,5
GTATAATCTCCCGGAT-1_Br8667_Post_IF,1,1,0,0,0,2
TAGTCCGTATGCATAA-1_Br8667_Post_IF,2,2,0,0,0,4
CACTTCGTCTTATCTC-1_Br8667_Post_IF,3,0,0,0,0,3
CATCCGCAGGCCCGAA-1_Br8667_Post_IF,2,0,1,0,0,3
CCCTGATGTAACTCGT-1_Br8667_Post_IF,0,0,4,0,0,4
CCATAGTCAGTAACCC-1_Br8667_Post_IF,3,0,0,0,0,3
CGGGCCATAGCCGCAC-1_Br8667_Post_IF,1,3,0,0,0,4
CTCCGGCTTGTAGACA-1_Br8667_Post_IF,2,1,0,0,0,3
AACTTGCGTTCTCGCG-1_Br8667_Post_IF,2,0,1,0,0,3
AATGAGTTCGCATATG-1_Br8667_Post_IF,4,1,0,0,0,5
CGAGGCCAGGCATTGG-1_Br8667_Post_IF,2,0,1,0,0,3
TCTGCGTCCGGTTTCT-1_Br8667_Post_IF,3,0,0,0,0,3
CAATCCTGCCGTGGAG-1_Br8667_Post_IF,1,0,1,0,0,2
CTGAGCAAGTAACAAG-1_Br8667_Post_IF,4,2,0,0,0,6
GGGTACCCACGGTCCT-1_Br8667_Post_IF,4,0,2,0,0,6
ACGGAATTTAGCAAAT-1_Br8667_Post_IF,1,0,1,0,0,2
GGGCGGTCCTATTGTC-1_Br8667_Post_IF,2,1,0,0,0,3
ATGTTACGAGCAATAC-1_Br8667_Post_IF,3,0,1,0,0,4
AACCATGGGATCGCTA-1_Br8667_Post_IF,2,1,0,0,0,3
TCGCATCCCTAAGTGT-1_Br8667_Post_IF,4,0,1,1,0,6
ACTTAGTACGACAAGA-1_Br8667_Post_IF,0,1,1,0,0,2
GAGCTCTCGGACCTAA-1_Br8667_Post_IF,2,2,1,0,0,5
TCTATTACGCTGGCGA-1_Br8667_Post_IF,2,0,2,0,0,4
AGATACGACTTCATAT-1_Br8667_Post_IF,0,0,0,0,0,0
CGCTATACCGCCCACT-1_Br8667_Post_IF,0,0,0,0,0,0
CAGTGTCCGCAGAATG-1_Br8667_Post_IF,2,1,0,0,0,3
CCATCCATACCAAGTC-1_Br8667_Post_IF,2,3,1,0,0,6
AACCCAGAGACGGAGA-1_Br8667_Post_IF,2,0,0,0,0,2
GAAGAACGGTGCAGGT-1_Br8667_Post_IF,0,0,1,0,0,1
GATAAATCGGTGGATG-1_Br8667_Post_IF,5,0,1,0,0,6
CAGCTCGTGCTTGTGT-1_Br8667_Post_IF,2,0,1,0,0,3
GAGTACGGGTATACAA-1_Br8667_Post_IF,3,1,1,0,0,5
CATCGCCCGCGGCCAA-1_Br8667_Post_IF,2,1,0,0,0,3
TCTTACAGAGGTACCG-1_Br8667_Post_IF,3,1,1,0,0,5
TGGAAGACGAACACCA-1_Br8667_Post_IF,2,1,0,0,0,3
GTTGTCGTGTTAGTTG-1_Br8667_Post_IF,2,1,2,0,0,5
CCAAGGAACAGAGAGG-1_Br8667_Post_IF,2,2,0,0,0,4
CTGCACCTGGAACCGC-1_Br8667_Post_IF,0,0,1,0,0,1
CGCTTTCATACCGGTG-1_Br8667_Post_IF,1,2,5,0,0,8
GTTCTTCCCTCGATGT-1_Br8667_Post_IF,1,0,3,0,0,4
ATTTAACTCGTATTAC-1_Br8667_Post_IF,1,1,1,0,0,3
AACGATAGAAGGGCCG-1_Br8667_Post_IF,1,0,1,1,0,3
TATCCTGCATGGGAAT-1_Br8667_Post_IF,0,0,0,0,0,0
AGGCCCATTGTACAGG-1_Br8667_Post_IF,3,2,0,0,0,5
CCGGCGCATATTGGAT-1_Br8667_Post_IF,2,2,1,0,0,5
ATCTGTAATTGTACCC-1_Br8667_Post_IF,4,1,3,0,0,8
GAGCGAGGGAGTACCG-1_Br8667_Post_IF,1,0,0,0,0,1
TTATTAGGGAAGCATC-1_Br8667_Post_IF,3,1,0,0,0,4
CTTCTTACGTCGTATA-1_Br8667_Post_IF,3,0,0,0,0,3
GAAGTGCTGGATAGCT-1_Br8667_Post_IF,1,2,0,0,0,3
GTGCAACAAATGTGGC-1_Br8667_Post_IF,2,1,0,0,0,3
CATGCGTTAGACAGAA-1_Br8667_Post_IF,0,1,2,0,0,3
ACACACTTTCTACACG-1_Br8667_Post_IF,1,0,0,0,0,1
AGCCCTAAGCGAAGTT-1_Br8667_Post_IF,1,0,0,0,0,1
ATTAATTCGGTCACTC-1_Br8667_Post_IF,5,0,1,0,0,6
AACAGGAAATCGAATA-1_Br8667_Post_IF,0,0,1,1,0,2
ACGTTTAGTTGTGATC-1_Br8667_Post_IF,0,2,1,0,0,3
TCCTTCAGTGGTCGAA-1_Br8667_Post_IF,2,0,0,0,0,2
CGAACGCCCAGTGCCG-1_Br8667_Post_IF,2,1,1,0,0,4
CCTCGAAGTGGACGGG-1_Br8667_Post_IF,1,1,0,0,0,2
CTCTGTTTGAGGATTC-1_Br8667_Post_IF,3,1,0,0,0,4
TGGGCACGTTCTATGG-1_Br8667_Post_IF,3,0,1,0,0,4
ACTATTCGTCCGTGGT-1_Br8667_Post_IF,2,0,1,0,0,3
CCTCTGGCCTAGACGG-1_Br8667_Post_IF,5,0,1,0,0,6
CCATAAACAACCCGAC-1_Br8667_Post_IF,0,1,0,0,0,1
CATAGTACATTGAGAG-1_Br8667_Post_IF,0,0,1,0,0,1
ATTTCATTATTTCGCG-1_Br8667_Post_IF,3,0,1,0,0,4
CAACTATATCGAATGC-1_Br8667_Post_IF,0,0,0,0,0,0
CTAGTATTCGGAATTA-1_Br8667_Post_IF,0,1,2,0,0,3
GTGGAACCTACATGCG-1_Br8667_Post_IF,2,3,2,0,0,7
CCTAAAGGCTGACGCT-1_Br8667_Post_IF,0,1,1,1,0,3
CGTGACATTGGGTCGT-1_Br8667_Post_IF,1,0,0,0,0,1
CCAATCGGTAGATCGA-1_Br8667_Post_IF,1,1,0,1,0,3
ATTGTCGCAATACCTT-1_Br8667_Post_IF,5,0,2,0,0,7
AAATTACACGACTCTG-1_Br8667_Post_IF,2,0,0,0,0,2
CACTCCTCTCGGTCGG-1_Br8667_Post_IF,1,0,1,0,0,2
AAATAACCATACGGGA-1_Br8667_Post_IF,2,1,2,0,0,5
AGTTACTCTATCGTGG-1_Br8667_Post_IF,2,0,2,0,0,4
CGTTAGCTCACAACTG-1_Br8667_Post_IF,3,0,2,0,0,5
GAATGTATGGCAGGTC-1_Br8667_Post_IF,6,1,2,0,0,9
GCAACCACCAGACCGG-1_Br8667_Post_IF,2,0,2,0,0,4
TCACTCGTGCAACGGC-1_Br8667_Post_IF,4,1,1,0,0,6
AAACAGAGCGACTCCT-1_Br8667_Post_IF,1,0,0,0,0,1
CAGCCTCTCCTCAAGA-1_Br8667_Post_IF,1,0,0,0,0,1
TTGCGTGAACGCTTAG-1_Br8667_Post_IF,4,2,0,0,0,6
CCGCCTGCGAATTGGT-1_Br8667_Post_IF,0,2,5,0,0,7
AGATGAGGGTTGCGAT-1_Br8667_Post_IF,1,0,0,0,0,1
CGGTGGGCTCCAGCCT-1_Br8667_Post_IF,3,1,2,0,0,6
GGCAGCGGTAATCCTA-1_Br8667_Post_IF,5,0,3,0,0,8
GCTAGCAGGGAGTGGG-1_Br8667_Post_IF,3,1,1,0,0,5
CTCAAGACATTAGCGC-1_Br8667_Post_IF,1,2,1,0,0,4
CACGGCGCGCCAAAGG-1_Br8667_Post_IF,0,0,0,0,0,0
TGCAATTTGGGCACGG-1_Br8667_Post_IF,3,0,0,0,0,3
ATGCCAATCGCTCTGC-1_Br8667_Post_IF,1,1,0,0,0,2
GCTGGACCCAAAGTGG-1_Br8667_Post_IF,1,0,0,0,0,1
ATTCCTAAGACGTGGA-1_Br8667_Post_IF,2,1,1,0,0,4
TCCGGAGGAAGGGCTG-1_Br8667_Post_IF,2,0,0,0,0,2
TCGGTGACCGCTCCGG-1_Br8667_Post_IF,0,2,1,0,0,3
TCCGAAGTAGTCACCA-1_Br8667_Post_IF,5,0,0,0,0,5
CATGTAGGAGCGCCAA-1_Br8667_Post_IF,2,1,1,0,0,4
CACAAGAAAGATATTA-1_Br8667_Post_IF,2,2,0,1,0,5
AGGGTCAGTAACCCTA-1_Br8667_Post_IF,1,0,1,0,0,2
TAAGCCCTTACGACCA-1_Br8667_Post_IF,3,1,1,0,0,5
ATACCGTCATCCATAA-1_Br8667_Post_IF,2,0,0,0,0,2
GGACGTCCATAGTTGG-1_Br8667_Post_IF,2,1,0,0,0,3
CATCAAACTGGCGCCC-1_Br8667_Post_IF,1,0,0,0,0,1
AAACGTGTTCGCCCTA-1_Br8667_Post_IF,2,1,0,0,0,3
AAATTGGTGAGAAGCA-1_Br8667_Post_IF,1,3,0,0,0,4
GGTCATTGTAGTCATA-1_Br8667_Post_IF,5,1,1,0,0,7
TGCAGTGAGGCTCGGG-1_Br8667_Post_IF,1,0,1,0,0,2
GAACATTAGTATGTTA-1_Br8667_Post_IF,3,0,0,0,0,3
GGTTTGCGAACACGTA-1_Br8667_Post_IF,1,2,2,0,0,5
ACACAAATATTCCTAG-1_Br8667_Post_IF,3,0,0,0,0,3
TTGGGTTTATTCAGCG-1_Br8667_Post_IF,3,2,0,1,0,6
ATTCGCAGAGGACACT-1_Br8667_Post_IF,1,0,0,0,0,1
GATTTAGTGCGTACTG-1_Br8667_Post_IF,2,0,1,0,0,3
TAGAAACACAATAGTG-1_Br8667_Post_IF,1,1,1,0,0,3
CAGTAGATGATGTCCG-1_Br8667_Post_IF,3,0,1,0,0,4
TCTTAACTCGGATGTA-1_Br8667_Post_IF,1,0,0,0,0,1
TACATCTTGTTTCTTG-1_Br8667_Post_IF,3,1,1,1,0,6
TTCATAGGGTGTCCAT-1_Br8667_Post_IF,1,1,0,0,0,2
TGAAGTAGCTTACGGA-1_Br8667_Post_IF,3,1,0,0,0,4
GCACAAGTGGATCATA-1_Br8667_Post_IF,0,0,1,0,0,1
GGGCGAATTTCTCCAC-1_Br8667_Post_IF,1,0,0,0,0,1
ATGTTCCTGCCCACCT-1_Br8667_Post_IF,1,1,1,1,0,4
GCTCAACCTCTTAGAG-1_Br8667_Post_IF,2,1,1,0,0,4
ATAGCTGCTCTTGTTA-1_Br8667_Post_IF,0,1,4,0,0,5
CGTCAGCTATTTACTC-1_Br8667_Post_IF,0,2,0,0,0,2
ATCTGATAGTGTCTTA-1_Br8667_Post_IF,1,0,0,0,0,1
TGCACTATGTGAGTGC-1_Br8667_Post_IF,1,0,0,0,0,1
CCGACAAACACATGAG-1_Br8667_Post_IF,3,0,1,0,0,4
GCCTTGTATATGCAGT-1_Br8667_Post_IF,3,0,0,0,0,3
ATAATACCGTTAGCCG-1_Br8667_Post_IF,0,0,0,0,0,0
ACACTCCAATGTCACT-1_Br8667_Post_IF,1,0,0,0,0,1
AGTTGCTGACTGATAT-1_Br8667_Post_IF,2,2,3,0,0,7
GGCGCTCCTCATCAAT-1_Br8667_Post_IF,3,2,1,0,0,6
TGCCTGACATCGGTCA-1_Br8667_Post_IF,1,0,0,0,0,1
TTGGCCATCTTGCGCT-1_Br8667_Post_IF,4,0,0,0,0,4
CAGTGGTTGCACATGA-1_Br8667_Post_IF,1,1,0,0,0,2
AGAATTGTTTGACATA-1_Br8667_Post_IF,2,1,0,0,0,3
AAATGCTCGTTACGTT-1_Br8667_Post_IF,3,1,1,0,0,5
CACCTAATAGAGTCGT-1_Br8667_Post_IF,1,0,0,0,0,1
CATTTCTAGCAGACTA-1_Br8667_Post_IF,3,1,2,0,0,6
CCGAAAGTGGTGAGCA-1_Br8667_Post_IF,4,1,1,0,0,6
AGTCAGCCACCGCCTG-1_Br8667_Post_IF,3,0,0,0,0,3
TCATCACTCGAGCTCG-1_Br8667_Post_IF,1,1,1,0,0,3
CTCAGGACTCACCTGT-1_Br8667_Post_IF,2,2,0,1,0,5
CGGTGTACTTGATCCC-1_Br8667_Post_IF,0,3,0,0,0,3
CCTACGGCTCAGTCGA-1_Br8667_Post_IF,9,1,0,0,2,12
GTACTTGGGCACTTCT-1_Br8667_Post_IF,1,2,0,1,0,4
TGATTTCCTCCTGACG-1_Br8667_Post_IF,1,2,1,0,0,4
CCTCACCAATCTTGAC-1_Br8667_Post_IF,2,1,1,0,0,4
GGTGAGATGCAGATAA-1_Br8667_Post_IF,0,0,0,0,0,0
GCTAGTTTCATTGAGG-1_Br8667_Post_IF,1,0,0,0,0,1
AGGACATCGCACGTCG-1_Br8667_Post_IF,0,1,0,0,0,1
GTGGACGTGCTGAGAC-1_Br8667_Post_IF,3,2,0,1,0,6
TAAGGAACTTGTGGGA-1_Br8667_Post_IF,0,1,1,0,0,2
TCGCTGTGCGTAAATC-1_Br8667_Post_IF,0,0,0,0,0,0
GCATCCCTAACTTTGA-1_Br8667_Post_IF,2,1,0,0,0,3
CACCCACACGTCACCC-1_Br8667_Post_IF,1,2,0,0,0,3
CCCTCATTCTGGAATT-1_Br8667_Post_IF,0,0,0,0,0,0
AGGGCGTGATCGGCTA-1_Br8667_Post_IF,0,1,1,0,0,2
GGTGCGGATAAGTGGC-1_Br8667_Post_IF,1,2,0,0,0,3
TAATATTGAAATTCGC-1_Br8667_Post_IF,1,1,1,0,0,3
CTTACACTGGGAAATA-1_Br8667_Post_IF,3,1,0,0,0,4
ACCAAGAACGCGTGTC-1_Br8667_Post_IF,1,0,1,0,0,2
GCCTTCAGCCCTACCG-1_Br8667_Post_IF,1,1,0,0,0,2
GATGCTACAAGCGCCT-1_Br8667_Post_IF,0,1,2,0,0,3
CCGGGACCCGCAGAGA-1_Br8667_Post_IF,3,1,0,0,0,4
GTTCCAGTCTGACCAT-1_Br8667_Post_IF,2,1,0,0,0,3
ATGATCGGGAATAGAC-1_Br8667_Post_IF,3,0,0,0,0,3
TTGGATTGGGTACCAC-1_Br8667_Post_IF,1,0,0,0,0,1
TACCTCACGCTTGTAC-1_Br8667_Post_IF,1,0,3,0,0,4
CATGGCAGGAAGATCG-1_Br8667_Post_IF,3,0,1,1,0,5
ATGACGCCGGCTCTAA-1_Br8667_Post_IF,0,2,2,0,0,4
AGCGACATCCCATTCA-1_Br8667_Post_IF,2,0,0,0,0,2
AGTAATGTCTTGCCGC-1_Br8667_Post_IF,5,1,0,0,0,6
TTCTTAGTGGCTCAGA-1_Br8667_Post_IF,1,2,1,0,0,4
CGTCTGGAAGGGCCCG-1_Br8667_Post_IF,2,1,4,0,0,7
ACGTGCGCCTCGTGCA-1_Br8667_Post_IF,2,2,1,0,0,5
AGAGCGGGCTAATCAT-1_Br8667_Post_IF,2,0,2,0,0,4
GCGTCGAAATGTCGGT-1_Br8667_Post_IF,1,1,0,0,0,2
AACTGATATTAGGCCT-1_Br8667_Post_IF,1,2,0,0,0,3
CGAGCTGGGCTTTAGG-1_Br8667_Post_IF,0,0,1,0,0,1
GGGTGTTTCAGCTATG-1_Br8667_Post_IF,0,0,0,0,0,0
TTAATTTCAGACGCGG-1_Br8667_Post_IF,3,0,0,0,0,3
ACTGCCGTCGTAACTC-1_Br8667_Post_IF,2,1,2,0,0,5
GTGCACGAAAGTGACT-1_Br8667_Post_IF,0,1,0,1,0,2
ATCTCCCTGCAATCTA-1_Br8667_Post_IF,5,0,0,0,0,5
ACGCCAGATGATTTCT-1_Br8667_Post_IF,4,0,0,0,0,4
AGCTATTTAATCCAAC-1_Br8667_Post_IF,2,0,0,0,0,2
CCACGAGAAGAGAATC-1_Br8667_Post_IF,1,0,0,0,0,1
GATTCCGCGTTTCCGT-1_Br8667_Post_IF,0,0,0,1,0,1
GTCGGATGTAGCGCGC-1_Br8667_Post_IF,1,1,1,0,0,3
TATTTATACCGAGTAG-1_Br8667_Post_IF,0,0,1,0,0,1
GTAGGTGATCCGTGTA-1_Br8667_Post_IF,1,0,1,0,0,2
AGTTAAGCGGTCCCGG-1_Br8667_Post_IF,1,0,0,0,0,1
CTGGCGACATAAGTCC-1_Br8667_Post_IF,3,0,0,0,0,3
TTGGCCTAGAATTTCG-1_Br8667_Post_IF,0,1,0,0,0,1
GGCATATCGGTTCTGC-1_Br8667_Post_IF,3,0,1,0,0,4
GGGCGTCCACTGGCTC-1_Br8667_Post_IF,0,1,1,0,0,2
TTACCCATTGCCGGGT-1_Br8667_Post_IF,2,0,0,0,0,2
TTAGACACGATCGTTG-1_Br8667_Post_IF,2,0,1,0,0,3
GCGCTGATCCAGACTC-1_Br8667_Post_IF,1,0,0,0,0,1
TTCGGCAACCCGCTGA-1_Br8667_Post_IF,3,1,2,0,0,6
GATATTTCCTACATGG-1_Br8667_Post_IF,2,1,2,0,0,5
CTGCGTTACGATATAA-1_Br8667_Post_IF,1,1,0,1,0,3
TAATAAACAAGGAGAT-1_Br8667_Post_IF,0,0,4,0,0,4
AACCTTTACGACGTCT-1_Br8667_Post_IF,0,0,0,0,0,0
AGTCCCGCCTTTAATT-1_Br8667_Post_IF,3,0,0,0,0,3
TGAGATTAGGCCCTAA-1_Br8667_Post_IF,2,1,1,0,0,4
AGTGTATTGCGCATTG-1_Br8667_Post_IF,2,2,1,0,0,5
GTTGGATTCAGTGGCT-1_Br8667_Post_IF,2,2,2,0,0,6
TAAAGCTGCAATAGGG-1_Br8667_Post_IF,1,0,0,0,0,1
AGTAGGAAGGAAGTTG-1_Br8667_Post_IF,1,0,3,0,0,4
TATCACTTCGAGTAAC-1_Br8667_Post_IF,3,0,1,0,0,4
TGATCTACGCTGATCT-1_Br8667_Post_IF,2,0,1,1,0,4
GGATCATCCCGTACGC-1_Br8667_Post_IF,5,0,0,0,0,5
TGACACTTCTCTTTGC-1_Br8667_Post_IF,3,0,2,0,0,5
AGCCCTTCTAATCCGA-1_Br8667_Post_IF,5,0,0,0,0,5
CACCGCGTCCACTCTA-1_Br8667_Post_IF,3,1,0,0,0,4
TAATTGGAATCGGGAA-1_Br8667_Post_IF,3,2,0,0,0,5
TCGTAAGCTCCGAGGA-1_Br8667_Post_IF,1,1,2,0,0,4
TATATTACAAATGTCG-1_Br8667_Post_IF,4,2,1,0,0,7
CGCGAGAGGGACTTGT-1_Br8667_Post_IF,0,1,0,0,0,1
GGACCTACGGTAACGT-1_Br8667_Post_IF,1,2,1,0,0,4
GAAATATGCTTGAATG-1_Br8667_Post_IF,1,1,0,0,0,2
CCGTATTAGCGCAGTT-1_Br8667_Post_IF,3,0,2,0,0,5
AGGCGTCTATGGACGG-1_Br8667_Post_IF,3,0,0,0,0,3
AACATCGATACGTCTA-1_Br8667_Post_IF,0,0,0,0,0,0
TGAATATGCTATAAAC-1_Br8667_Post_IF,5,1,0,0,0,6
ACCAAACACCCAGCGA-1_Br8667_Post_IF,2,0,0,0,0,2
TGGCTTGTACAAGCTT-1_Br8667_Post_IF,5,0,0,1,0,6
GAATGAAGGTCTTCAG-1_Br8667_Post_IF,2,1,0,0,0,3
AGATACCAGCACTTCA-1_Br8667_Post_IF,3,0,1,0,0,4
GCGGTCCCGGTGAAGG-1_Br8667_Post_IF,0,0,0,0,0,0
GAGGCATTTGCAGCAG-1_Br8667_Post_IF,2,0,0,0,0,2
GGCAAGCCAGGGATAG-1_Br8667_Post_IF,0,0,0,0,0,0
TCTACGGGCTCAGTTG-1_Br8667_Post_IF,1,0,0,0,0,1
TCTGCGAATCGTTCGC-1_Br8667_Post_IF,5,0,1,0,0,6
AGCTCGTTGATGGAAA-1_Br8667_Post_IF,1,2,1,0,0,4
TGAATGAGATACAGCA-1_Br8667_Post_IF,1,0,1,1,0,3
ACCCTTGCCTGGGTCG-1_Br8667_Post_IF,2,1,0,0,0,3
GGCGAACCGTTCTGAT-1_Br8667_Post_IF,5,1,0,0,0,6
GCGATGTCTGTGCTTG-1_Br8667_Post_IF,2,0,1,0,0,3
ATTAACACCTGAGATA-1_Br8667_Post_IF,4,0,0,0,0,4
GAAATCTGACCAAGTT-1_Br8667_Post_IF,3,0,3,0,0,6
CCTGACAAACTCGCGC-1_Br8667_Post_IF,4,0,1,0,0,5
ATGTCATTTCCCATTG-1_Br8667_Post_IF,2,2,0,0,0,4
GCGGTGCGGAGCATCG-1_Br8667_Post_IF,3,2,0,0,0,5
CGGAAAGCAAATGTGC-1_Br8667_Post_IF,5,1,0,0,0,6
GCTGAGCAACGGTTCT-1_Br8667_Post_IF,4,0,2,0,0,6
TCACTCTTCGTCTGTC-1_Br8667_Post_IF,1,1,0,0,0,2
GATCTTCATTGTCCTC-1_Br8667_Post_IF,1,2,1,0,0,4
ACTCGATGTATTTCAT-1_Br8667_Post_IF,1,1,0,0,0,2
TGAAGAGCGGTCCTAG-1_Br8667_Post_IF,1,1,0,0,0,2
TAAACGTCGTCAATGA-1_Br8667_Post_IF,1,0,0,0,0,1
ACGTTATTGGTCACTC-1_Br8667_Post_IF,3,2,0,0,0,5
ATAGCCTCAGTACCCA-1_Br8667_Post_IF,3,1,1,0,0,5
CGGGAGTATACCGCCG-1_Br8667_Post_IF,2,2,1,0,0,5
GTCCTACAGGCGGCTC-1_Br8667_Post_IF,1,2,2,0,0,5
CGGATAAGCGGACATG-1_Br8667_Post_IF,8,0,0,0,0,8
AACTTCTGCGTCTATC-1_Br8667_Post_IF,3,0,0,0,0,3
GGGTTCAGACGAACAA-1_Br8667_Post_IF,3,1,3,0,0,7
AGTCTGGACATCCTTG-1_Br8667_Post_IF,1,1,3,0,0,5
TTGAACGAATCCTTTG-1_Br8667_Post_IF,2,0,1,0,0,3
GAAATACTAAACGTTT-1_Br8667_Post_IF,2,1,1,0,0,4
CCCGCGCAATGCACCC-1_Br8667_Post_IF,1,0,0,0,0,1
TTCGGCTAGAGATGGT-1_Br8667_Post_IF,1,1,1,0,0,3
GACACGAGTTAGAGGA-1_Br8667_Post_IF,1,4,1,0,0,6
GAGGTCCCAAAGATCT-1_Br8667_Post_IF,2,1,0,0,0,3
TAACTCCATGGAGGCT-1_Br8667_Post_IF,3,2,1,0,0,6
CTTGTTTATGTAGCCA-1_Br8667_Post_IF,1,1,0,0,0,2
GATGGCGCACACATTA-1_Br8667_Post_IF,0,0,1,1,0,2
ATAATAGTGTAGGGAC-1_Br8667_Post_IF,1,0,1,0,0,2
CGCTATTCAATGTATG-1_Br8667_Post_IF,1,1,0,0,0,2
ATATTGCTGTCAAAGT-1_Br8667_Post_IF,0,0,1,0,0,1
GGATTCAGTACGGTGG-1_Br8667_Post_IF,2,1,0,0,0,3
TTCTTAGTGAACGGTG-1_Br8667_Post_IF,3,0,3,0,0,6
AATGGTTCTCACAAGC-1_Br8667_Post_IF,2,1,1,0,0,4
TATACACGCAAAGTAT-1_Br8667_Post_IF,1,0,0,0,0,1
CTTCATAGCTCAAGAA-1_Br8667_Post_IF,3,1,0,0,0,4
CAACGGTTCTTGATAC-1_Br8667_Post_IF,3,0,3,0,0,6
ACACCCGAGAAATCCG-1_Br8667_Post_IF,0,1,0,0,0,1
TCTATCATGCAGTTAC-1_Br8667_Post_IF,0,2,1,0,0,3
CCCGCCATGCTCCCGT-1_Br8667_Post_IF,1,0,1,0,0,2
CGCTTCCACTGAAATC-1_Br8667_Post_IF,3,0,2,0,0,5
CACTGTCCAAGTGAGA-1_Br8667_Post_IF,3,0,2,0,0,5
ATTACTAGCCTCTTGC-1_Br8667_Post_IF,1,1,0,0,0,2
CATAGTAGCATAGTAG-1_Br8667_Post_IF,2,1,1,0,0,4
CAACTCCTTGATCCCG-1_Br8667_Post_IF,2,0,0,0,0,2
AAGTAGAAGACCGGGT-1_Br8667_Post_IF,2,0,0,0,0,2
GCGGGAACCAGGCCCT-1_Br8667_Post_IF,2,0,2,0,0,4
ATTAGATTGATAGCGG-1_Br8667_Post_IF,2,0,0,0,0,2
CTCGGTCCGTAGCCTG-1_Br8667_Post_IF,0,2,0,0,0,2
TGGCTTTGGGTAGACA-1_Br8667_Post_IF,2,1,2,0,0,5
TATCCATATCATGCGA-1_Br8667_Post_IF,8,0,0,0,1,9
GGAGTGCCGCCCTGGA-1_Br8667_Post_IF,0,1,1,0,0,2
TGAGAATGCTTTACCG-1_Br8667_Post_IF,1,0,0,0,0,1
TTAACCAACCCTCCCT-1_Br8667_Post_IF,1,2,1,0,0,4
TGTTTCGGTACTTCTC-1_Br8667_Post_IF,3,0,0,0,0,3
TTGCTGAAGGAACCAC-1_Br8667_Post_IF,3,1,1,0,0,5
TATTTAGTCTAGATCG-1_Br8667_Post_IF,0,1,1,0,0,2
CTCCGGCCTAATATGC-1_Br8667_Post_IF,2,0,0,0,0,2
TTGTGGCCCTGACAGT-1_Br8667_Post_IF,1,0,1,0,0,2
TCGCCGGTCGATCCGT-1_Br8667_Post_IF,2,0,3,0,0,5
CCATAGGTTGGCGTGG-1_Br8667_Post_IF,2,1,0,0,0,3
GAACGACCGAATGATA-1_Br8667_Post_IF,2,1,1,0,0,4
TCCGATAATTGCCATA-1_Br8667_Post_IF,1,1,0,0,0,2
CATTACGTCGGCCCGT-1_Br8667_Post_IF,2,0,0,0,0,2
CAAGCACCAAATGCCT-1_Br8667_Post_IF,1,1,0,0,0,2
TGCATGGATCGGATCT-1_Br8667_Post_IF,3,0,1,0,0,4
GAAATCGCGCGCAACT-1_Br8667_Post_IF,2,0,0,0,0,2
CTGAAAGAGATCCGAC-1_Br8667_Post_IF,0,0,2,0,0,2
CACCTCGATGGTGGAC-1_Br8667_Post_IF,1,0,0,0,0,1
ATTTGTTCCAGGGCTC-1_Br8667_Post_IF,2,0,3,0,0,5
TGGGCCACAAGAGCGC-1_Br8667_Post_IF,2,0,0,0,0,2
CCTTCTTGATCCAGTG-1_Br8667_Post_IF,5,1,0,0,0,6
CCTCGCCAGCAAATTA-1_Br8667_Post_IF,2,1,2,0,0,5
TTCATGGCGCAACAGG-1_Br8667_Post_IF,3,2,1,0,0,6
TTAATCAGTACGTCAG-1_Br8667_Post_IF,1,1,1,0,0,3
CCTATCTATATCGGAA-1_Br8667_Post_IF,2,0,2,0,0,4
ATTATACTTTGCTCGT-1_Br8667_Post_IF,1,1,0,0,0,2
ATGGATCCGGCGTCCG-1_Br8667_Post_IF,2,1,0,0,0,3
CGCCCGCTTCCGTACA-1_Br8667_Post_IF,0,0,0,0,0,0
GGATTCCGCTATACCC-1_Br8667_Post_IF,0,1,0,0,0,1
CGGTCTATCAACCCGT-1_Br8667_Post_IF,1,0,0,0,0,1
ATGCCGGTTGATGGGA-1_Br8667_Post_IF,6,0,1,0,0,7
TCATGCAGGTTCTCAT-1_Br8667_Post_IF,4,1,2,0,0,7
TGAGCTTTAATGACGC-1_Br8667_Post_IF,3,1,1,0,0,5
TCCCTTAGATTACTCG-1_Br8667_Post_IF,0,2,0,0,0,2
ATATCTCCCTCGTTAA-1_Br8667_Post_IF,0,1,0,0,0,1
AGCTCTTCCCAGTGCA-1_Br8667_Post_IF,1,0,1,0,0,2
TCGCTAAACCGCTATC-1_Br8667_Post_IF,0,2,1,0,0,3
CACATTCTTTCGATGG-1_Br8667_Post_IF,1,0,0,0,0,1
GATATGCGGTAGCCAA-1_Br8667_Post_IF,0,1,0,0,0,1
CGTTTCACTTCGGGCG-1_Br8667_Post_IF,3,1,1,0,0,5
CCAATTACGGGTCGAG-1_Br8667_Post_IF,5,0,0,0,0,5
GCAGGTAGAGTATGGT-1_Br8667_Post_IF,0,0,2,0,0,2
GTCGTATTGGCGTACA-1_Br8667_Post_IF,3,0,0,0,0,3
GAAATTAGCACGGATA-1_Br8667_Post_IF,3,1,1,0,0,5
AATGCACCAAGCAATG-1_Br8667_Post_IF,1,1,0,0,0,2
AGGACGCTCGATGTTG-1_Br8667_Post_IF,3,2,0,0,0,5
GGCTAAAGGGCGGGTC-1_Br8667_Post_IF,5,0,0,0,0,5
CATCTATCCCGTGTCT-1_Br8667_Post_IF,1,1,0,0,0,2
CAGTAACTATTTATTG-1_Br8667_Post_IF,2,1,0,0,0,3
CATATACTACTGATAA-1_Br8667_Post_IF,2,1,1,0,0,4
GCGTTCGGAGACCGGG-1_Br8667_Post_IF,1,1,0,1,0,3
AAGTTCAGTCTGCGTA-1_Br8667_Post_IF,5,0,0,0,0,5
CGAAGCTATAAATTCA-1_Br8667_Post_IF,2,0,0,0,0,2
CGCGGTCACAAACCAA-1_Br8667_Post_IF,4,1,3,0,0,8
GGGAATGAGCCCTCAC-1_Br8667_Post_IF,1,1,2,1,0,5
ACGGAGCGCAAATTAC-1_Br8667_Post_IF,1,0,0,0,0,1
CGTTCTTCGCACACCT-1_Br8667_Post_IF,1,0,0,0,0,1
GAATAGCCCTGCGGTC-1_Br8667_Post_IF,2,0,1,0,0,3
AATAGCTACCGCGTGC-1_Br8667_Post_IF,1,0,1,0,0,2
CCGAGCTGTGCTTGTC-1_Br8667_Post_IF,1,1,2,0,0,4
GATGACGATGATCGCG-1_Br8667_Post_IF,2,0,0,0,0,2
GCCTATGCTGGGCCTT-1_Br8667_Post_IF,0,2,0,0,0,2
TTACTGTCTAGAGCTC-1_Br8667_Post_IF,0,1,2,0,0,3
AGCGGTTGCCGCTCTG-1_Br8667_Post_IF,4,1,0,0,0,5
GCTTGCAGCACAATTG-1_Br8667_Post_IF,2,0,0,0,0,2
CCGGAGGTCTTATGGT-1_Br8667_Post_IF,3,1,0,0,0,4
ACAGTATACCGTGGGA-1_Br8667_Post_IF,3,0,0,0,0,3
GGGATCCCAATACAAA-1_Br8667_Post_IF,4,0,0,0,0,4
ATTACGACTCCACAGT-1_Br8667_Post_IF,3,1,1,0,0,5
CTCACACGCAAGCCTA-1_Br8667_Post_IF,1,2,0,0,0,3
CCAGATGTAAATGGGT-1_Br8667_Post_IF,3,2,1,0,0,6
GAACTTGTGCACGGGA-1_Br8667_Post_IF,2,1,0,0,0,3
AAGCCGCTTTACCTTG-1_Br8667_Post_IF,3,2,0,0,0,5
TCCATTCCCACTAGAG-1_Br8667_Post_IF,2,2,0,0,0,4
AGAGCGCTTGTAACGG-1_Br8667_Post_IF,0,0,2,0,0,2
TGGGTTCCCGGACGGA-1_Br8667_Post_IF,5,0,0,0,0,5
GCTGCGCCTCCCACGT-1_Br8667_Post_IF,1,2,1,0,0,4
CTGTTGGCTCTTCTGA-1_Br8667_Post_IF,3,0,0,0,0,3
TTGTTCTAGATACGCT-1_Br8667_Post_IF,3,0,1,0,0,4
CCCTCAAGCTCTTAGT-1_Br8667_Post_IF,0,1,0,0,0,1
TGGTCTAGCTTACATG-1_Br8667_Post_IF,3,2,0,0,0,5
ATGCACCTTCCTTAAT-1_Br8667_Post_IF,3,0,2,1,0,6
GGGATACGGTAATAAT-1_Br8667_Post_IF,2,0,0,0,0,2
AGTTCACCGGTTGGAC-1_Br8667_Post_IF,4,1,0,0,0,5
GACATACTGTCGCAGA-1_Br8667_Post_IF,3,1,0,1,0,5
TGGACACCGTTGCTTG-1_Br8667_Post_IF,2,0,1,0,0,3
TGCGATGCTAATGGCT-1_Br8667_Post_IF,0,1,0,0,0,1
TTCTGTTTCCTGTCGC-1_Br8667_Post_IF,4,2,0,0,0,6
CGTTGTAAACGTCAGG-1_Br8667_Post_IF,3,0,0,0,0,3
GATCGGCGATAAGTCG-1_Br8667_Post_IF,0,0,0,0,0,0
AGCCTTAAAGCGGAAG-1_Br8667_Post_IF,5,2,1,0,0,8
TCCGTAACCACAATCC-1_Br8667_Post_IF,1,2,0,0,0,3
GAATGCCGAAATGACC-1_Br8667_Post_IF,1,1,0,0,0,2
TATACTCATGCGGCAA-1_Br8667_Post_IF,2,1,1,0,0,4
TAGTGTCAGAAACGGC-1_Br8667_Post_IF,1,1,0,0,0,2
CGTCATACCATATCCA-1_Br8667_Post_IF,1,0,0,0,0,1
TAGTACCTTAGTGGTC-1_Br8667_Post_IF,1,1,1,0,0,3
CTGGCGGGAATAAGTA-1_Br8667_Post_IF,2,1,1,0,0,4
AGTGTGGTCTATTGTG-1_Br8667_Post_IF,2,1,2,0,0,5
GCTATCGCGGCGCAAC-1_Br8667_Post_IF,1,0,0,0,0,1
CAGTAATCCCTCCCAG-1_Br8667_Post_IF,3,1,1,0,0,5
GTATTAAGGCGTCTAA-1_Br8667_Post_IF,0,0,2,0,0,2
CTAATTTCAACAACAC-1_Br8667_Post_IF,3,0,0,0,0,3
TTAGCAACATGGATGT-1_Br8667_Post_IF,2,0,1,0,0,3
ATGCTCAGTGTTGCAT-1_Br8667_Post_IF,1,1,0,0,0,2
GATGTTTGTGCGAGAT-1_Br8667_Post_IF,5,0,1,0,0,6
CACTTCGCCACAGGCT-1_Br8667_Post_IF,3,0,2,0,0,5
CTGTATGGTGTAGAAA-1_Br8667_Post_IF,2,0,2,0,0,4
TACGTGCACTATGCTG-1_Br8667_Post_IF,1,5,0,0,0,6
GTATCAGCTTGGGTTC-1_Br8667_Post_IF,3,0,3,0,0,6
TAACAAAGGGAGAAGC-1_Br8667_Post_IF,2,0,2,0,0,4
TTACATCGTGGCCTGG-1_Br8667_Post_IF,2,1,1,0,0,4
TCTGAACCGGTCGGCT-1_Br8667_Post_IF,0,0,0,0,0,0
GGCTCGTGCCACCAGC-1_Br8667_Post_IF,3,0,1,0,0,4
TATAAGTGAGGATAGC-1_Br8667_Post_IF,2,0,3,0,0,5
GCCCGCGCGTTTGACA-1_Br8667_Post_IF,4,1,1,0,0,6
TGCTGGTTGGACAATT-1_Br8667_Post_IF,2,0,0,0,0,2
GCCTAGCGATCTGACC-1_Br8667_Post_IF,0,0,1,0,0,1
CCATGCTCTGCAGGAA-1_Br8667_Post_IF,4,1,1,0,0,6
TATAAATCCACAAGCT-1_Br8667_Post_IF,1,1,1,0,0,3
CGCTCGACATAATGAT-1_Br8667_Post_IF,5,1,1,0,0,7
CCAATTGAATGTTAAT-1_Br8667_Post_IF,3,2,1,0,0,6
GCTAATACCGAATGCC-1_Br8667_Post_IF,2,0,3,0,0,5
TTCAACGACCCGACCG-1_Br8667_Post_IF,5,0,0,0,0,5
TTCCTCGAGGGTGTCT-1_Br8667_Post_IF,0,0,0,0,0,0
CAACGACCCGTTTACA-1_Br8667_Post_IF,2,0,0,0,0,2
CTTGTACTTGTTGACT-1_Br8667_Post_IF,2,0,0,0,0,2
TCTCTAATAGCTGGTA-1_Br8667_Post_IF,0,4,0,0,0,4
ATTATGCCATAGGGAG-1_Br8667_Post_IF,1,0,0,0,0,1
GACAACGCAGCTTACG-1_Br8667_Post_IF,1,0,0,0,0,1
AGATGACTCGCCCACG-1_Br8667_Post_IF,0,1,2,0,0,3
GTGCGGGTCTCCAAAT-1_Br8667_Post_IF,3,1,0,0,0,4
GTACGAGATTGCGACA-1_Br8667_Post_IF,1,0,2,0,0,3
GTATAGGACTCAGTAG-1_Br8667_Post_IF,1,1,0,0,0,2
TTGCACGGAGCAGCAC-1_Br8667_Post_IF,1,1,0,0,0,2
CACAGCTAGGGAGTGA-1_Br8667_Post_IF,2,0,1,0,0,3
ATACTAGCATGACCCT-1_Br8667_Post_IF,5,1,0,0,0,6
CCAAGACTTCTGCGAA-1_Br8667_Post_IF,2,0,0,0,0,2
ACATAATAAGGCGGTG-1_Br8667_Post_IF,1,1,1,1,0,4
TAATACACAGTAGTAT-1_Br8667_Post_IF,3,0,0,0,0,3
TCTTGGTAACACCAAA-1_Br8667_Post_IF,0,0,0,0,0,0
AACTGGGTCCCGACGT-1_Br8667_Post_IF,0,1,0,0,0,1
ATCACTTCATCCTCGC-1_Br8667_Post_IF,1,0,1,0,0,2
TGGAAGGATAAAGATG-1_Br8667_Post_IF,1,1,1,0,0,3
CATGATGCACAATTCT-1_Br8667_Post_IF,1,1,0,0,0,2
TGCCTGATCAAACGAT-1_Br8667_Post_IF,3,0,0,0,0,3
ATAGGGATATCCTTGA-1_Br8667_Post_IF,0,1,0,0,0,1
CACCTAATCAGTTTAC-1_Br8667_Post_IF,3,3,1,0,0,7
TGTGACTACGCCAGTC-1_Br8667_Post_IF,1,1,0,0,0,2
CCCGACCATAGTCCGC-1_Br8667_Post_IF,0,0,0,0,0,0
CGCGCCCGACTTAATA-1_Br8667_Post_IF,1,1,0,0,0,2
TGCCACCTGGCGAAAC-1_Br8667_Post_IF,2,0,0,0,0,2
CTGCCAAGGTTGGAAG-1_Br8667_Post_IF,1,0,0,0,0,1
TCTCCAACGTAGGTTA-1_Br8667_Post_IF,2,1,0,0,0,3
TTCTTGGAGTAATGAG-1_Br8667_Post_IF,4,0,0,0,0,4
GTCTCGATCTGCTTTC-1_Br8667_Post_IF,1,0,0,0,0,1
TACTCTCCGAACAAAT-1_Br8667_Post_IF,1,0,0,0,0,1
ATCACATTAGAATATC-1_Br8667_Post_IF,1,2,1,0,0,4
TACGGGATGCTAGCAG-1_Br8667_Post_IF,0,0,1,0,0,1
AGCTGAAGTAAACCAA-1_Br8667_Post_IF,0,0,0,0,0,0
CATGGGTCGGGTGTGG-1_Br8667_Post_IF,1,1,1,0,0,3
CACCCACGAGGCAATT-1_Br8667_Post_IF,4,0,0,0,0,4
TGCCATTACTAAAGAA-1_Br8667_Post_IF,1,1,1,0,0,3
CCGTTACGTTAGAACA-1_Br8667_Post_IF,1,0,0,1,0,2
GCCAGGAGTAACCGAT-1_Br8667_Post_IF,1,0,0,0,0,1
GGAAAGTGCCCATGCC-1_Br8667_Post_IF,1,0,0,0,0,1
TCTTACCGGAACTCGT-1_Br8667_Post_IF,2,2,2,1,0,7
TATGTCAAGACCGACT-1_Br8667_Post_IF,2,0,0,0,0,2
CCTAACTAAGGCTCTA-1_Br8667_Post_IF,1,1,0,0,0,2
GCGGTGAACTGCGCTC-1_Br8667_Post_IF,2,0,0,1,0,3
CCTCGCGCGATATAGG-1_Br8667_Post_IF,3,1,0,0,0,4
ATCGGCAAGCAGTCCA-1_Br8667_Post_IF,0,0,0,1,0,1
AGATCGTGCATAAGAT-1_Br8667_Post_IF,3,0,0,0,0,3
ATTCAGGACCTATTTC-1_Br8667_Post_IF,1,0,2,0,0,3
AGCTAGAAGCAGAAGT-1_Br8667_Post_IF,0,2,0,0,0,2
TTCGCTATCTGACGTG-1_Br8667_Post_IF,0,1,0,0,0,1
TTCCGCAGAGAAATAT-1_Br8667_Post_IF,3,0,0,0,0,3
CAGTACATTCTCTAAA-1_Br8667_Post_IF,1,1,0,0,0,2
GTGAAGATTTCAAGTG-1_Br8667_Post_IF,0,0,2,1,0,3
AACGCATGATCTGGGT-1_Br8667_Post_IF,2,1,0,0,0,3
CCCAGAGGAGGGCGTA-1_Br8667_Post_IF,2,2,2,0,0,6
GGAAACCTTGTTGAAT-1_Br8667_Post_IF,0,3,3,1,0,7
GTGAAGCCGTATAGTC-1_Br8667_Post_IF,3,0,1,0,0,4
GAGCTGTCGTCTCGGA-1_Br8667_Post_IF,1,1,0,0,0,2
TGTCATTTGTTGGGAA-1_Br8667_Post_IF,3,1,1,0,0,5
ACCAACACCACACACT-1_Br8667_Post_IF,1,1,1,0,0,3
AAATGATTCGATCAGC-1_Br8667_Post_IF,0,1,2,0,0,3
CTGCTTTATGTCCGCG-1_Br8667_Post_IF,2,3,2,1,0,8
GCGAGAGGCCATGTAA-1_Br8667_Post_IF,1,2,0,0,0,3
ATTGACCGGCGATGAC-1_Br8667_Post_IF,1,1,0,0,0,2
ACCCTGGTAACGCCCT-1_Br8667_Post_IF,1,1,0,1,0,3
GTTGGACCGCATCAGG-1_Br8667_Post_IF,4,1,1,0,0,6
CGTTTACAAGGCAGCT-1_Br8667_Post_IF,1,1,0,0,0,2
CGGTCCATGAGACTCC-1_Br8667_Post_IF,2,2,0,0,0,4
GTTCGTCTGGGTCCCT-1_Br8667_Post_IF,2,2,1,0,0,5
TGTACTACTCTCACGG-1_Br8667_Post_IF,3,0,1,0,0,4
AGTGAAGATGGTGTCC-1_Br8667_Post_IF,0,1,0,0,0,1
GAGGGCCATAATATTA-1_Br8667_Post_IF,1,0,0,0,0,1
ACTCCCGTAGACTAGG-1_Br8667_Post_IF,1,1,0,0,0,2
CGTCAAATGGTCGCAG-1_Br8667_Post_IF,1,0,0,1,0,2
AAGTCTAGTAGCTGCC-1_Br8667_Post_IF,0,2,2,0,0,4
AAGAAATCACCAGATT-1_Br8667_Post_IF,3,5,0,0,0,8
GAGTGCACGGACAACA-1_Br8667_Post_IF,0,0,0,0,0,0
GTTCAAATCAGATGTC-1_Br8667_Post_IF,4,2,0,0,0,6
CATGGCTCCCTATGTC-1_Br8667_Post_IF,2,0,4,0,0,6
GGCCACACGAAAGCCT-1_Br8667_Post_IF,1,0,0,0,0,1
GAAGCCGGGTAAGCTC-1_Br8667_Post_IF,3,0,0,0,0,3
TTGCGCTCTCTCGCTT-1_Br8667_Post_IF,1,1,0,0,0,2
TACATGACCTTATCCG-1_Br8667_Post_IF,1,1,1,0,0,3
GTCCTTCTACAACCCA-1_Br8667_Post_IF,2,1,1,0,0,4
TATATGCTGGGTTGCC-1_Br8667_Post_IF,3,1,3,0,0,7
GTTTATGGGATTTAGA-1_Br8667_Post_IF,1,0,0,0,0,1
GGAACCCGAACAAGAA-1_Br8667_Post_IF,1,0,1,0,0,2
AACGTTATCAGCACCT-1_Br8667_Post_IF,0,0,1,0,0,1
CATCGTCCGGTTACTA-1_Br8667_Post_IF,1,2,0,0,0,3
AGACAGCTCAGAATCC-1_Br8667_Post_IF,2,1,0,0,0,3
GCAGATCCTCGCAAAT-1_Br8667_Post_IF,1,2,0,0,0,3
GGGTCATGCGTACCAT-1_Br8667_Post_IF,2,1,1,0,0,4
CTGGTCATTCCAATCC-1_Br8667_Post_IF,1,0,0,1,0,2
TCAGGGCGCAAACTCG-1_Br8667_Post_IF,2,0,0,0,0,2
GATGCCAGCAGAAGGC-1_Br8667_Post_IF,1,0,0,0,0,1
GTTATTAACGTGGGAG-1_Br8667_Post_IF,4,1,2,0,0,7
AATACAATGTTTCAGG-1_Br8667_Post_IF,3,0,1,0,0,4
TTGCTGCACCTATCCA-1_Br8667_Post_IF,4,0,0,0,0,4
CCAGAGACAAAGCCGG-1_Br8667_Post_IF,1,1,2,0,0,4
CCGAAGTATATTGTTC-1_Br8667_Post_IF,1,0,0,0,0,1
GCTAAACCTGAGGTGA-1_Br8667_Post_IF,4,0,0,0,0,4
TCATACTTACAGATCC-1_Br8667_Post_IF,0,0,0,0,0,0
CGAGCACTTCAAGTTT-1_Br8667_Post_IF,0,1,1,0,0,2
TAGCAACCTGTCACAA-1_Br8667_Post_IF,0,0,1,0,0,1
TGGGAAATGCCTTTCC-1_Br8667_Post_IF,0,2,0,0,0,2
AGACCATGGGATACAA-1_Br8667_Post_IF,2,0,0,0,0,2
TAAATGAATCCGTTTC-1_Br8667_Post_IF,7,1,0,0,0,8
ACAACGGTCCCTGCGA-1_Br8667_Post_IF,1,0,1,0,0,2
GTCACTCTCCAAATCT-1_Br8667_Post_IF,2,3,0,0,0,5
TTCTACTTGCGAGGGC-1_Br8667_Post_IF,2,0,2,0,0,4
CGCAATTACTTTCGGT-1_Br8667_Post_IF,3,0,2,0,0,5
CTGTTCATCTCACGGG-1_Br8667_Post_IF,3,0,1,0,0,4
TTCTTGTAACCTAATG-1_Br8667_Post_IF,2,0,0,0,0,2
GCTTGATGATAATCAG-1_Br8667_Post_IF,0,0,0,0,0,0
TTGGCTCGCATGAGAC-1_Br8667_Post_IF,3,0,2,1,0,6
GCCCAGTTGGTATGCC-1_Br8667_Post_IF,1,1,0,0,0,2
ATTCCTCCGCCAGTGC-1_Br8667_Post_IF,4,1,0,0,0,5
TCGTCCGCTGGCGTCT-1_Br8667_Post_IF,1,2,0,0,0,3
GGAGAAGTCATTGGCA-1_Br8667_Post_IF,1,2,2,0,0,5
TTGTTAGCAAATTCGA-1_Br8667_Post_IF,1,2,0,0,0,3
TCTAGCATCTTCGATG-1_Br8667_Post_IF,0,0,1,0,0,1
TTCTAGGCCAATTGTG-1_Br8667_Post_IF,0,2,1,0,0,3
TCACGGTCATCGCACA-1_Br8667_Post_IF,0,0,2,0,0,2
ATGAAGCCAAGGAGCC-1_Br8667_Post_IF,1,1,2,0,0,4
AATGACTGTCAGCCGG-1_Br8667_Post_IF,3,1,0,0,0,4
CCAAACAGAACCCTCG-1_Br8667_Post_IF,2,0,1,0,0,3
TATCGATGATTAAACG-1_Br8667_Post_IF,2,3,1,0,0,6
GAACACACATCAACCA-1_Br8667_Post_IF,1,1,0,0,0,2
CCCGTCAGCGTCTGAC-1_Br8667_Post_IF,5,1,1,0,0,7
AGCATCGTCGATAATT-1_Br8667_Post_IF,3,0,1,0,0,4
GACTAAGATCATGCAC-1_Br8667_Post_IF,1,1,2,0,0,4
TAGGGTGTTTCAAGAG-1_Br8667_Post_IF,3,0,0,0,0,3
TGGTTCGTAGCAAAGG-1_Br8667_Post_IF,0,0,0,0,0,0
CTGTTCACTGCCTGTG-1_Br8667_Post_IF,3,1,1,0,0,5
ATGTGCATCCGACGCA-1_Br8667_Post_IF,3,1,0,0,0,4
TTGTCGTTCAGTTACC-1_Br8667_Post_IF,0,0,1,0,0,1
CGGGATCAATGTAAGA-1_Br8667_Post_IF,0,0,1,0,0,1
TTATCTGTATCATAAC-1_Br8667_Post_IF,1,1,0,0,0,2
ATCGACTCTTTCCGTT-1_Br8667_Post_IF,4,0,2,0,0,6
CTCATTTGATGGGCGG-1_Br8667_Post_IF,2,0,1,0,0,3
GTAAGCGGGCAGTCAG-1_Br8667_Post_IF,0,1,0,0,0,1
TCTATCGGTCGCAACA-1_Br8667_Post_IF,1,1,1,0,0,3
AACGCGGTCTCCAGCC-1_Br8667_Post_IF,1,1,1,1,0,4
ATTAATACTACGCGGG-1_Br8667_Post_IF,2,1,1,0,0,4
CTTTAACTTTCAAAGG-1_Br8667_Post_IF,2,0,1,0,0,3
CGTACCTGATAGGCCT-1_Br8667_Post_IF,2,0,0,0,0,2
GAATGTTGGGTAATCT-1_Br8667_Post_IF,1,1,5,0,0,7
TGCGGAGTAAAGGTGC-1_Br8667_Post_IF,2,1,0,1,0,4
CCTGAATATTTACATA-1_Br8667_Post_IF,1,2,1,0,0,4
TTGCTCCCATACCGGA-1_Br8667_Post_IF,1,0,1,0,0,2
CCTCTAATCTGCCAAG-1_Br8667_Post_IF,2,1,1,0,0,4
AGGTTGAGGCACGCTT-1_Br8667_Post_IF,1,1,1,0,0,3
TCCCGTCAGTCCCGCA-1_Br8667_Post_IF,5,2,1,0,0,8
TCCGATGACTGAGCTC-1_Br8667_Post_IF,1,0,0,0,0,1
CAGCCTCCTGCAGAGG-1_Br8667_Post_IF,2,2,0,0,0,4
CTTAGCCTTCCACATG-1_Br8667_Post_IF,2,0,0,0,0,2
ATTAATGAACCAGTCG-1_Br8667_Post_IF,2,0,1,1,0,4
ACGATACATAGAACTA-1_Br8667_Post_IF,1,0,2,0,0,3
AGCCACTCCCGTGCTT-1_Br8667_Post_IF,2,0,0,0,0,2
ATACGGGTTTCGATTG-1_Br8667_Post_IF,4,0,1,0,0,5
CTGTCAAATGGCTCGG-1_Br8667_Post_IF,1,1,3,0,0,5
GCTCGGAATTTAAAGC-1_Br8667_Post_IF,5,1,0,0,0,6
TAGGCATGTTACGCCA-1_Br8667_Post_IF,0,1,0,0,0,1
TGGCAACTCGCGCGCC-1_Br8667_Post_IF,2,0,0,0,0,2
ATCAGTAGGCAGGGAT-1_Br8667_Post_IF,4,0,0,0,0,4
TATCGATCTATGCATA-1_Br8667_Post_IF,1,2,1,0,0,4
CGACTCAGGATGTTAT-1_Br8667_Post_IF,2,1,0,0,0,3
GCCATATTGCACACAG-1_Br8667_Post_IF,8,0,1,1,0,10
AATTCATAAGGGATCT-1_Br8667_Post_IF,0,0,1,0,0,1
CGGTAGAGGTGCAGGT-1_Br8667_Post_IF,0,0,0,0,0,0
AATGATGATACGCTAT-1_Br8667_Post_IF,3,1,1,0,0,5
CTTGTGCTCACCGATT-1_Br8667_Post_IF,1,1,5,0,0,7
TTCCAATCAGAGCTAG-1_Br8667_Post_IF,2,1,0,0,0,3
CGATGGACCCTACGCC-1_Br8667_Post_IF,1,0,0,0,0,1
GGTCGGATAAACGGCG-1_Br8667_Post_IF,0,1,0,0,0,1
TTAGCTAATACGATCT-1_Br8667_Post_IF,0,2,0,0,0,2
CTCGATATTTGCGAGC-1_Br8667_Post_IF,2,1,0,0,0,3
ATTACTTACTGGGCAT-1_Br8667_Post_IF,0,0,3,0,0,3
CTAGCCGATGTTATGA-1_Br8667_Post_IF,0,1,0,0,0,1
TACTGCAATCAATTAC-1_Br8667_Post_IF,0,3,1,1,0,5
TAGTCTGTGACGTTGC-1_Br8667_Post_IF,2,3,0,0,0,5
CTCGTTTCTAATGTTT-1_Br8667_Post_IF,3,1,2,0,0,6
TTCGTTCAACGAAGTT-1_Br8667_Post_IF,3,0,0,0,0,3
CTGAATTTATTGCCAG-1_Br8667_Post_IF,2,1,0,0,0,3
TGGAATATCCTTGACC-1_Br8667_Post_IF,2,1,0,0,0,3
CAGATCATTTAAAGTC-1_Br8667_Post_IF,2,1,1,0,0,4
CTCCTTTACGCAAGTC-1_Br8667_Post_IF,2,3,0,0,0,5
TCCCAAACAGACAACG-1_Br8667_Post_IF,0,1,0,0,0,1
ATCGCTGCGTGCAGCA-1_Br8667_Post_IF,0,1,0,0,0,1
TTAGTTCAAGTGTTCG-1_Br8667_Post_IF,0,2,0,0,0,2
AAACTCGTGATATAAG-1_Br8667_Post_IF,2,2,0,0,0,4
TTAACGAACAAGCAGT-1_Br8667_Post_IF,0,2,1,0,0,3
GTTATATCAGGAGCCA-1_Br8667_Post_IF,3,0,1,0,0,4
CAAATTGGATTATGCC-1_Br8667_Post_IF,3,0,2,1,0,6
CGAGGAGCTTCCATAT-1_Br8667_Post_IF,2,2,0,0,0,4
GGAGACCAATGTGCTT-1_Br8667_Post_IF,2,2,1,1,0,6
CATTGATGAACACGCC-1_Br8667_Post_IF,1,5,0,1,0,7
GTCAATGCTATAATTT-1_Br8667_Post_IF,0,3,0,0,0,3
ACCACCCTCTCTTCTA-1_Br8667_Post_IF,1,3,0,0,0,4
TGGAGGGAAACACCTC-1_Br8667_Post_IF,0,1,0,1,0,2
CACGGACGTGGATGGC-1_Br8667_Post_IF,1,1,0,0,0,2
AACTTTCTCGATCATG-1_Br8667_Post_IF,0,1,0,0,0,1
CGTATTGTTTCCTAAT-1_Br8667_Post_IF,0,0,6,8,0,14
CCTACTGCGGCGGCCA-1_Br8667_Post_IF,0,0,0,0,0,0
CGCAATCGATCATTAG-1_Br8667_Post_IF,0,1,0,0,0,1
TGGTTATGCTTGCGGT-1_Br8667_Post_IF,0,1,0,0,0,1
GGCTTGGCTCTCACCT-1_Br8667_Post_IF,1,2,1,0,0,4
ATTGGTAGGATCCGCT-1_Br8667_Post_IF,2,0,1,0,0,3
TCAGGGCGACTTCCTT-1_Br8667_Post_IF,1,1,1,0,0,3
TCTGCAGATTCGAGTC-1_Br8667_Post_IF,2,2,0,0,0,4
CTCTCGCTGTACTATG-1_Br8667_Post_IF,0,0,0,1,0,1
AATAGTCGCGAGTCGG-1_Br8667_Post_IF,0,1,0,0,0,1
AGTTACCCTTAAGACT-1_Br8667_Post_IF,1,0,1,1,0,3
CTTAAATAAGACCCAT-1_Br8667_Post_IF,1,1,0,0,0,2
GGTTGTGCTCTTGTCC-1_Br8667_Post_IF,0,0,0,0,0,0
GTGAGTCTAAGACGGA-1_Br8667_Post_IF,8,0,0,0,0,8
CGCGACACTGCGCAGC-1_Br8667_Post_IF,3,1,1,0,0,5
GCTCGCGGTTCCGCTC-1_Br8667_Post_IF,4,1,0,0,0,5
TTAACTCACGCGTGGA-1_Br8667_Post_IF,1,3,2,0,0,6
GGAACGGCCTGCAGCC-1_Br8667_Post_IF,1,1,3,0,0,5
GTAGAAACGGGTGGAG-1_Br8667_Post_IF,1,0,0,0,0,1
TAATGAAAGACCCTTG-1_Br8667_Post_IF,0,2,0,0,0,2
AGGCTTGCTAGACACC-1_Br8667_Post_IF,1,1,0,0,0,2
TTGCGTAGTTTGAGGA-1_Br8667_Post_IF,4,0,0,0,0,4
CGCCCTTGAAGGCTGA-1_Br8667_Post_IF,0,1,1,0,0,2
CCCGGTGGAAGAACCT-1_Br8667_Post_IF,2,0,2,0,0,4
TTAACACCTCGAACAT-1_Br8667_Post_IF,4,0,1,0,0,5
GATTCCTATACGGCGC-1_Br8667_Post_IF,0,0,1,0,0,1
TTACCCTAACAGTCCT-1_Br8667_Post_IF,2,0,1,0,0,3
ACCCACCTACATGCTC-1_Br8667_Post_IF,1,2,1,0,0,4
AAAGGGCAGCTTGAAT-1_Br8667_Post_IF,1,1,1,0,0,3
CACACAGGGATAGATT-1_Br8667_Post_IF,0,1,1,0,0,2
AGAGCGTACAAGCTCG-1_Br8667_Post_IF,2,0,2,0,0,4
TCTTACGGCATCCGAC-1_Br8667_Post_IF,3,2,0,0,0,5
GCCTATTCCGATATAG-1_Br8667_Post_IF,2,1,0,0,0,3
GAAAGTGACTAACTGC-1_Br8667_Post_IF,3,0,3,0,0,6
CCGGAATGGTTTCAGT-1_Br8667_Post_IF,4,2,2,0,0,8
AGTATAATACTAGGCA-1_Br8667_Post_IF,0,1,0,0,0,1
TAACTATCGAAGGTCC-1_Br8667_Post_IF,3,2,0,0,0,5
ATGAGGAGTGTTAATC-1_Br8667_Post_IF,5,1,0,0,0,6
TGTGTCGCGAGTTGCA-1_Br8667_Post_IF,4,2,2,0,0,8
ATCCAACGCAGTCATA-1_Br8667_Post_IF,2,2,1,0,0,5
AAGGCGCGTAAAGCTT-1_Br8667_Post_IF,3,0,0,0,0,3
AGTCGGCCCAAACGAC-1_Br8667_Post_IF,1,1,0,0,0,2
AACGTCAGACTAGTGG-1_Br8667_Post_IF,1,1,0,0,0,2
ACTACCAGCTCTCTGG-1_Br8667_Post_IF,1,0,0,0,0,1
GCAAGTGCACAGAGAA-1_Br8667_Post_IF,0,0,0,0,1,1
ACACCTTAAGTAGGGC-1_Br8667_Post_IF,3,1,0,0,0,4
TTCGACGGGAAGGGCG-1_Br8667_Post_IF,1,0,1,0,0,2
TTCGCACTCGCGTGCT-1_Br8667_Post_IF,3,0,1,0,0,4
TATTTGTTACCCTTTA-1_Br8667_Post_IF,6,1,0,0,0,7
CGCTGTGACGCCGCAC-1_Br8667_Post_IF,3,2,0,0,0,5
GTTGCACGGAGTTTCG-1_Br8667_Post_IF,1,1,2,0,0,4
GTTTCCTGGAGGGTGA-1_Br8667_Post_IF,1,1,2,0,0,4
ACACCCAGCATGCAGC-1_Br8667_Post_IF,3,0,0,0,0,3
TCAACCATGTTCGGGC-1_Br8667_Post_IF,1,1,0,0,0,2
TTACAACTACGCATCC-1_Br8667_Post_IF,3,1,1,0,0,5
TCCGATGGTGCGACAT-1_Br8667_Post_IF,2,2,0,0,0,4
GGGCGTACATTTATAT-1_Br8667_Post_IF,0,2,1,0,0,3
AGCGACCAACGATATT-1_Br8667_Post_IF,4,0,1,0,0,5
ACACAAAGACGGGTGG-1_Br8667_Post_IF,1,1,1,0,0,3
ATCGCACGCCGGGAGA-1_Br8667_Post_IF,1,1,3,0,0,5
GCTCTAAACCCTGACG-1_Br8667_Post_IF,2,0,2,0,0,4
AATGCAACCGGGTACC-1_Br8667_Post_IF,0,0,0,0,0,0
TCAAACAACCGCGTCG-1_Br8667_Post_IF,3,3,1,0,0,7
TATGCTCCCTACTTAC-1_Br8667_Post_IF,4,2,0,0,0,6
AAAGGGATGTAGCAAG-1_Br8667_Post_IF,1,0,0,0,0,1
ACGATCATACATAGAG-1_Br8667_Post_IF,4,1,0,0,0,5
TTGTTCAGTGTGCTAC-1_Br8667_Post_IF,4,1,1,0,0,6
ATGCATGATCCAGGAT-1_Br8667_Post_IF,2,2,0,0,0,4
AGTCTTCTCCTCAAAT-1_Br8667_Post_IF,2,1,0,0,0,3
GATTCCCTTGTCGCAG-1_Br8667_Post_IF,0,0,1,0,0,1
CTCGCACCTATATAGT-1_Br8667_Post_IF,3,1,1,0,0,5
ACTCAATAAAGGCACG-1_Br8667_Post_IF,1,0,0,0,0,1
AACCGAGCTTGGTCAT-1_Br8667_Post_IF,2,1,2,0,0,5
TAAGGCAACATAAGAT-1_Br8667_Post_IF,1,0,0,0,0,1
CACGCACAGCGCAGCT-1_Br8667_Post_IF,1,0,0,0,0,1
GGTTTACAATCTCAAT-1_Br8667_Post_IF,5,4,2,0,0,11
TGCAGGATCGGCAAAG-1_Br8667_Post_IF,4,1,0,0,0,5
ATAACGGAGTCCAACG-1_Br8667_Post_IF,2,0,0,0,0,2
AACGATATGTCAACTG-1_Br8667_Post_IF,4,0,1,0,0,5
GACAACGACCATTGAA-1_Br8667_Post_IF,3,1,2,0,0,6
TTGACCATGTTCTCCG-1_Br8667_Post_IF,3,0,0,0,0,3
AGTACGGGCACCTGGC-1_Br8667_Post_IF,4,1,1,0,0,6
CGCCATCCGATTATGA-1_Br8667_Post_IF,3,2,0,0,0,5
AAGGTATCCTAATATA-1_Br8667_Post_IF,2,1,0,0,0,3
TGTTGTCAAGAAGTCT-1_Br8667_Post_IF,0,1,0,0,0,1
CAGTGAATAAATGACT-1_Br8667_Post_IF,2,0,0,0,0,2
CACCTTGCGAAACTCG-1_Br8667_Post_IF,2,0,0,0,0,2
CATTTAGCGGACCATG-1_Br8667_Post_IF,1,1,0,0,0,2
CCAGTCTAGACGGCGC-1_Br8667_Post_IF,3,0,0,0,0,3
TCGCTTTAAACGTTTG-1_Br8667_Post_IF,2,1,0,0,0,3
GTGAAACGGCGCCACC-1_Br8667_Post_IF,3,1,2,0,0,6
GGGCTCATCGAACCCA-1_Br8667_Post_IF,1,0,0,0,0,1
TTGATGTGTAGTCCCG-1_Br8667_Post_IF,3,4,2,0,0,9
CAGTAGCCCACGCGGT-1_Br8667_Post_IF,1,0,0,0,0,1
AGCGCGGGTGCCAATG-1_Br8667_Post_IF,2,1,2,0,0,5
TAATCGATCCGTACGT-1_Br8667_Post_IF,0,0,0,0,0,0
AGTGGCGGCAATTTGA-1_Br8667_Post_IF,2,0,1,0,0,3
CCTTTCAATGAAGAAA-1_Br8667_Post_IF,4,0,0,0,0,4
CTCAGTCACGACAAAT-1_Br8667_Post_IF,1,0,2,1,0,4
ATAGGCTAGCTTCGCA-1_Br8667_Post_IF,0,2,0,0,0,2
CGGTTCAAGTAGGTGT-1_Br8667_Post_IF,1,0,0,0,0,1
CAGTCGAGGATGCAAT-1_Br8667_Post_IF,1,0,0,0,0,1
TATCACCCAACCGACC-1_Br8667_Post_IF,2,1,1,0,0,4
AATGATGCGACTCCTG-1_Br8667_Post_IF,0,0,0,0,0,0
TGGAACCACTGACACA-1_Br8667_Post_IF,0,0,0,0,0,0
GCCAATAGGGCATCTC-1_Br8667_Post_IF,1,0,0,0,0,1
TTCTTTGGTCGCGACG-1_Br8667_Post_IF,1,1,0,0,0,2
ATTAGATTCCTCAGCA-1_Br8667_Post_IF,1,0,0,0,0,1
CCGTGGAACGATCCAA-1_Br8667_Post_IF,3,1,2,0,0,6
GGGTCGTGGCAAGTGT-1_Br8667_Post_IF,3,1,0,0,0,4
TCGCTCGGCACCAGCG-1_Br8667_Post_IF,1,2,1,0,0,4
ACGCAATCACTACAGC-1_Br8667_Post_IF,2,2,0,0,0,4
CTCTAATGCATTGATC-1_Br8667_Post_IF,2,2,0,0,0,4
GTCTCGACTAAGTTTG-1_Br8667_Post_IF,2,2,0,0,0,4
TGGTTTAAACGTGGGT-1_Br8667_Post_IF,0,2,1,0,0,3
CGCAGATCTTCACCCG-1_Br8667_Post_IF,1,3,1,2,0,7
TCCAGATGTACGCCAA-1_Br8667_Post_IF,3,1,0,0,0,4
CATTGCGGGTCAATTC-1_Br8667_Post_IF,2,2,0,0,0,4
GACGTTCGTAAATACA-1_Br8667_Post_IF,5,2,0,0,0,7
TACACCGTCGTTAGTC-1_Br8667_Post_IF,2,1,1,0,0,4
ACGGGCGTATGCGACA-1_Br8667_Post_IF,1,0,0,0,0,1
GAAGGCTACCATTGTT-1_Br8667_Post_IF,1,0,0,0,0,1
TAAATCTTTACACCTC-1_Br8667_Post_IF,2,1,2,0,0,5
AGTTTATGTAAAGACA-1_Br8667_Post_IF,2,0,0,0,0,2
AGGAGACATCCACAGT-1_Br8667_Post_IF,3,0,2,1,0,6
CAACCTGAACCTGCCA-1_Br8667_Post_IF,0,0,0,0,0,0
AGTCCCTCGCAGAAAG-1_Br8667_Post_IF,1,1,0,0,0,2
AAATGTATCTTATCCC-1_Br8667_Post_IF,0,2,0,0,0,2
ACTCTAAACCTGGGAT-1_Br8667_Post_IF,1,2,0,0,0,3
GCTGGCAGGTGCCGTG-1_Br8667_Post_IF,0,0,1,0,0,1
CTCATTCGTGAACATC-1_Br8667_Post_IF,2,2,1,0,0,5
TCGCCGGATGGGCAAG-1_Br8667_Post_IF,2,2,1,0,0,5
GGACTAAGTCAGGAGT-1_Br8667_Post_IF,1,0,0,0,0,1
TATCAAAGGTCTGTAA-1_Br8667_Post_IF,1,0,0,0,0,1
TTCAGTTTGTGGCAGC-1_Br8667_Post_IF,2,0,0,0,0,2
TGTTCATAAATGTGCT-1_Br8667_Post_IF,5,0,0,0,0,5
CTTAGCCCGGATAGTG-1_Br8667_Post_IF,1,2,0,0,0,3
GATGCGAATGGTATTA-1_Br8667_Post_IF,2,0,0,0,0,2
TCTAACTGTATGTAAA-1_Br8667_Post_IF,4,1,2,0,0,7
TTAAACCTGGTTCCTT-1_Br8667_Post_IF,0,0,0,0,0,0
GCTAAGTAAAGGCGAT-1_Br8667_Post_IF,2,1,1,0,0,4
AGTTACCGCACATGGT-1_Br8667_Post_IF,3,0,0,0,0,3
GACTGCGGCACGTGTA-1_Br8667_Post_IF,0,0,1,0,0,1
TGGTGATCGTATTTGT-1_Br8667_Post_IF,1,3,0,0,0,4
TTATCGCCTGCGAAGC-1_Br8667_Post_IF,1,0,0,0,0,1
TGGAATTAGACGCTTT-1_Br8667_Post_IF,2,1,0,0,0,3
TCGTCACACTGTTAGC-1_Br8667_Post_IF,3,5,1,0,0,9
TTATGTTTGCGATAGA-1_Br8667_Post_IF,3,0,0,0,0,3
GGTGCTGATCACAAAG-1_Br8667_Post_IF,0,1,1,0,0,2
CATAGCCGCCCGGGAT-1_Br8667_Post_IF,0,1,0,0,0,1
GGTTAGTTACGGCGCC-1_Br8667_Post_IF,0,0,0,0,0,0
ATTCCCACATAAACAA-1_Br8667_Post_IF,4,2,0,1,0,7
ATTCAGTAGCAGGGTC-1_Br8667_Post_IF,1,2,0,0,0,3
CAGTTCCGCGGGTCGA-1_Br8667_Post_IF,4,1,0,0,0,5
AAGAGATGAATCGGTA-1_Br8667_Post_IF,2,2,2,0,0,6
CGCAATTCTACAATAA-1_Br8667_Post_IF,1,1,0,0,0,2
TAACGCTTTGAGAGCG-1_Br8667_Post_IF,2,1,0,0,0,3
AGGCTATGGTTAGCTT-1_Br8667_Post_IF,2,1,0,0,0,3
GAGGAATGGAGAGGTT-1_Br8667_Post_IF,2,3,0,0,0,5
TCCTCTACGAGATGGC-1_Br8667_Post_IF,1,1,1,0,0,3
TTGATTATGCAGATGA-1_Br8667_Post_IF,2,0,1,0,0,3
TCAGTACTGACCCGCG-1_Br8667_Post_IF,0,1,0,0,0,1
TTATGACAAACTGGAT-1_Br8667_Post_IF,2,4,0,0,0,6
GTAAGTAGGGTATACC-1_Br8667_Post_IF,4,1,1,0,0,6
CGCAAACACGAGTTAC-1_Br8667_Post_IF,2,0,1,0,0,3
TGGCCGTATATTGACC-1_Br8667_Post_IF,5,0,0,0,0,5
ACTGTAGCACTTTGGA-1_Br8667_Post_IF,4,1,1,0,0,6
GCTCTATGTTACGTGC-1_Br8667_Post_IF,1,2,0,0,0,3
TGCGCGATTAACGGAG-1_Br8667_Post_IF,1,0,2,0,0,3
GAATCGACATGGTCAC-1_Br8667_Post_IF,3,0,2,0,0,5
GACTAAGTAGGCTCAC-1_Br8667_Post_IF,4,1,0,0,0,5
ATCTTGACCTGCAACG-1_Br8667_Post_IF,1,1,0,0,0,2
ATGCACTACCGCATTG-1_Br8667_Post_IF,1,0,0,0,0,1
CAGATACTAACATAGT-1_Br8667_Post_IF,1,1,0,0,0,2
GATCGACACTATCTGA-1_Br8667_Post_IF,3,0,0,0,0,3
ATAGAGTACTGGGACA-1_Br8667_Post_IF,4,2,1,0,0,7
CCTACTGCTTACACTT-1_Br8667_Post_IF,1,0,1,0,0,2
CCTGCTATTTGAGAAG-1_Br8667_Post_IF,1,0,1,0,0,2
CGCGTTCATGAAATAC-1_Br8667_Post_IF,2,0,0,0,0,2
CATTATGCTTGTTGTG-1_Br8667_Post_IF,3,0,0,0,0,3
CCAGGGACGTGGCCTC-1_Br8667_Post_IF,2,1,0,0,0,3
TATGGATGTGCTACGC-1_Br8667_Post_IF,2,1,1,0,0,4
GTACTAAGATTTGGAG-1_Br8667_Post_IF,3,1,0,0,0,4
AGACCCGCCCTCCTCG-1_Br8667_Post_IF,3,2,0,0,0,5
CGCATTAGCTAATAGG-1_Br8667_Post_IF,3,0,0,0,0,3
GCTCTCGGGTACCGAA-1_Br8667_Post_IF,0,1,0,0,0,1
CACCGCCAGAAGGTTT-1_Br8667_Post_IF,2,2,0,0,0,4
TCCCAAAGACGAAGGA-1_Br8667_Post_IF,1,0,0,0,0,1
ATGGATTGACCAAACG-1_Br8667_Post_IF,3,2,1,0,0,6
GTCATGGACATGACTA-1_Br8667_Post_IF,5,2,2,0,0,9
CTACTGCCACCTGACC-1_Br8667_Post_IF,1,0,0,0,0,1
TTATATTTGGCAATCC-1_Br8667_Post_IF,3,3,1,0,0,7
AGCACCAGTACTCACG-1_Br8667_Post_IF,3,0,0,0,0,3
CATGGTCTAGATACCG-1_Br8667_Post_IF,2,0,1,0,0,3
TCTACCGTCCACAAGC-1_Br8667_Post_IF,1,1,0,0,0,2
CTAGTTGGGCCCGGTA-1_Br8667_Post_IF,1,1,0,0,0,2
TCCCGCGTACTCCTGG-1_Br8667_Post_IF,2,1,0,0,0,3
CAGAGCATGAGCTTGC-1_Br8667_Post_IF,2,2,1,0,0,5
ACACGGGAACTTAGGG-1_Br8667_Post_IF,0,1,1,0,0,2
GGCTCTGCTCCAACGC-1_Br8667_Post_IF,2,0,0,0,0,2
AGAACGTGGTACATTC-1_Br8667_Post_IF,4,1,1,1,0,7
CAATAAACCTTGGCCC-1_Br8667_Post_IF,0,3,2,0,0,5
ACTTCGCCATACGCAC-1_Br8667_Post_IF,3,2,0,0,0,5
ATCTGGTTAAGACTGT-1_Br8667_Post_IF,2,0,2,0,0,4
TCGTAAGACGACATTG-1_Br8667_Post_IF,4,1,0,0,0,5
GTGTACCTTGGCTACG-1_Br8667_Post_IF,1,1,0,0,0,2
GCCCGTAATACCTTCT-1_Br8667_Post_IF,6,0,0,0,0,6
CGGTCAAGTGGGAACC-1_Br8667_Post_IF,0,1,0,0,0,1
TTGTAAGGCCAGTTGG-1_Br8667_Post_IF,1,0,0,0,0,1
GGAGCACCAAGAACTA-1_Br8667_Post_IF,1,1,0,0,0,2
TAATAGTGACGACCAG-1_Br8667_Post_IF,1,1,0,0,0,2
CTAAATCCTATTCCGG-1_Br8667_Post_IF,3,0,0,0,0,3
CGAGTTCTGTCCCACC-1_Br8667_Post_IF,1,0,0,0,0,1
AGGCAGATGCGTAAAC-1_Br8667_Post_IF,4,1,1,0,0,6
AAGGATGAGGGACCTC-1_Br8667_Post_IF,8,0,0,0,0,8
AGAGAACCGTCTAGGA-1_Br8667_Post_IF,3,1,0,0,0,4
GAGGGCGCAGCTCTGC-1_Br8667_Post_IF,4,1,0,1,0,6
AAGATTGGCGGAACGT-1_Br8667_Post_IF,3,0,0,0,0,3
CCAGTAGTCTGATCCA-1_Br8667_Post_IF,2,1,0,0,0,3
AAGGGACAGATTCTGT-1_Br8667_Post_IF,2,2,0,0,0,4
ATAGAGTTATCAACTT-1_Br8667_Post_IF,0,2,0,0,0,2
AAATTACCTATCGATG-1_Br8667_Post_IF,0,1,0,0,0,1
GATCCTAAATCGGGAC-1_Br8667_Post_IF,3,1,0,0,0,4
TTACAGACCTAAATGA-1_Br8667_Post_IF,3,0,0,0,0,3
CCTCACCTTAGCATCG-1_Br8667_Post_IF,1,1,0,0,0,2
CATGCGACCAGTTTAA-1_Br8667_Post_IF,4,0,1,0,0,5
AACATATCAACTGGTG-1_Br8667_Post_IF,2,1,1,0,0,4
CTATAAGAGCCAATCG-1_Br8667_Post_IF,0,2,0,0,0,2
AATATCGAGGGTTCTC-1_Br8667_Post_IF,2,2,0,0,0,4
GTACTCCTGGGTATGC-1_Br8667_Post_IF,3,2,1,1,0,7
ATAAGTAGGATTCAGA-1_Br8667_Post_IF,0,2,1,0,0,3
AGGTCGCGGAGTTACT-1_Br8667_Post_IF,2,2,0,1,0,5
CTAATTCTCAGATATT-1_Br8667_Post_IF,1,1,0,0,0,2
GCCAACCATTTCCGGA-1_Br8667_Post_IF,4,4,1,0,0,9
TGATCCCAGCATTAGT-1_Br8667_Post_IF,8,0,0,1,0,9
CGTTGTAAGATTGATT-1_Br8667_Post_IF,1,0,1,1,0,3
GAAACCATGGTGCGCT-1_Br8667_Post_IF,1,4,0,0,0,5
AATCTATGCCGGAGCC-1_Br8667_Post_IF,4,2,1,0,0,7
GACTCCCAGAATAAGG-1_Br8667_Post_IF,4,4,0,0,0,8
TATGATCCGGCACGCC-1_Br8667_Post_IF,1,2,1,1,0,5
CCGCTTGCTGACATGG-1_Br8667_Post_IF,7,1,0,0,0,8
TGGTTAAGGGCGCTGG-1_Br8667_Post_IF,2,2,1,0,0,5
TTGATAGTCAATACAT-1_Br8667_Post_IF,2,1,0,0,0,3
GGTTTAATTGAGCAGG-1_Br8667_Post_IF,4,1,0,0,0,5
CATTACATAGATTGTG-1_Br8667_Post_IF,0,0,1,1,0,2
GGTACACCAGATTTAT-1_Br8667_Post_IF,1,0,0,0,0,1
GGCCCGTATACCATGC-1_Br8667_Post_IF,0,0,0,0,0,0
ATCTTTCGTATAACCA-1_Br8667_Post_IF,0,0,1,0,0,1
GAGATGACAATCCTTA-1_Br8667_Post_IF,0,0,1,0,1,2
AAAGCTTGCCTACATA-1_Br8667_Post_IF,1,0,0,1,0,2
CCAATAGATTTCATCT-1_Br8667_Post_IF,0,3,0,0,0,3
GGGCACGAATTGGCCG-1_Br8667_Post_IF,2,0,1,0,0,3
TCGTTGACAGGGTCCC-1_Br8667_Post_IF,2,2,0,0,0,4
ATCGTATTCCGAGAAC-1_Br8667_Post_IF,1,0,0,0,0,1
GGGAATTCTGTCCAGT-1_Br8667_Post_IF,2,0,1,0,0,3
ACGCGTTTCTTAAGAG-1_Br8667_Post_IF,2,0,0,0,0,2
GAGAGCGCAGTCCCTG-1_Br8667_Post_IF,2,0,0,0,0,2
GTCCTATTGTTGTGGT-1_Br8667_Post_IF,3,0,1,1,0,5
CATCTGCAGGATCATT-1_Br8667_Post_IF,2,0,0,0,0,2
GAGTCGACAGACCCTC-1_Br8667_Post_IF,2,0,2,0,0,4
AAGTGCAAAGGTAGAC-1_Br8667_Post_IF,2,1,0,0,0,3
AGGGTGGATAGTGCAT-1_Br8667_Post_IF,2,1,1,0,0,4
TGATAGCGGGATTCTA-1_Br8667_Post_IF,2,1,0,0,0,3
GTCAGTTTGGTAGTCG-1_Br8667_Post_IF,1,0,0,0,0,1
GCATTCGAAATGAACA-1_Br8667_Post_IF,2,1,0,0,0,3
AAAGACTGGGCGCTTT-1_Br8667_Post_IF,0,1,2,0,0,3
TAACAATATTTGTTGC-1_Br8667_Post_IF,2,1,0,0,0,3
CCAGCTTCCGCCCGCA-1_Br8667_Post_IF,0,0,1,0,0,1
GATATGGATTACGCGG-1_Br8667_Post_IF,1,2,0,0,0,3
AGAGCAGTTATGAGAC-1_Br8667_Post_IF,3,0,1,0,0,4
TCACATCTTATCTGAT-1_Br8667_Post_IF,1,1,1,0,0,3
TATGAAGACAGGTGCG-1_Br8667_Post_IF,4,3,1,0,0,8
TACCTGCTGCACTGTG-1_Br8667_Post_IF,2,0,0,0,3,5
TAGGTCCAAGTAAGGA-1_Br8667_Post_IF,3,1,3,1,0,8
GAAACTCGTGCGATGC-1_Br8667_Post_IF,0,0,0,0,0,0
AACAATTACTCTACGC-1_Br8667_Post_IF,0,0,0,1,0,1
CCGCACGTGACCTCGG-1_Br8667_Post_IF,2,1,1,0,0,4
AACTTGCCCGTATGCA-1_Br8667_Post_IF,2,0,0,0,0,2
GGGTATGTATGCACTT-1_Br8667_Post_IF,4,1,0,0,0,5
TTCGTACTCCAGAACG-1_Br8667_Post_IF,1,2,0,0,0,3
GAATTTCTCGCTGCAG-1_Br8667_Post_IF,1,1,0,0,0,2
AACAGGATGGGCCGCG-1_Br8667_Post_IF,2,0,0,0,0,2
GACGTGTAGGGATTAT-1_Br8667_Post_IF,2,1,0,0,0,3
TAGGTGAGCCCTACTC-1_Br8667_Post_IF,2,0,2,0,0,4
CTAATTCGCACGCGCT-1_Br8667_Post_IF,1,2,3,0,0,6
GAAGCTTGCTGACCGC-1_Br8667_Post_IF,4,1,0,0,0,5
GGTTAGGCTTGGAGAA-1_Br8667_Post_IF,2,2,1,0,0,5
ACAAGGACAAGAGGTT-1_Br8667_Post_IF,1,2,0,0,0,3
AGGCCACCCGTTATGA-1_Br8667_Post_IF,1,0,2,2,0,5
GTGGGCTTAGACACAC-1_Br8667_Post_IF,1,2,0,0,0,3
CGTGTCCCATTCGCGA-1_Br8667_Post_IF,7,0,0,0,0,7
TGGAGTGATGCGATGA-1_Br8667_Post_IF,2,0,1,0,0,3
AACAACTGGTAGTTGC-1_Br8667_Post_IF,1,0,0,0,0,1
CCTGGCTAGACCCGCC-1_Br8667_Post_IF,1,2,1,0,0,4
CGCAATTAGGGTAATA-1_Br8667_Post_IF,0,1,1,0,1,3
TCGAAATTTAGGACCA-1_Br8667_Post_IF,1,0,0,0,0,1
AGACTAGCCTTCCAGA-1_Br8667_Post_IF,5,0,0,0,0,5
TTGATCTAACTTTGTC-1_Br8667_Post_IF,0,1,0,0,0,1
AAGGAGCGGTTGGTGC-1_Br8667_Post_IF,1,2,0,0,0,3
ACTTGGGACCCGGTGG-1_Br8667_Post_IF,1,0,0,0,0,1
TGATCTCCGGCGCCAG-1_Br8667_Post_IF,2,0,0,0,0,2
CAGTTCAAATTGACAC-1_Br8667_Post_IF,1,4,0,0,0,5
GTCCGGCTGAATTGCG-1_Br8667_Post_IF,1,0,0,0,0,1
CTGGAAATGGATGCTT-1_Br8667_Post_IF,0,0,2,0,0,2
TGATCGGTTTGACCCT-1_Br8667_Post_IF,0,1,0,0,0,1
TAGAGTCTAAGCGAAC-1_Br8667_Post_IF,0,0,1,0,0,1
GAGACTGATGGGTAGA-1_Br8667_Post_IF,1,2,1,0,0,4
TAGCTAAGTCCGGGAG-1_Br8667_Post_IF,2,2,0,0,0,4
GGGCGATATGTGTGAA-1_Br8667_Post_IF,1,2,0,0,0,3
CTCGAGGTCGAACAGT-1_Br8667_Post_IF,3,0,0,0,0,3
GATCCCTTTATACTGC-1_Br8667_Post_IF,1,2,0,0,0,3
GTCATGCACCTCCGTT-1_Br8667_Post_IF,2,1,1,0,0,4
ACTTTCCTATAGCTTC-1_Br8667_Post_IF,4,1,0,0,0,5
TCGCTCGATATATTCC-1_Br8667_Post_IF,2,2,0,0,0,4
ATAGGTTGGGCAGATG-1_Br8667_Post_IF,1,1,1,0,0,3
CAATTAAGGGTGATGA-1_Br8667_Post_IF,1,1,0,0,0,2
ACCGACTGAGTCCCAC-1_Br8667_Post_IF,1,1,0,0,0,2
CCTGTCACCCGGGCTC-1_Br8667_Post_IF,0,3,0,0,0,3
GATCGGTGGCCATAAC-1_Br8667_Post_IF,2,2,1,0,0,5
CCTATGGGTTACCGTC-1_Br8667_Post_IF,1,1,0,1,0,3
TTGGGACACTGCCCGC-1_Br8667_Post_IF,2,2,0,1,0,5
CGAGGCTAAATATGGC-1_Br8667_Post_IF,0,0,0,0,0,0
TCAGGGTGTAACGTAA-1_Br8667_Post_IF,1,2,0,1,0,4
CGAGAGATGTGAACCT-1_Br8667_Post_IF,3,0,0,0,0,3
TCGCTGGGCGGATTGT-1_Br8667_Post_IF,2,2,2,0,0,6
AGATCTCAGGTGTGAT-1_Br8667_Post_IF,2,0,0,0,0,2
TGGCCAAACTGAAGTA-1_Br8667_Post_IF,1,0,2,0,0,3
GCTTCCGTCCCTAGAC-1_Br8667_Post_IF,5,0,1,0,0,6
CAGCAGCCCGTTCCTT-1_Br8667_Post_IF,0,1,2,0,0,3
TGTATAACAGATCCTG-1_Br8667_Post_IF,2,0,0,0,0,2
CGCGGGAATTAGGCAG-1_Br8667_Post_IF,0,1,1,0,0,2
TGCATGTGGTAATCTA-1_Br8667_Post_IF,0,0,1,0,0,1
ACAATTTGAGCAGTGG-1_Br8667_Post_IF,2,1,0,0,0,3
GAGCTAAGGGCATATC-1_Br8667_Post_IF,2,1,1,0,0,4
CCAGATAGTTGAGTGA-1_Br8667_Post_IF,0,0,2,0,0,2
CCACAATGTACGTCTT-1_Br8667_Post_IF,2,2,0,0,0,4
CAATGGATCTCTACCA-1_Br8667_Post_IF,3,4,0,0,0,7
TGTGGCAAAGCGTATG-1_Br8667_Post_IF,4,2,0,0,0,6
TAAAGCGTTAGGAGAA-1_Br8667_Post_IF,4,1,0,0,0,5
TCCGTTTAGCCTTGAA-1_Br8667_Post_IF,2,1,0,0,0,3
CAGCTCGACAAGTTAA-1_Br8667_Post_IF,0,0,1,0,0,1
GCCTATAGTGTCAGGG-1_Br8667_Post_IF,2,1,0,0,0,3
ATAGACAACGGGACCT-1_Br8667_Post_IF,1,2,1,0,0,4
CTACTATCTTTCAGAG-1_Br8667_Post_IF,2,3,0,0,0,5
GCGCTGCTTTGCATTT-1_Br8667_Post_IF,1,1,0,0,0,2
GCGCATCCAGTCAGCA-1_Br8667_Post_IF,5,3,1,1,0,10
GACTCGCGGGAATGAC-1_Br8667_Post_IF,2,1,0,0,0,3
CTGGTAACGAGCTCTT-1_Br8667_Post_IF,1,1,0,0,1,3
TCCGGCCTAGCGTACA-1_Br8667_Post_IF,1,1,0,0,0,2
TCTAGGTGGCGACGCT-1_Br8667_Post_IF,7,1,0,1,0,9
ACGCTAGTGATACACT-1_Br8667_Post_IF,1,3,0,0,0,4
ATCTGCACCTCTGCGA-1_Br8667_Post_IF,2,3,0,0,0,5
CCTCACCTGAGGGAGC-1_Br8667_Post_IF,2,2,0,0,0,4
AGTGAGCCTCGCCGCC-1_Br8667_Post_IF,4,0,0,0,0,4
ACGAGTACGGATGCCC-1_Br8667_Post_IF,3,0,0,0,0,3
GGTACCATTAAGACGG-1_Br8667_Post_IF,3,0,0,0,0,3
TTCTGCTAGACTCCAA-1_Br8667_Post_IF,1,0,0,0,0,1
TAACTATTACGCCAAA-1_Br8667_Post_IF,2,0,0,0,0,2
GCATTCAAGGCAACGC-1_Br8667_Post_IF,1,6,1,0,0,8
AGTACATCATTTATCA-1_Br8667_Post_IF,2,0,0,1,0,3
GTCGTGTCTGGTCATC-1_Br8667_Post_IF,1,1,0,0,0,2
AGTCTAAAGTATACTC-1_Br8667_Post_IF,1,0,0,0,1,2
CGGCCCAACCTGTAGT-1_Br8667_Post_IF,2,0,0,1,0,3
AGGGAGACATACTTCG-1_Br8667_Post_IF,0,1,1,0,0,2
TCCCTAGATCAATAGG-1_Br8667_Post_IF,1,0,1,0,2,4
TCCCGTCGCGTCATAG-1_Br8667_Post_IF,1,0,2,0,2,5
CGCATCCATCAGCCAG-1_Br8667_Post_IF,3,0,1,0,2,6
CTGCACCTAGTCCACA-1_Br8667_Post_IF,1,0,0,0,1,2
CGAGGATCGGGAACGA-1_Br8667_Post_IF,0,0,2,1,2,5
TCTGACGGGCTAACCC-1_Br8667_Post_IF,0,1,0,0,0,1
GTCTTCCTCACCTAAG-1_Br8667_Post_IF,1,2,0,0,0,3
GGTGATGAAGGAAGTG-1_Br8667_Post_IF,1,1,0,0,0,2
TCAATACAATTGCTGC-1_Br8667_Post_IF,6,0,1,0,0,7
GCAACCCAAGTTGTTT-1_Br8667_Post_IF,2,1,0,0,0,3
ATGAAGTGGACCCAGC-1_Br8667_Post_IF,0,1,0,0,0,1
GAGAATCTCACGATCA-1_Br8667_Post_IF,1,0,0,0,0,1
TATATCATTGATCAGT-1_Br8667_Post_IF,1,2,0,0,0,3
AACTTTACGGGAGCTT-1_Br8667_Post_IF,2,0,0,0,0,2
TTCTTGTGTCCATCAG-1_Br8667_Post_IF,2,2,1,0,0,5
ACAATTTAGGAGGCTC-1_Br8667_Post_IF,2,2,0,0,0,4
ATACTTGTTCTCGAGC-1_Br8667_Post_IF,1,2,1,0,0,4
CACGGGATTGAGGGTT-1_Br8667_Post_IF,1,1,0,0,0,2
GTTAATGTCTATCTTA-1_Br8667_Post_IF,0,1,0,0,0,1
GCGTTATATTTGGAAC-1_Br8667_Post_IF,3,1,0,0,0,4
CGTCAAGGCTATAAAT-1_Br8667_Post_IF,3,2,0,0,0,5
TTAGCTCTGTAATCCG-1_Br8667_Post_IF,3,3,2,0,0,8
AATGGTCCACCGTTCA-1_Br8667_Post_IF,1,1,0,0,0,2
GTCATTGCATTGACCC-1_Br8667_Post_IF,2,0,0,0,0,2
TGTCCGTGGCGCCTTT-1_Br8667_Post_IF,1,1,2,0,0,4
TCAACTAACGTATAAC-1_Br8667_Post_IF,0,0,0,0,0,0
TCCTCTCCAGTTGTCC-1_Br8667_Post_IF,2,1,0,0,0,3
TGTGTTCGTATCCAAG-1_Br8667_Post_IF,2,0,0,0,0,2
CCGCGTAGGTAAGGGC-1_Br8667_Post_IF,0,1,1,0,0,2
CTGCGGGTGAAATGTT-1_Br8667_Post_IF,2,0,0,0,0,2
TATCTACAGAGGTAAT-1_Br8667_Post_IF,1,2,1,0,0,4
CTACTCTAGGCCCGGC-1_Br8667_Post_IF,1,2,0,0,0,3
ACAAGCAGTGCCTAGC-1_Br8667_Post_IF,3,1,0,0,0,4
TACAAGTCTCGTGCAT-1_Br8667_Post_IF,2,1,0,0,0,3
TCGGAATGCGCTCTGA-1_Br8667_Post_IF,6,1,1,0,0,8
TCGCGTCCAGAAGGTC-1_Br8667_Post_IF,2,2,0,0,0,4
TATGGCCCGGCCTCGC-1_Br8667_Post_IF,3,0,0,0,0,3
GCTGGCATATTCACCT-1_Br8667_Post_IF,2,2,0,0,0,4
GTCAGAATAGTCTATG-1_Br8667_Post_IF,2,1,0,0,0,3
GGCGTCCTATCCGCTG-1_Br8667_Post_IF,3,1,0,0,0,4
CGGAGTTTGAGAGACA-1_Br8667_Post_IF,3,2,0,0,0,5
AGCACTTAAGGACGCC-1_Br8667_Post_IF,4,2,0,0,0,6
TCCACAATGGTTTACG-1_Br8667_Post_IF,3,2,1,0,0,6
CCAACGATGCACTGAT-1_Br8667_Post_IF,1,1,0,0,0,2
ATTTACAGTTTACTGG-1_Br8667_Post_IF,3,0,0,0,0,3
CCCTGAAATGAGTTGA-1_Br8667_Post_IF,0,2,0,0,0,2
CAAACGGTCGCACTTT-1_Br8667_Post_IF,3,1,1,0,0,5
TGATTCGTCTATCACT-1_Br8667_Post_IF,2,1,0,0,0,3
TCAGGTTCTTTGAGAA-1_Br8667_Post_IF,2,1,0,0,0,3
CACGCAGCGAGGCTTT-1_Br8667_Post_IF,0,0,0,0,0,0
TTAAGCGCCTGACCCA-1_Br8667_Post_IF,1,1,0,0,0,2
CTTACACGGTATTCCA-1_Br8667_Post_IF,1,0,1,0,0,2
AAGGCTGTGCTCATCG-1_Br8667_Post_IF,3,2,0,0,0,5
GACCAGAGCCCTGTAG-1_Br8667_Post_IF,6,0,2,0,0,8
TCCCAGGCTTAGCTAA-1_Br8667_Post_IF,3,2,1,0,0,6
ATTGAAGATCTTAGTG-1_Br8667_Post_IF,1,1,0,0,0,2
AGTTCCTACAGAATTA-1_Br8667_Post_IF,1,0,0,0,0,1
GGGCTGGTTAGTCGCG-1_Br8667_Post_IF,1,1,0,0,0,2
GAAATGGCGGTGTTAG-1_Br8667_Post_IF,6,0,0,0,0,6
TACGAACACGACTTCA-1_Br8667_Post_IF,1,1,2,0,0,4
ACCACAAGTTTCTATC-1_Br8667_Post_IF,1,1,1,1,0,4
ATATTTAACCCTCAAG-1_Br8667_Post_IF,2,0,2,0,0,4
GATCATTCCAAACATT-1_Br8667_Post_IF,0,0,3,0,0,3
TCCAGGCGAGTACGGT-1_Br8667_Post_IF,5,0,1,0,0,6
GTTTGACCAAATCCTA-1_Br8667_Post_IF,1,0,1,0,0,2
CACAGCACCCACGGCA-1_Br8667_Post_IF,1,1,1,0,0,3
TGCAAGAATGACGTAA-1_Br8667_Post_IF,1,3,0,1,0,5
GCGAAGCCATACCCGT-1_Br8667_Post_IF,3,0,0,0,0,3
TCCTTTCTTACGCTTA-1_Br8667_Post_IF,1,2,3,0,0,6
GCTGCTCTCCGGACAC-1_Br8667_Post_IF,0,1,1,0,0,2
ACTGTCTTCTTTAGAA-1_Br8667_Post_IF,3,0,1,0,0,4
TCAAACTTAGATTGTT-1_Br8667_Post_IF,0,1,0,0,0,1
CTATGTCACTAGCCCA-1_Br8667_Post_IF,0,1,0,0,0,1
TGCGCAAAGCATTTGG-1_Br8667_Post_IF,6,3,2,0,0,11
TTAATGTAGACCAGGT-1_Br8667_Post_IF,2,0,1,0,0,3
GGCGGTAGGATCATTG-1_Br8667_Post_IF,6,2,1,0,0,9
GGCAATAGTCAATGAG-1_Br8667_Post_IF,2,2,1,0,0,5
ACACGAGACTCCTTCT-1_Br8667_Post_IF,0,0,1,0,0,1
GACACAAGGGAAGAAA-1_Br8667_Post_IF,0,1,0,0,0,1
TCAGCAAATGCATCTC-1_Br8667_Post_IF,2,3,0,0,0,5
GAGATCTGTCACTCCG-1_Br8667_Post_IF,1,1,0,0,0,2
ATGCCGGTCTTGCATA-1_Br8667_Post_IF,3,1,0,0,0,4
TTGGGCGGCGGTTGCC-1_Br8667_Post_IF,0,1,2,0,0,3
TTGTTGTGTGTCAAGA-1_Br8667_Post_IF,2,0,0,0,0,2
ACTGTACGATACACAT-1_Br8667_Post_IF,3,1,0,0,0,4
TCCACTTTATCTAGGT-1_Br8667_Post_IF,2,1,0,0,0,3
GGTCTGAGAATCTGGA-1_Br8667_Post_IF,2,0,1,0,0,3
TAGAAAGGTGGCGCTA-1_Br8667_Post_IF,4,0,0,0,0,4
TATGTCTCATTGTGCC-1_Br8667_Post_IF,4,0,2,0,0,6
GGATTTCACTTCTATA-1_Br8667_Post_IF,3,2,1,0,0,6
TGAGTGGTCCGTGACG-1_Br8667_Post_IF,1,0,1,0,0,2
CGCTTTCTTGCATTCG-1_Br8667_Post_IF,4,0,0,0,0,4
ACCCAACGCCCGTGGC-1_Br8667_Post_IF,2,0,0,0,0,2
GAACGTCTCATGGTCG-1_Br8667_Post_IF,2,3,1,0,0,6
AGGGTTCCCTTTGGTT-1_Br8667_Post_IF,2,0,0,0,0,2
GTAGCTTCCTCTTGTT-1_Br8667_Post_IF,2,3,0,1,0,6
GCATGAGGGACGCGGC-1_Br8667_Post_IF,2,1,0,0,0,3
CTACCCTAAGGTCATA-1_Br8667_Post_IF,1,0,0,0,0,1
TCACCGCTCGGCACTC-1_Br8667_Post_IF,3,0,0,0,0,3
GGCTCGCGTTGAGGTA-1_Br8667_Post_IF,1,2,0,0,0,3
CTAACGAAACTTGCTG-1_Br8667_Post_IF,0,5,1,0,0,6
TTAAACTCGAATTCAT-1_Br8667_Post_IF,1,0,0,1,0,2
TACTTTACTGAGCCGG-1_Br8667_Post_IF,0,3,0,0,0,3
GCTTGGATCGATTAGG-1_Br8667_Post_IF,3,1,1,0,0,5
CGGTTATCCAACAGTG-1_Br8667_Post_IF,3,0,0,0,0,3
CAGACCTGTAAGTGTT-1_Br8667_Post_IF,2,0,0,0,0,2
GACGGTCAATAGAAGC-1_Br8667_Post_IF,3,2,0,0,0,5
CTGACTGCGCAGCTCG-1_Br8667_Post_IF,3,0,0,0,0,3
CCATACCTTTACTTGT-1_Br8667_Post_IF,1,2,0,0,0,3
GTAATAAAGGGCTCCC-1_Br8667_Post_IF,2,0,0,1,0,3
GTGAACTCCCATTCGA-1_Br8667_Post_IF,2,1,0,0,0,3
GTGGTTACTTCTTTCG-1_Br8667_Post_IF,2,0,1,0,0,3
TCAGAACCTCCACAGG-1_Br8667_Post_IF,0,0,3,0,0,3
TCCCACTCTCTTCCGG-1_Br8667_Post_IF,2,0,1,0,0,3
ATCTTGACTTGTCCAA-1_Br8667_Post_IF,2,1,0,0,3,6
TCGGGAACGTGCCTAG-1_Br8667_Post_IF,0,0,1,1,0,2
GTTAGCCGTAAATCAA-1_Br8667_Post_IF,3,0,3,0,5,11
ATTTACTAAGTCCATT-1_Br8667_Post_IF,4,0,0,0,1,5
GGGTGCATATGAAAGC-1_Br8667_Post_IF,1,0,0,0,2,3
TCCGAATGGTCCTGAG-1_Br8667_Post_IF,1,0,1,0,0,2
TGATGGCTGTTTCTGA-1_Br8667_Post_IF,1,0,0,0,2,3
AAATAAGGTAGTGCCC-1_Br8667_Post_IF,0,0,0,0,4,4
CCACTATCCGGGTCAC-1_Br8667_Post_IF,1,0,1,0,5,7
CCATACTCGCCTCTCC-1_Br8667_Post_IF,1,2,0,0,0,3
ACGATACCTATCCTGA-1_Br8667_Post_IF,2,1,0,0,0,3
CTCACCAGTACAAGTG-1_Br8667_Post_IF,1,1,1,0,0,3
CGAAGACGGTGAGTGC-1_Br8667_Post_IF,1,1,1,0,0,3
AAATTAATAAGCGCGA-1_Br8667_Post_IF,0,0,3,0,0,3
GGGCCCTTATCTATAC-1_Br8667_Post_IF,2,1,1,0,0,4
CTGCCCACGAAGCGTT-1_Br8667_Post_IF,0,1,1,0,0,2
GGACAAGTTGCAGTGA-1_Br8667_Post_IF,5,2,1,0,0,8
GTCCGAGAGCAATCAT-1_Br8667_Post_IF,2,0,1,0,0,3
ATGGCAGCCGAGAAAC-1_Br8667_Post_IF,3,0,0,0,0,3
CCTCGGATGCTACCTG-1_Br8667_Post_IF,1,1,1,0,0,3
ATACGGTGAAGATGCA-1_Br8667_Post_IF,1,1,0,0,0,2
ACATCAGCTGGGACGC-1_Br8667_Post_IF,3,1,0,0,0,4
GGTTGTGTAGCCTGGC-1_Br8667_Post_IF,4,0,0,0,0,4
CCTGCGTTCTACGCTT-1_Br8667_Post_IF,2,1,0,0,0,3
GAACGTTAGGAAGACG-1_Br8667_Post_IF,3,0,0,0,0,3
CTGATAGTGTATCTCA-1_Br8667_Post_IF,2,1,0,0,0,3
TTCTGCGAGCGCCCTT-1_Br8667_Post_IF,2,0,0,0,0,2
CTTTGGCGCTTTATAC-1_Br8667_Post_IF,2,1,1,0,0,4
TCCGAACTTGGCTTAC-1_Br8667_Post_IF,3,1,2,0,0,6
TAGATTCCTGGTTATT-1_Br8667_Post_IF,2,0,1,0,0,3
CCGACAAAGGGAGTGC-1_Br8667_Post_IF,2,0,1,0,0,3
CCATGGCCCTTGTACC-1_Br8667_Post_IF,1,2,0,1,0,4
GAAATATCACCATCAG-1_Br8667_Post_IF,2,0,2,0,0,4
ACGAAATGGGCGGCAC-1_Br8667_Post_IF,4,1,0,0,0,5
GTGAGCGTGCTGCACT-1_Br8667_Post_IF,1,1,1,0,0,3
CCGCGGGTACGAAGAA-1_Br8667_Post_IF,4,1,1,0,0,6
TCCCTGGCTCGCTGGA-1_Br8667_Post_IF,6,2,0,0,0,8
CAGCTTAGTAGGTAGC-1_Br8667_Post_IF,1,2,1,0,0,4
CACGAAAGTTAGTCCC-1_Br8667_Post_IF,0,1,0,0,0,1
ACCTAATCGACTTCCT-1_Br8667_Post_IF,0,0,2,0,0,2
AAGTAGTGACGCGAGG-1_Br8667_Post_IF,3,2,0,0,0,5
TCCGATTACATTGCCG-1_Br8667_Post_IF,1,3,0,0,0,4
CCTCCGACAATTCAAG-1_Br8667_Post_IF,4,0,0,0,0,4
GTTCACAGGAGTCTAG-1_Br8667_Post_IF,0,0,0,0,0,0
CGAAGTTGCTCTGTGT-1_Br8667_Post_IF,1,0,1,0,0,2
GTCGGATATCTCAGAC-1_Br8667_Post_IF,0,0,0,0,0,0
CGCTCTCCGTAGATTA-1_Br8667_Post_IF,3,0,0,0,0,3
CAAGCAACGTCGGAGT-1_Br8667_Post_IF,3,2,1,0,0,6
CCATTCCCTGCCCACA-1_Br8667_Post_IF,1,0,0,0,0,1
CTTTGGCTTTAGTAAA-1_Br8667_Post_IF,0,2,0,0,0,2
GGCTATTAAGTTGTAT-1_Br8667_Post_IF,2,2,0,0,0,4
CCATTAGCGATAATCC-1_Br8667_Post_IF,2,1,0,0,0,3
TGTTCTTCCATTGACT-1_Br8667_Post_IF,4,2,0,0,0,6
AGATAACTTCAGGGCC-1_Br8667_Post_IF,2,2,0,0,0,4
ATAGACGAAGAGAAAG-1_Br8667_Post_IF,1,1,1,0,0,3
GGCGGAGTAATATTAG-1_Br8667_Post_IF,1,1,1,0,0,3
TGACCCACGTTAGACA-1_Br8667_Post_IF,0,1,1,0,0,2
TCACAGGTTATTGGGC-1_Br8667_Post_IF,2,3,0,0,0,5
TCACGCATTGTAGATC-1_Br8667_Post_IF,5,0,2,0,0,7
TTGAAGAATTCCCAGG-1_Br8667_Post_IF,3,3,2,1,0,9
AAATGGTCAATGTGCC-1_Br8667_Post_IF,0,2,1,0,0,3
TAGTGCCCTCCAGAGT-1_Br8667_Post_IF,2,1,0,0,0,3
GGTATTGCCGAGTTTA-1_Br8667_Post_IF,0,0,0,0,0,0
CGTATTAAGAGATCTA-1_Br8667_Post_IF,1,0,1,0,0,2
ACTGTCCAGGATTATA-1_Br8667_Post_IF,2,3,2,0,0,7
CGGGCAGCTAAACCGC-1_Br8667_Post_IF,0,0,0,0,0,0
TTGCTGATCATGTTCG-1_Br8667_Post_IF,3,2,1,0,0,6
TATGGGTACGTATCGT-1_Br8667_Post_IF,5,2,0,0,0,7
CAGCTCACTGAGACAT-1_Br8667_Post_IF,3,1,2,1,0,7
GGGACTGCATAGATAG-1_Br8667_Post_IF,2,2,0,0,0,4
ACGCATTCGTGAGTAC-1_Br8667_Post_IF,4,1,0,0,1,6
CTCTGGACGCCTGGTG-1_Br8667_Post_IF,1,6,0,0,0,7
AGGGTTTAGTTCGGGA-1_Br8667_Post_IF,2,3,0,0,0,5
GGGAGAACTCACAGTA-1_Br8667_Post_IF,5,2,0,0,0,7
ATCAATCTGGGCTGCA-1_Br8667_Post_IF,4,0,0,0,0,4
TCTTCGATACCAATAA-1_Br8667_Post_IF,1,3,0,0,0,4
ACGTAGATTGCTGATG-1_Br8667_Post_IF,2,2,1,0,0,5
TCTTGATGCGTAGCGA-1_Br8667_Post_IF,1,0,0,0,0,1
GGGCTGCCTAGGGCGA-1_Br8667_Post_IF,3,1,0,0,0,4
CTCTCACAATCGATGA-1_Br8667_Post_IF,0,1,0,1,0,2
CCAAGCGTAACTCGTA-1_Br8667_Post_IF,5,0,0,0,0,5
ACAACAGCATGAGCTA-1_Br8667_Post_IF,2,0,0,0,0,2
GTCCCAACGTAAAGTA-1_Br8667_Post_IF,3,1,1,0,0,5
TCGGAGTACATGAGTA-1_Br8667_Post_IF,2,1,0,0,0,3
GGGAGTTAATGAGGCG-1_Br8667_Post_IF,2,1,0,0,0,3
CCGGGCGGTCTCGTCA-1_Br8667_Post_IF,3,2,1,0,0,6
CCGTAAGTTGGTCCCA-1_Br8667_Post_IF,2,0,1,1,0,4
GGAGGGCTTGGTTGGC-1_Br8667_Post_IF,1,2,2,0,0,5
TCGGACGCCCAGCCCA-1_Br8667_Post_IF,4,3,0,0,0,7
TCTGTGCCATCATAGT-1_Br8667_Post_IF,3,1,1,1,0,6
GTACTGGAGTTAGACC-1_Br8667_Post_IF,2,2,0,0,0,4
GGAATGCGCTAGCGTG-1_Br8667_Post_IF,2,2,1,0,0,5
GTGTGAATAACTTAGG-1_Br8667_Post_IF,4,2,0,0,0,6
GGTCGGCCAGGAGCTT-1_Br8667_Post_IF,1,2,0,0,0,3
TAGCCGGCGGTCAGCG-1_Br8667_Post_IF,0,1,1,0,0,2
CGGGTGTACCCATTTA-1_Br8667_Post_IF,1,2,0,0,0,3
AGTGATTCAAGCAGGA-1_Br8667_Post_IF,4,1,0,0,0,5
GTTGGATTGAGAACAC-1_Br8667_Post_IF,2,2,0,0,0,4
CACACGCGCTGTCTTA-1_Br8667_Post_IF,5,2,0,0,0,7
TAGACGCCCGTACCGG-1_Br8667_Post_IF,5,0,0,0,0,5
GGTTTCAATCGGTCAG-1_Br8667_Post_IF,1,0,0,0,0,1
AATCTGCGTTGGGACG-1_Br8667_Post_IF,4,2,3,1,0,10
TTACGGATGGTTCGAG-1_Br8667_Post_IF,4,0,0,0,0,4
CGGCAGGGTCGGGTTG-1_Br8667_Post_IF,2,2,2,0,0,6
GCTTTCAGAGGAGGTG-1_Br8667_Post_IF,1,0,0,0,0,1
TCTTCCCATGGGCACA-1_Br8667_Post_IF,5,1,0,1,0,7
TACCGCGGACTTGCAG-1_Br8667_Post_IF,3,0,0,0,0,3
AGAATTATGGATTCGA-1_Br8667_Post_IF,4,1,1,0,0,6
ATTGATGAGTCCTAAC-1_Br8667_Post_IF,2,0,0,0,1,3
TAGGTCGCCGGAACTG-1_Br8667_Post_IF,0,0,0,0,0,0
TAACCTACCGTCCGAG-1_Br8667_Post_IF,1,0,0,1,0,2
CTTAGTAGGCCTACAG-1_Br8667_Post_IF,2,0,0,0,0,2
CTAGATGTGAGTGTAA-1_Br8667_Post_IF,0,0,0,0,0,0
ACTCCCGAATTCGTTT-1_Br8667_Post_IF,1,0,1,1,1,4
GTTCATCGTTTGGCTG-1_Br8667_Post_IF,2,0,0,0,2,4
ACTTTACCCTCATGAA-1_Br8667_Post_IF,2,0,0,0,0,2
GCGAGAGTTGCGTCCA-1_Br8667_Post_IF,0,0,0,0,0,0
GTTCGGGCGTACCATT-1_Br8667_Post_IF,1,0,0,0,0,1
CGACTTTGTATAGCCT-1_Br8667_Post_IF,0,0,0,0,4,4
GCCATCGATGCTGCAT-1_Br8667_Post_IF,0,0,0,0,1,1
GCATTTCCAAGGCTCC-1_Br8667_Post_IF,11,0,0,0,0,11
ATGTAAGGCTGCTCTT-1_Br8667_Post_IF,4,0,0,1,1,6
GTGACGAGGGTGACCC-1_Br8667_Post_IF,0,0,0,0,0,0
GGTATGAAAGAACTGA-1_Br8667_Post_IF,4,1,0,0,0,5
GTGGCCTAATATCATT-1_Br8667_Post_IF,1,2,0,0,0,3
CCTGTGAAACCGTAAC-1_Br8667_Post_IF,0,0,0,0,0,0
GGCAGAGAGATCGGGA-1_Br8667_Post_IF,1,2,0,0,0,3
TAGCGTCGAATATTGA-1_Br8667_Post_IF,2,3,0,0,0,5
CGCCGACTATTCGCTA-1_Br8667_Post_IF,3,1,0,0,0,4
TCTGGCGCAAGCCGGG-1_Br8667_Post_IF,0,1,1,0,0,2
AGTGGTTGCGTATAGG-1_Br8667_Post_IF,0,2,0,0,0,2
ATCGGTTACCTAGTAA-1_Br8667_Post_IF,2,0,0,0,0,2
CCTGCCCGTTGTCTAG-1_Br8667_Post_IF,2,1,0,0,0,3
GCACACGCCCATGGTC-1_Br8667_Post_IF,3,3,0,0,0,6
AGTACGGCCCGTATCG-1_Br8667_Post_IF,1,1,0,0,0,2
TATCTAGCCTAAAGGA-1_Br8667_Post_IF,0,2,0,0,0,2
CACTCGGTTAGGAGGA-1_Br8667_Post_IF,2,1,0,0,0,3
ATGTTCGTCGACCCAC-1_Br8667_Post_IF,4,1,0,0,0,5
TTCCTCTGCCCGAATA-1_Br8667_Post_IF,5,0,0,0,0,5
TTACTATCGGCTTCTC-1_Br8667_Post_IF,1,1,0,0,0,2
GCCGCATTAGTCCGGC-1_Br8667_Post_IF,5,1,0,0,0,6
TAAGGGCTGGGAGAGG-1_Br8667_Post_IF,3,1,0,0,0,4
TAAGCAGGCGACACGC-1_Br8667_Post_IF,2,4,0,0,0,6
AGCACTACCGGCCTGT-1_Br8667_Post_IF,2,2,0,0,0,4
GAAAGCCCTTTGGACC-1_Br8667_Post_IF,3,0,0,0,0,3
GACCGACTGAAGCGTC-1_Br8667_Post_IF,0,3,0,0,0,3
CGGTGAAGACTAAAGT-1_Br8667_Post_IF,1,4,0,0,0,5
CCCTGCGCTACGCATA-1_Br8667_Post_IF,0,2,0,0,0,2
TACTGGACAGCTCGGC-1_Br8667_Post_IF,1,3,0,0,0,4
TTAGTAGGGCGGCGGG-1_Br8667_Post_IF,2,1,0,0,0,3
GAGGCTATCAAAGTCG-1_Br8667_Post_IF,2,1,0,0,0,3
TTACCATTGATTACCC-1_Br8667_Post_IF,5,3,0,0,0,8
ATACCACGGGCAACTT-1_Br8667_Post_IF,2,1,0,0,0,3
TGTCCTAAGTCACCGC-1_Br8667_Post_IF,1,1,1,0,0,3
AGGTAGGTACAAAGCT-1_Br8667_Post_IF,1,2,0,0,0,3
GGCATACAGGTAGCGG-1_Br8667_Post_IF,5,0,0,0,0,5
TGTAGTGATCTATAAT-1_Br8667_Post_IF,1,2,0,0,0,3
TCCCGGGTGTGCTGCT-1_Br8667_Post_IF,1,1,0,0,0,2
TACGATGTTGATCATC-1_Br8667_Post_IF,5,1,1,0,0,7
CCTCTCTCCCATCTAG-1_Br8667_Post_IF,2,0,1,0,0,3
GCAGGACTATAGAATA-1_Br8667_Post_IF,1,3,0,0,0,4
CTAGTGAAGGACAGGA-1_Br8667_Post_IF,0,0,0,0,0,0
TACGAGAACTTCACGT-1_Br8667_Post_IF,3,2,0,0,0,5
CGTTGTTTCAATTCCC-1_Br8667_Post_IF,2,1,1,0,0,4
GCAAATATTACGCTTT-1_Br8667_Post_IF,4,0,1,0,0,5
CCAATAGTGCCGTCGA-1_Br8667_Post_IF,0,1,0,0,0,1
ATTGCTGCTCCTCCAT-1_Br8667_Post_IF,1,1,0,0,0,2
GAGATCTGCTTGGCAT-1_Br8667_Post_IF,0,2,0,0,0,2
GCCGAAATTCCTACGT-1_Br8667_Post_IF,3,1,0,0,0,4
GGCACTCCACTGGGCA-1_Br8667_Post_IF,5,3,0,0,0,8
GGGTCACCGTGACGGT-1_Br8667_Post_IF,0,2,1,0,0,3
CACTTAATCAGACGGA-1_Br8667_Post_IF,4,2,1,0,0,7
CGTTTCGCTCATTACA-1_Br8667_Post_IF,1,3,1,0,0,5
ATAAAGGCTCGGTCGT-1_Br8667_Post_IF,1,2,0,0,0,3
CACTAAAGTTGCCTAT-1_Br8667_Post_IF,2,0,0,0,1,3
GTGCTCAAGTACTGTC-1_Br8667_Post_IF,1,1,0,0,0,2
CCATGCCTGTTTAGTA-1_Br8667_Post_IF,3,2,2,0,0,7
TCTAGTTATCAGAAGA-1_Br8667_Post_IF,1,3,2,0,0,6
TTGTAATCCGTACTCG-1_Br8667_Post_IF,2,2,1,0,0,5
TCCCAGCTTTAGTCTG-1_Br8667_Post_IF,1,1,1,0,0,3
CTACGCACGGAGTACC-1_Br8667_Post_IF,0,3,0,0,0,3
AAATTAACGGGTAGCT-1_Br8667_Post_IF,4,1,0,0,0,5
CGGCCACGCACAAAGT-1_Br8667_Post_IF,2,1,1,0,0,4
GAAGCGTGAGGAATTT-1_Br8667_Post_IF,2,1,1,1,0,5
ATATCTTAGGGCCTTC-1_Br8667_Post_IF,0,2,0,0,0,2
ACGCGGGCCAAGGACA-1_Br8667_Post_IF,2,0,1,0,0,3
GCGAGTTCTGCAAAGA-1_Br8667_Post_IF,3,2,0,0,0,5
TATTCGTGCCAGAATA-1_Br8667_Post_IF,1,4,0,0,0,5
AGGGCTGCAGTTACAG-1_Br8667_Post_IF,3,1,1,0,0,5
CTAGCATAGTATAATG-1_Br8667_Post_IF,2,2,0,0,0,4
TAGGTTCGAGTTCGTC-1_Br8667_Post_IF,5,3,0,0,0,8
GAATTATAGTGAAAGG-1_Br8667_Post_IF,0,1,1,0,0,2
CTATCGGGTCTCAACA-1_Br8667_Post_IF,4,1,1,1,0,7
GCGCTAATTGAATAGA-1_Br8667_Post_IF,3,4,0,0,1,8
ATGCGACAGTCCCATT-1_Br8667_Post_IF,2,1,1,1,0,5
GGTAGTGCTCGCACCA-1_Br8667_Post_IF,2,2,0,0,0,4
AAGCTCGTGCCAAGTC-1_Br8667_Post_IF,3,6,0,0,0,9
TATTCAATTCTAATCC-1_Br8667_Post_IF,1,3,0,0,0,4
TTCAAAGTCTCTAGCC-1_Br8667_Post_IF,0,3,2,0,0,5
TTGAATATGGACTTTC-1_Br8667_Post_IF,5,2,0,0,0,7
AAGAGCTCTTTATCGG-1_Br8667_Post_IF,4,3,0,0,0,7
TTACTCCGGCCGGGAA-1_Br8667_Post_IF,2,1,0,0,0,3
AAACGAGACGGTTGAT-1_Br8667_Post_IF,0,3,0,1,0,4
GCTAAGTAGTTTCTCT-1_Br8667_Post_IF,3,1,1,0,0,5
ATAACGCCGGAGGGTC-1_Br8667_Post_IF,5,3,1,0,0,9
GGATCCGGAATATACT-1_Br8667_Post_IF,1,2,0,0,0,3
TGAAAGGACCTGACTC-1_Br8667_Post_IF,5,2,2,0,0,9
TCCGCGGCAGCATCTG-1_Br8667_Post_IF,0,2,0,0,0,2
TGCATATGTCTGTCAC-1_Br8667_Post_IF,4,2,0,0,1,7
TGTAGGAGAAATTTCC-1_Br8667_Post_IF,6,1,1,0,1,9
AGTGAGACTTCCAGTA-1_Br8667_Post_IF,5,1,0,0,0,6
CCCAAACATGCTGCTC-1_Br8667_Post_IF,2,3,1,0,0,6
GCTTATGAAGCAGGAA-1_Br8667_Post_IF,2,0,0,0,0,2
TTCTAACCGAAGCTTA-1_Br8667_Post_IF,2,0,0,0,0,2
GGATGTCCTTACCGCA-1_Br8667_Post_IF,0,0,2,0,1,3
AGGGTGCTCTCGAGGG-1_Br8667_Post_IF,1,0,0,0,0,1
AACTCTCAATAGAGCG-1_Br8667_Post_IF,1,0,0,0,2,3
TCTGAATTCCGTACAA-1_Br8667_Post_IF,2,0,0,1,0,3
GCGTGGTACTGGGTTA-1_Br8667_Post_IF,1,0,0,1,0,2
CGTCGGATAGTGTTGA-1_Br8667_Post_IF,0,1,1,0,0,2
ATATGTCTCCCTAGCC-1_Br8667_Post_IF,3,0,0,0,0,3
TCTTTAAGACTATGAA-1_Br8667_Post_IF,3,0,1,0,1,5
TCATTTAAGTCTCCGA-1_Br8667_Post_IF,1,0,0,0,0,1
GATATTGAGATTGGCG-1_Br8667_Post_IF,3,0,0,0,0,3
TGACATCGAGCGGACC-1_Br8667_Post_IF,2,0,0,0,0,2
GCGTAAATGGCCATAA-1_Br8667_Post_IF,3,0,1,0,1,5
ATTGTACAACTCGGCT-1_Br8667_Post_IF,0,0,1,0,4,5
TACGCTATAGAAACCT-1_Br8667_Post_IF,1,0,2,0,2,5
CACCCAAATCTTATGT-1_Br8667_Post_IF,1,0,0,0,2,3
AGATGATGGAGTCTGG-1_Br8667_Post_IF,1,0,0,0,1,2
CCACGGTGCCCGGTAG-1_Br8667_Post_IF,9,0,3,2,0,14
TCAAGAAATACTAGCT-1_Br8667_Post_IF,4,0,0,0,3,7
CAAGGTCCTATAGGCT-1_Br8667_Post_IF,0,0,0,0,0,0
CAAACCAGGTCTGCAT-1_Br8667_Post_IF,3,0,0,0,0,3
ACAAGCTATATGGAAG-1_Br8667_Post_IF,1,1,0,0,0,2
TCGCCCACTGCGAGAG-1_Br8667_Post_IF,2,2,1,0,0,5
AGCCGCAAATTCAAAT-1_Br8667_Post_IF,1,1,1,0,0,3
TTAACGTTAAAGCCTG-1_Br8667_Post_IF,2,2,1,0,0,5
CAGCGCCAACACGATA-1_Br8667_Post_IF,7,0,0,0,1,8
ATCCAATGGTACCGAA-1_Br8667_Post_IF,0,3,0,0,0,3
GTGCTGCAGATAAGGA-1_Br8667_Post_IF,3,3,0,0,0,6
GGCCTTTGCAACTGGC-1_Br8667_Post_IF,4,2,0,0,0,6
GTCGTACCTACGATTG-1_Br8667_Post_IF,2,3,0,0,0,5
TAGAAATTCACGTATA-1_Br8667_Post_IF,1,0,0,0,0,1
AGAATAAATCTTCAGG-1_Br8667_Post_IF,1,2,0,0,0,3
CATTGCGAAATGGGCG-1_Br8667_Post_IF,1,6,0,0,0,7
GTCTACTCAATTACAA-1_Br8667_Post_IF,2,2,0,0,0,4
TGTAATGACCACAATA-1_Br8667_Post_IF,1,5,0,0,0,6
AAAGTCGACCCTCAGT-1_Br8667_Post_IF,1,0,0,0,0,1
TACTCGGCACGCCGGG-1_Br8667_Post_IF,3,3,0,0,0,6
AGGTGTATCGCCATGA-1_Br8667_Post_IF,1,0,0,1,1,3
TGTGCTTTACGTAAGA-1_Br8667_Post_IF,5,0,0,1,1,7
AAACCTCATGAAGTTG-1_Br8667_Post_IF,3,0,0,0,0,3
TATAGGGTACTCATGA-1_Br8667_Post_IF,3,4,0,0,0,7
CCAGCTGATGGTACTT-1_Br8667_Post_IF,1,0,0,0,0,1
AATATTGGAGTATTGA-1_Br8667_Post_IF,0,1,0,0,0,1
GGCCCTCACCCACTTA-1_Br8667_Post_IF,3,0,0,0,0,3
AACCAAGACTTCTCTG-1_Br8667_Post_IF,3,2,0,0,0,5
TCGTATTACCCATTGC-1_Br8667_Post_IF,2,2,0,0,0,4
ATTCGACGCCGGGCCT-1_Br8667_Post_IF,0,1,0,0,0,1
GGCGCAGGACATCTTC-1_Br8667_Post_IF,4,6,1,0,0,11
GTACTCCCTTATCGCT-1_Br8667_Post_IF,3,1,0,0,0,4
TGGTCTGTTGGGCGTA-1_Br8667_Post_IF,2,7,1,0,1,11
AATAACAACGCTCGGC-1_Br8667_Post_IF,3,1,1,0,1,6
CATACCCGTACCCAGT-1_Br8667_Post_IF,3,1,1,0,1,6
ACAATCCATTTAAACC-1_Br8667_Post_IF,3,2,0,0,0,5
GTTACAATTGGTGACG-1_Br8667_Post_IF,3,3,0,0,0,6
TTGCCCTGATCACGGG-1_Br8667_Post_IF,0,0,0,0,0,0
CTAACCGCGCGCCCGT-1_Br8667_Post_IF,2,1,0,0,0,3
CTAAAGAATGCCTACT-1_Br8667_Post_IF,0,0,0,0,0,0
ACCCATCTTGAGGGTA-1_Br8667_Post_IF,1,2,0,0,1,4
GATCTTTGCAGGGTAT-1_Br8667_Post_IF,3,0,0,0,0,3
GGGTACTTCATGAACT-1_Br8667_Post_IF,2,1,0,0,0,3
GCCGCTTGTGAGAAAC-1_Br8667_Post_IF,2,3,0,0,0,5
CCTGTAAGACATGATA-1_Br8667_Post_IF,3,1,1,0,0,5
CGACAGTTCGCGTTAT-1_Br8667_Post_IF,1,0,0,0,0,1
ACGATGCATATGTTAT-1_Br8667_Post_IF,2,1,0,0,0,3
TGTTCCGCTTCCATGA-1_Br8667_Post_IF,1,3,0,0,0,4
GGATGACGCGAGTTTA-1_Br8667_Post_IF,0,2,1,0,0,3
GAAGTTTCCACTCAAT-1_Br8667_Post_IF,3,3,0,0,0,6
GCGAGGCCCGAGCAGA-1_Br8667_Post_IF,3,0,0,0,0,3
CATACTATGTAATTGT-1_Br8667_Post_IF,1,1,0,0,0,2
CCAATGTCACAGCAAG-1_Br8667_Post_IF,0,4,0,0,0,4
GTTGGATTTGCGTTGG-1_Br8667_Post_IF,2,3,1,0,0,6
GGGAGGATGCCCGAAA-1_Br8667_Post_IF,1,2,0,0,0,3
GATCGCGGGCTCTCCA-1_Br8667_Post_IF,2,2,1,0,0,5
GTTCGCCATAAGTGCC-1_Br8667_Post_IF,6,0,0,0,0,6
AGATTATAGGACGTTT-1_Br8667_Post_IF,2,1,0,0,0,3
TCGAGACCAACACCGT-1_Br8667_Post_IF,0,3,0,0,0,3
TATGGGACCGAGCAGG-1_Br8667_Post_IF,2,3,0,0,1,6
GATGCGTCCTGCATTC-1_Br8667_Post_IF,2,4,1,0,0,7
TATGGTCTGAGTAACA-1_Br8667_Post_IF,1,3,0,0,0,4
GCATAGAGCACTCAGG-1_Br8667_Post_IF,1,0,1,0,0,2
CTTCATTGTCAGTGGA-1_Br8667_Post_IF,3,1,1,0,0,5
GCAGATTAGGGATATC-1_Br8667_Post_IF,5,3,0,0,0,8
CCTGTCGCCCGTAAAT-1_Br8667_Post_IF,2,3,0,0,0,5
CAATTTCGTATAAGGG-1_Br8667_Post_IF,2,4,0,0,0,6
GTACACTTACCTGAAG-1_Br8667_Post_IF,1,3,0,0,0,4
CCAGCCTGGACCAATA-1_Br8667_Post_IF,4,0,0,0,0,4
ATGGAGCAGGCCGTGA-1_Br8667_Post_IF,5,4,0,0,0,9
GTCATTAGAGCGAACG-1_Br8667_Post_IF,2,2,0,0,0,4
AAGACTGCAAGCTACT-1_Br8667_Post_IF,2,0,0,0,1,3
CTAGTCACGTCTTAAG-1_Br8667_Post_IF,3,1,0,0,0,4
ACTCTTGTATAGTAAC-1_Br8667_Post_IF,2,2,0,0,1,5
ATTAGGCGATGCTTTC-1_Br8667_Post_IF,2,1,0,0,1,4
TTCGGGACTAATCGCG-1_Br8667_Post_IF,1,1,0,0,0,2
TGGACTGTTCGCTCAA-1_Br8667_Post_IF,3,1,0,0,0,4
AACGTGCGAAAGTCTC-1_Br8667_Post_IF,1,2,0,0,0,3
CCACCCAAGGAAAGTG-1_Br8667_Post_IF,0,0,0,0,0,0
CCGCACAAAGACCAAC-1_Br8667_Post_IF,2,1,0,0,0,3
GCGATTGTTAACGTTA-1_Br8667_Post_IF,3,0,0,0,0,3
ACTCGTCAGTAATCCC-1_Br8667_Post_IF,4,1,0,0,0,5
GGTGATAAGGAGCAGT-1_Br8667_Post_IF,3,0,1,0,0,4
AAGAGGCATGGATCGC-1_Br8667_Post_IF,2,1,0,0,0,3
CACGTTCGTGCTCTAG-1_Br8667_Post_IF,0,1,0,0,1,2
CTATTTGGTTACGGAT-1_Br8667_Post_IF,2,1,2,1,0,6
GTACAGAGGCAAGGGT-1_Br8667_Post_IF,1,0,0,0,0,1
GGGCCGGCCGAAGTAC-1_Br8667_Post_IF,4,0,1,0,0,5
CCTGAACGATATATTC-1_Br8667_Post_IF,1,0,0,0,0,1
CCGGGCTGCTCCATAC-1_Br8667_Post_IF,1,0,0,0,0,1
TACTTGTTAGTAGTCC-1_Br8667_Post_IF,1,0,0,0,0,1
CCTAGGCGTAGCGATC-1_Br8667_Post_IF,1,1,1,0,0,3
CTGGCGCACAGGTCTG-1_Br8667_Post_IF,2,0,1,0,1,4
ACTTATACTTACCCGG-1_Br8667_Post_IF,3,0,0,0,0,3
GAAGTCTCCCTAGCGA-1_Br8667_Post_IF,0,0,0,0,0,0
ACCGATGGTAGCATCG-1_Br8667_Post_IF,1,0,0,0,1,2
CGAGTTTATCGGACTG-1_Br8667_Post_IF,3,0,0,0,0,3
CATAACGGACAGTCGT-1_Br8667_Post_IF,0,0,0,0,1,1
TGACGATGCACTAGAA-1_Br8667_Post_IF,1,0,0,0,1,2
TAGGGAGCTTGGGATG-1_Br8667_Post_IF,3,0,0,0,1,4
AGGGTCGATGCGAACT-1_Br8667_Post_IF,0,0,0,0,1,1
TATATCCCTGGGAGGA-1_Br8667_Post_IF,0,0,0,0,2,2
CATCTTACACCACCTC-1_Br8667_Post_IF,6,0,0,0,2,8
GTGCGACAGGGAGTGT-1_Br8667_Post_IF,0,0,0,0,1,1
CCGATCTCAACCTTAT-1_Br8667_Post_IF,4,0,0,0,1,5
ACGATCATCTTGTAAA-1_Br8667_Post_IF,1,0,0,0,1,2
CTAGGTCTGAAGGAAT-1_Br8667_Post_IF,6,0,0,0,0,6
AAATAGCTTAGACTTT-1_Br8667_Post_IF,1,0,0,0,0,1
ACAGGTGTGTTGTTGC-1_Br8667_Post_IF,0,0,0,0,0,0
TGAACTGCTATGACTT-1_Br8667_Post_IF,2,1,1,1,0,5
TGACATATATGACGAT-1_Br8667_Post_IF,2,0,0,0,0,2
AAGTCTTCTGTGGCCT-1_Br8667_Post_IF,3,1,1,0,0,5
ACCAGACCATAACAAC-1_Br8667_Post_IF,4,0,0,0,0,4
TGAGACGTACCTCTCA-1_Br8667_Post_IF,0,1,0,0,0,1
GACCGTTACATGCGAC-1_Br8667_Post_IF,0,0,0,0,0,0
GGTTCGGATTATACTA-1_Br8667_Post_IF,0,1,0,0,0,1
CCTCCTGAGCCCACAT-1_Br8667_Post_IF,1,0,0,0,0,1
CCGCGATTTGGTAGGT-1_Br8667_Post_IF,1,1,1,0,1,4
AATCTCTACTGTGGTT-1_Br8667_Post_IF,1,0,0,0,0,1
ACTTTGACTGCATCCT-1_Br8667_Post_IF,0,1,0,0,0,1
CCCTGACTAACAAATT-1_Br8667_Post_IF,1,1,0,1,0,3
ACGCTGTGAGGCGTAG-1_Br8667_Post_IF,1,0,0,0,1,2
GCATACGAGGTCTTTA-1_Br8667_Post_IF,0,0,0,0,0,0
TCGGGATTCAAACATA-1_Br8667_Post_IF,0,0,0,1,1,2
GGGCCCTACGAAAGGG-1_Br8667_Post_IF,1,0,0,0,0,1
CGCCAAGAAGCCGAGT-1_Br8667_Post_IF,1,0,0,0,1,2
GGTACATCTGGGACGA-1_Br8667_Post_IF,2,0,0,0,0,2
GGATGCTGGCGTTCCT-1_Br8667_Post_IF,1,0,0,0,0,1
CCGATTCGAGGGACCC-1_Br8667_Post_IF,1,1,1,0,0,3
CCACTGGTGGCTGGTT-1_Br8667_Post_IF,0,0,0,0,2,2
GACAGGCACACACTAT-1_Br8667_Post_IF,2,0,1,0,0,3
TCAACGCGACCGGCAG-1_Br8667_Post_IF,0,0,0,0,0,0
CTACGACTAGCTATAA-1_Br8667_Post_IF,0,2,2,0,0,4
CGGTTGACCTGGCATA-1_Br8667_Post_IF,0,0,0,0,1,1
ATCCTGAATCGCTGCG-1_Br8667_Post_IF,1,0,1,0,0,2
GTTTCATATCGTCGCT-1_Br8667_Post_IF,1,0,0,0,1,2
ATAAATATTAGCAGCT-1_Br8667_Post_IF,0,0,2,0,0,2
AAGAGGATGTACGCGA-1_Br8667_Post_IF,2,0,0,0,0,2
TCCTGCGTTGATACTC-1_Br8667_Post_IF,3,0,0,0,0,3
CGTGCATTGTCGACGC-1_Br8667_Post_IF,1,0,0,0,1,2
CCGGGTTCGAGGTTAC-1_Br8667_Post_IF,3,1,0,0,0,4
CCCAATTTCACAACTT-1_Br8667_Post_IF,0,1,1,0,0,2
TGATTTATTAGCTGTG-1_Br8667_Post_IF,2,1,0,0,0,3
TGGAAGAAGGGAACGT-1_Br8667_Post_IF,0,0,0,0,3,3
GACGCTTGCTTCTAAA-1_Br8667_Post_IF,0,0,0,0,1,1
GGGAACGGGAGGTTAG-1_Br8667_Post_IF,1,0,0,0,0,1
GCGGCTCTGACGTACC-1_Br8667_Post_IF,3,3,1,0,0,7
ACGTTAGATTTGCCCG-1_Br8667_Post_IF,0,1,0,0,0,1
GAGAGGGCGCGAGGTT-1_Br8667_Post_IF,4,2,0,0,0,6
GCGTCTCTGCATTGGG-1_Br8667_Post_IF,0,0,0,0,0,0
GCAGCACACAGCCCAG-1_Br8667_Post_IF,6,0,2,0,1,9
CAGGCCGTTTGGGTGT-1_Br8667_Post_IF,1,0,0,0,0,1
AACTCAAGTTAATTGC-1_Br8667_Post_IF,1,1,1,0,0,3
CTTCGTAGATAGGTGA-1_Br8667_Post_IF,0,0,0,0,0,0
TGCAGAGTACCGAGCA-1_Br8667_Post_IF,1,1,1,0,0,3
GAAGTGATTTATCGTG-1_Br8667_Post_IF,3,0,0,0,0,3
CGCTACGGGACATTTA-1_Br8667_Post_IF,2,0,0,0,1,3
CCACACTGAGATATTA-1_Br8667_Post_IF,0,1,0,0,0,1
CGATCCGACCCAGTGC-1_Br8667_Post_IF,2,0,0,0,0,2
CTGTACTTCTTAGCAT-1_Br8667_Post_IF,0,0,0,0,3,3
ACTTATTAGGATCGGT-1_Br8667_Post_IF,1,0,3,0,0,4
TAGTCCGCAGAGAATG-1_Br8667_Post_IF,0,1,0,0,2,3
TTCACGAAAGGATCAC-1_Br8667_Post_IF,4,0,1,0,0,5
TACATTTCTAACGTGC-1_Br8667_Post_IF,0,1,0,0,2,3
ACCATATCCGCAATAA-1_Br8667_Post_IF,4,0,0,0,0,4
CACTCAAGAGCTATGG-1_Br8667_Post_IF,0,1,1,0,0,2
TGTACGAACAAATCCG-1_Br8667_Post_IF,1,0,1,0,0,2
ATCATCCAATATTTGT-1_Br8667_Post_IF,0,0,0,0,0,0
CGCTATTCTTAGGCTC-1_Br8667_Post_IF,0,0,0,0,0,0
TGGCAGCAGTAATAGT-1_Br8667_Post_IF,0,1,0,0,3,4
TCACGTGCCCGATTCA-1_Br8667_Post_IF,2,0,1,0,0,3
CATACGGCGTCTGGGC-1_Br8667_Post_IF,0,0,0,0,2,2
CACATGATTCAGCAAC-1_Br8667_Post_IF,2,0,0,0,2,4
GCTAGTAGAGCTTGTA-1_Br8667_Post_IF,2,0,0,0,3,5
TGCTGTTGAAGAACTC-1_Br8667_Post_IF,0,0,0,0,1,1
TAGCGTTGGGTCTTAC-1_Br8667_Post_IF,3,1,1,0,0,5
TAACATACAATGTGGG-1_Br8667_Post_IF,0,0,0,0,1,1
GATCGTGACTGATATC-1_Br8667_Post_IF,4,0,0,0,0,4
TTATATACGCTGTCAC-1_Br8667_Post_IF,0,0,0,0,2,2
AGCTCTAGACGTTCCA-1_Br8667_Post_IF,0,0,0,0,1,1
CGAGGGACTGCGGTCG-1_Br8667_Post_IF,0,0,0,0,1,1
TAATTTCCGTCCAGTA-1_Br8667_Post_IF,1,0,0,0,1,2
TCCTTCAATCCCTACG-1_Br8667_Post_IF,5,1,1,0,0,7
TACCTATCCCTAGAGG-1_Br8667_Post_IF,1,0,0,0,0,1
GCATGGGTACTGACGC-1_Br8667_Post_IF,2,0,1,0,0,3
GTCGGGAACATGGTAG-1_Br8667_Post_IF,1,0,0,0,0,1
GCAAATGAGGACACTT-1_Br8667_Post_IF,2,0,0,0,1,3
GAATGGGCTTATCGAC-1_Br8667_Post_IF,2,0,0,0,0,2
TGGTCGTGCAAGGCAA-1_Br8667_Post_IF,4,0,0,0,7,11
CACCACGCCACACAGA-1_Br8667_Post_IF,3,0,1,0,0,4
GAACCTCGACCTACAC-1_Br8667_Post_IF,2,0,0,1,3,6
CAATACGCTCTGAGGC-1_Br8667_Post_IF,3,0,0,0,0,3
TGGTAAGCAGGATTGA-1_Br8667_Post_IF,5,0,0,0,1,6
AGTGGCTCCGTCGGCC-1_Br8667_Post_IF,4,0,0,0,0,4
GATCGGATAGAACCAT-1_Br8667_Post_IF,5,0,0,0,0,5
GCTACAGTACGGACCG-1_Br8667_Post_IF,0,0,0,0,0,0
TTCAGGCGTCAAAGCC-1_Br8667_Post_IF,1,0,0,0,3,4
AGAGATCTCTAAAGCG-1_Br8667_Post_IF,0,0,1,0,1,2
GTGGCGGTCCCAGCGT-1_Br8667_Post_IF,2,0,1,0,3,6
CCGTTCCGAATCTCGG-1_Br8667_Post_IF,0,0,0,0,1,1
AGCTTGATCTTAACTT-1_Br8667_Post_IF,11,0,0,0,0,11
CCTGTACTCACGCCCA-1_Br8667_Post_IF,3,0,0,0,3,6
AAGTGACGACCGAATT-1_Br8667_Post_IF,11,0,0,0,0,11
CTCACTTGGCTGGTAA-1_Br8667_Post_IF,1,1,1,0,2,5
CGCCTGGCCTACGTAA-1_Br8667_Post_IF,0,0,0,0,0,0
CCCGTAAGTCTAGGCC-1_Br8667_Post_IF,0,0,0,0,0,0
TTGGACATGTGGCTTA-1_Br8667_Post_IF,7,0,0,0,0,7
ATTACGCGCTGGCAGG-1_Br8667_Post_IF,5,0,0,0,1,6
ACGCGCTACACAGGGT-1_Br8667_Post_IF,10,0,0,1,5,16
TACGTTTACCGGCAAT-1_Br8667_Post_IF,1,0,0,0,0,1
TAGTCTAACAACGAGA-1_Br8667_Post_IF,1,0,0,0,0,1
TCTGGGTAGCGCTCAT-1_Br8667_Post_IF,0,1,0,0,1,2
AGATACCGGTGTTCAC-1_Br8667_Post_IF,1,0,0,0,0,1
TCCAACTTTAAATTCT-1_Br8667_Post_IF,1,0,0,0,1,2
GTCTATCTGAGTTTCT-1_Br8667_Post_IF,0,0,0,0,1,1
AGTTAAACACTTGCGA-1_Br8667_Post_IF,0,0,0,0,2,2
ATCCAGGATTCGTGAA-1_Br8667_Post_IF,1,0,0,0,1,2
CGATACCTCGCGGACA-1_Br8667_Post_IF,2,0,0,0,3,5
AATTAAAGGTCGGCGT-1_Br8667_Post_IF,0,0,0,0,1,1
GACCGTGCTGACGGTG-1_Br8667_Post_IF,0,0,1,0,1,2
GGTACAAACATGCTAT-1_Br8667_Post_IF,0,0,0,0,5,5
CGTGAAGTTAATTCAC-1_Br8667_Post_IF,0,0,0,0,1,1
TACGCCATATTCTAAT-1_Br8667_Post_IF,0,0,0,0,0,0
TACATAGGCATACACC-1_Br8667_Post_IF,0,0,0,0,1,1
TGTGTCGAAGTCGAGG-1_Br8667_Post_IF,6,0,0,0,1,7
GGATCAGAGCCATCAG-1_Br8667_Post_IF,0,0,0,0,0,0
GTCCCAATCATCCCGC-1_Br8667_Post_IF,3,0,0,0,0,3
TGCCACACTAGAGGAA-1_Br8667_Post_IF,8,0,0,1,0,9
TGAATTTCACTTGCCT-1_Br8667_Post_IF,5,0,0,0,0,5
CTCAGATTGTGATAAG-1_Br8667_Post_IF,1,0,0,3,0,4
CGGACGTTACTTGAAG-1_Br8667_Post_IF,7,0,1,1,0,9
CCAGTCAAATCTCTTA-1_Br8667_Post_IF,11,0,0,0,0,11
TCAACGAGGAGACAAA-1_Br8667_Post_IF,16,0,0,0,0,16
CATCGGACGGGTTAAT-1_Br8667_Post_IF,10,0,0,0,0,10
TATCTACCACAGCGGG-1_Br8667_Post_IF,12,0,0,0,0,12
ACATCGATCGTTTACC-1_Br8667_Post_IF,16,0,0,0,0,16
GAATCTGAACATTCTC-1_Br8667_Post_IF,11,0,0,0,0,11
CAGTCTGTATACTGGG-1_Br8667_Post_IF,17,0,1,0,0,18
CGACCTACTAGACAAT-1_Br8667_Post_IF,0,0,1,0,1,2
GAGTCTTGTAAAGGAC-1_Br8667_Post_IF,1,0,0,0,0,1
AATATCCTAGCAAACT-1_Br8667_Post_IF,0,0,0,0,1,1
CCCTAGGCAACAAGAG-1_Br8667_Post_IF,1,0,0,0,0,1
ACAAAGAAGGTAGGCC-1_Br8667_Post_IF,2,0,1,0,1,4
CCCTGGCTGTTCCTTC-1_Br8667_Post_IF,1,0,0,1,0,2
TCGCCGCACCGCGTGA-1_Br8667_Post_IF,0,0,0,0,0,0
TATAGCGCACGTTATC-1_Br8667_Post_IF,2,0,0,0,0,2
TTATCTGACATTAGGA-1_Br8667_Post_IF,1,0,3,0,0,4
AGTGGTGTTACCCGTG-1_Br8667_Post_IF,0,0,2,0,0,2
GCCAAGAATACTTCTG-1_Br8667_Post_IF,3,0,0,0,0,3
CCGGCGTGAGACTCTG-1_Br8667_Post_IF,1,0,0,1,0,2
TTCCCGGCGCCAATAG-1_Br8667_Post_IF,0,0,0,0,0,0
AAACAGGGTCTATATT-1_Br8667_Post_IF,1,0,0,0,0,1
ACAGTAATACAACTTG-1_Br8667_Post_IF,2,0,1,0,0,3
CGAACGGCCGGACAAC-1_Br8667_Post_IF,1,0,0,0,0,1
GCAACACACTAGAACT-1_Br8667_Post_IF,0,0,0,0,1,1
ACTCCCATTCCTAAAG-1_Br8667_Post_IF,2,1,2,0,0,5
ACCTGCGTGTCATGTT-1_Br8667_Post_IF,2,0,1,0,0,3
TACTTTCCGCACGCCA-1_Br8667_Post_IF,4,0,0,0,0,4
AGGTCAGGTGAGAGTG-1_Br8667_Post_IF,1,0,0,0,0,1
TCCTCCTAAGACATTC-1_Br8667_Post_IF,1,0,0,0,0,1
ATGTGAAAGCCTAATG-1_Br8667_Post_IF,0,0,0,0,0,0
AGTCGGCTCAACTTTA-1_Br8667_Post_IF,2,0,0,0,0,2
CGATCTGTTGGAGGAC-1_Br8667_Post_IF,1,0,0,0,0,1
ACGGGAGTGTCGGCCC-1_Br8667_Post_IF,2,1,0,0,0,3
TTAACTTCAGGTAGGA-1_Br8667_Post_IF,8,0,0,0,0,8
CCACGGAGCCATAAGA-1_Br8667_Post_IF,1,0,0,0,0,1
CTTCTATGTTGAAGTA-1_Br8667_Post_IF,2,0,1,0,2,5
CACCGTTGCGCGATAT-1_Br8667_Post_IF,1,0,0,0,0,1
TCTAGCAATCTCCGCC-1_Br8667_Post_IF,0,1,0,0,0,1
AGTTTGGCCAGACCTA-1_Br8667_Post_IF,3,2,0,0,0,5
TTGTAAGGACCTAAGT-1_Br8667_Post_IF,2,0,0,0,1,3
AAATTTGCGGGTGTGG-1_Br8667_Post_IF,0,0,0,0,0,0
AAGTTCGGCCAACAGG-1_Br8667_Post_IF,1,0,1,0,1,3
CCGCTTACCTCACTCT-1_Br8667_Post_IF,0,1,0,0,0,1
ATCACGTGCTAATTAA-1_Br8667_Post_IF,0,0,0,0,0,0
GGTGAAGTACAGGGAT-1_Br8667_Post_IF,0,0,0,0,0,0
GCTGTATTACTGGCCC-1_Br8667_Post_IF,0,0,0,0,0,0
AACGGCCATCTCCGGT-1_Br8667_Post_IF,2,1,0,0,0,3
TAAGTAACATCTTGAC-1_Br8667_Post_IF,1,0,1,0,0,2
TTCTTGAGCCGCGCTA-1_Br8667_Post_IF,1,0,0,0,0,1
AGTGCGTAGCTCGTAA-1_Br8667_Post_IF,2,0,0,0,0,2
GGGATGGTCGTAACCG-1_Br8667_Post_IF,0,0,0,0,0,0
GTCTGGGCGGTCGAGA-1_Br8667_Post_IF,0,0,0,1,0,1
CGGAACGTAAACATAG-1_Br8667_Post_IF,2,0,0,0,0,2
TGCGACACCCTAGTGC-1_Br8667_Post_IF,2,0,0,0,0,2
CAAACGAGTATCGCAG-1_Br8667_Post_IF,1,0,1,0,1,3
TCAGTAGGGACTATAA-1_Br8667_Post_IF,3,0,2,0,0,5
GCGGTTCCCTATCATG-1_Br8667_Post_IF,2,0,0,0,0,2
GTGACTTCAGTAGTGC-1_Br8667_Post_IF,4,0,0,0,2,6
CGTCACGTCCATTGGT-1_Br8667_Post_IF,3,0,1,0,0,4
ATAAGTTACCGCGACG-1_Br8667_Post_IF,1,0,0,0,2,3
CTGAATCCGAGACCTC-1_Br8667_Post_IF,0,0,0,0,1,1
TACGACGCTTGCTGCG-1_Br8667_Post_IF,3,0,0,0,0,3
GAATTCACCCGGGTGT-1_Br8667_Post_IF,2,1,0,0,0,3
TGAGTAAATTAGCGTA-1_Br8667_Post_IF,0,0,1,0,0,1
GGCGCGTTCGAGTTTA-1_Br8667_Post_IF,3,0,0,0,0,3
ATAAACGGACCCGTAA-1_Br8667_Post_IF,0,0,1,0,0,1
ATAATAGCTGTTGAAT-1_Br8667_Post_IF,0,1,1,0,0,2
TACCGGCTCACTGCCC-1_Br8667_Post_IF,1,0,0,0,0,1
GTTACCTACAACTTGC-1_Br8667_Post_IF,3,0,0,0,0,3
AAATACCTATAAGCAT-1_Br8667_Post_IF,1,1,0,0,0,2
ATGTGGACATCTTGAT-1_Br8667_Post_IF,1,0,0,0,0,1
CACATATTAGCAGGAT-1_Br8667_Post_IF,1,0,0,0,1,2
TCGCAAAGATGCATTT-1_Br8667_Post_IF,1,0,0,0,2,3
TCGTGTACTATGGATG-1_Br8667_Post_IF,1,0,0,0,2,3
TCACAGGGAATCGCAA-1_Br8667_Post_IF,2,0,0,0,1,3
TCCGCTGTCATCCCGG-1_Br8667_Post_IF,1,0,1,0,0,2
ACTGAATGGCGAAAGT-1_Br8667_Post_IF,2,0,0,0,0,2
TTCAGCCCTGGTCCAC-1_Br8667_Post_IF,2,0,0,0,2,4
GGTTAGCTATATGTCT-1_Br8667_Post_IF,2,0,0,0,0,2
TGGGCCCATACTAATT-1_Br8667_Post_IF,1,0,0,0,1,2
TTAGTTATTCGTGGCA-1_Br8667_Post_IF,0,0,1,0,3,4
ATACGTCCACTCCTGT-1_Br8667_Post_IF,1,0,0,0,1,2
TCTGAACTCGTACCCG-1_Br8667_Post_IF,0,0,0,0,1,1
GTGATCACTAACGCCT-1_Br8667_Post_IF,1,0,0,0,1,2
TTGACAGGAGCTCCCG-1_Br8667_Post_IF,0,0,0,0,1,1
CGTGGCCGAATATCTA-1_Br8667_Post_IF,0,0,0,0,0,0
TCAAGGTTACTACACC-1_Br8667_Post_IF,0,0,0,0,0,0
TATGACCTTGCGCTGG-1_Br8667_Post_IF,2,0,0,0,0,2
ATATACATGTATGGTA-1_Br8667_Post_IF,3,3,0,0,0,6
TGTGTGACCATGAATC-1_Br8667_Post_IF,1,0,0,0,0,1
CCCACTCCACGGTATC-1_Br8667_Post_IF,2,0,0,0,0,2
GGGCAGACGTCACTGC-1_Br8667_Post_IF,3,0,0,1,0,4
TCAAAGAGCTATCTGT-1_Br8667_Post_IF,1,0,2,0,0,3
AGATGCATCCTGTGTC-1_Br8667_Post_IF,2,0,0,0,0,2
GTGAAGTCACGACTCG-1_Br8667_Post_IF,4,2,0,0,0,6
TGATTCAGGTCCCGCG-1_Br8667_Post_IF,0,0,0,0,0,0
CGCCACAGGTCGCGAT-1_Br8667_Post_IF,2,1,0,0,0,3
TTGAATCGTTGTATAA-1_Br8667_Post_IF,1,1,0,0,0,2
TGGCCAATTTGGTACT-1_Br8667_Post_IF,1,4,0,0,0,5
CGACCCTTAACGCCGG-1_Br8667_Post_IF,3,0,0,0,0,3
TCGGCGTACTGCACAA-1_Br8667_Post_IF,2,2,0,0,0,4
GAGTAAGGCCACGGGA-1_Br8667_Post_IF,0,2,1,0,0,3
ATCAGCTCGTCCACTA-1_Br8667_Post_IF,2,4,0,0,0,6
AGGATCACGCGATCTG-1_Br8667_Post_IF,1,0,0,0,0,1
AAATGGCCCGTGCCCT-1_Br8667_Post_IF,4,1,0,0,0,5
CAGTACCAGTTTACGT-1_Br8667_Post_IF,1,1,2,0,0,4
GGTCGTAAGCTCGCAC-1_Br8667_Post_IF,4,4,0,0,0,8
CGTTCATGGTGCGCGT-1_Br8667_Post_IF,2,0,0,0,0,2
GACTACAAAGCGGTGG-1_Br8667_Post_IF,1,0,1,0,0,2
CAGCTGGCGTAACCGT-1_Br8667_Post_IF,3,0,0,0,0,3
ACTCGTAACCCGTCCT-1_Br8667_Post_IF,3,2,0,0,0,5
CATATGTCAGGCTACG-1_Br8667_Post_IF,3,1,1,0,0,5
GCCCGACTTCTTCCCG-1_Br8667_Post_IF,1,6,0,0,0,7
CTGGCATCCGAATGAG-1_Br8667_Post_IF,2,1,0,0,0,3
AAGTGCGTTAGAATCT-1_Br8667_Post_IF,2,3,0,1,0,6
AGAAGTGATTCGTGAT-1_Br8667_Post_IF,0,0,0,0,0,0
TACCTTAAGATTTCCC-1_Br8667_Post_IF,2,1,0,0,0,3
AATGACAGCAATGTCT-1_Br8667_Post_IF,2,0,0,0,0,2
TCAACGCAGGAAATAA-1_Br8667_Post_IF,3,3,0,1,0,7
TATTCCTCCGCCCACT-1_Br8667_Post_IF,2,2,2,0,0,6
ATCAAACGAAGGTTTG-1_Br8667_Post_IF,4,1,0,0,0,5
TTGATTAGCTGTTTCT-1_Br8667_Post_IF,1,0,0,0,0,1
CTGCTGAGGCCACGAA-1_Br8667_Post_IF,4,0,1,0,0,5
CCGTGTTAAATTCCAT-1_Br8667_Post_IF,3,0,0,0,0,3
CACGTCGGCAACCTCT-1_Br8667_Post_IF,2,0,0,0,0,2
GTATTCTGAGAAACGA-1_Br8667_Post_IF,2,4,0,0,0,6
CGGTGCGCGTTGGTCC-1_Br8667_Post_IF,2,2,0,0,0,4
GTGATTCGCCGCTCAA-1_Br8667_Post_IF,2,0,1,0,0,3
GCCCGCGCGTAAACGG-1_Br8667_Post_IF,1,1,0,1,0,3
AACGTACTGTGGGTAC-1_Br8667_Post_IF,1,4,0,0,0,5
GAGTATGCCCGCCTTG-1_Br8667_Post_IF,3,1,1,0,0,5
TGATTCTGTCGCCGGT-1_Br8667_Post_IF,3,0,0,0,0,3
GGGCGGCAAATGAATT-1_Br8667_Post_IF,4,2,1,0,0,7
TTCCAATCTGGCTATC-1_Br8667_Post_IF,3,2,0,0,0,5
GGAACCGTGTAAATTG-1_Br8667_Post_IF,4,1,0,0,0,5
TTGGTCACACTCGTAA-1_Br8667_Post_IF,0,1,0,0,0,1
CGAACCCGCATGCGTC-1_Br8667_Post_IF,1,3,0,0,0,4
GGGCGTCACCACGTAA-1_Br8667_Post_IF,4,0,0,0,0,4
TACCAGAAGTAGGTTC-1_Br8667_Post_IF,4,3,0,1,0,8
TTGGATATCGTCTACG-1_Br8667_Post_IF,4,0,0,0,0,4
TAGATATGGACTGGAA-1_Br8667_Post_IF,4,1,0,0,1,6
GCGACGATAGTTGTAC-1_Br8667_Post_IF,1,0,0,0,0,1
CTGGATTTACACTTGA-1_Br8667_Post_IF,3,2,1,0,0,6
GTTATATTATCTCCCT-1_Br8667_Post_IF,2,1,0,0,0,3
TATTCCACTCAGCTCG-1_Br8667_Post_IF,2,2,0,0,0,4
CTGTTACCCAATCTAG-1_Br8667_Post_IF,3,2,1,0,0,6
ACGCGAAGTCAGACGA-1_Br8667_Post_IF,1,2,0,0,0,3
GATAGGTAACGTTGAC-1_Br8667_Post_IF,2,3,0,0,0,5
TGTTCGTATTGCGGTG-1_Br8667_Post_IF,4,2,1,0,0,7
GGTCAGTGGGTCCCAC-1_Br8667_Post_IF,3,2,0,0,0,5
AATTCTAGAGTTAGGC-1_Br8667_Post_IF,0,2,1,1,0,4
GTTTACGTTCCATCTG-1_Br8667_Post_IF,0,0,0,0,0,0
AGACCCACCGCTGATC-1_Br8667_Post_IF,3,0,1,0,0,4
TCTAGCATGCCCAGAA-1_Br8667_Post_IF,4,3,0,0,0,7
CCCGCAGCGCGAACTA-1_Br8667_Post_IF,2,3,1,0,0,6
CTCTATTTGGCTGCAG-1_Br8667_Post_IF,4,1,0,0,0,5
TTCTGCCGCGCCTAGA-1_Br8667_Post_IF,2,0,1,1,0,4
ACTCCCTAGAATAGTA-1_Br8667_Post_IF,2,1,0,0,0,3
CCGAACCTTCCCGGCC-1_Br8667_Post_IF,4,2,0,0,0,6
TCAGACGCTATAGAAG-1_Br8667_Post_IF,2,0,0,0,0,2
CAGGCGCCATGCTAGG-1_Br8667_Post_IF,2,0,1,1,0,4
CACTCGAGCTGAACAA-1_Br8667_Post_IF,2,0,0,0,0,2
ACAAGGAAATCCGCCC-1_Br8667_Post_IF,2,1,0,1,0,4
ACCACGTGCAGCTATA-1_Br8667_Post_IF,1,0,0,0,0,1
ACGGCGACGATGGGAA-1_Br8667_Post_IF,2,0,0,0,0,2
TTACTAAAGGACTTTA-1_Br8667_Post_IF,0,0,1,0,0,1
GGCTGAAATAGCAAAG-1_Br8667_Post_IF,0,2,2,0,2,6
TTAGACGAGTCACCTC-1_Br8667_Post_IF,0,0,0,0,0,0
GTAGTCGCGGGAATCA-1_Br8667_Post_IF,0,2,0,0,0,2
GCAAACCCTACATTAT-1_Br8667_Post_IF,0,0,1,0,0,1
GTTAAAGTAGGACTGG-1_Br8667_Post_IF,3,0,0,0,1,4
ACCCTCCCTTGCTATT-1_Br8667_Post_IF,0,0,0,0,1,1
CATGTCTCATTTATGG-1_Br8667_Post_IF,2,5,0,0,0,7
AATAGAATCTGTTTCA-1_Br8667_Post_IF,2,0,0,0,0,2
TCTCATGAGATAGGGT-1_Br8667_Post_IF,0,1,1,0,0,2
ATGACTATGCGACATT-1_Br8667_Post_IF,0,0,0,0,0,0
CCTAACCCAAACAAGT-1_Br8667_Post_IF,4,0,0,0,0,4
AGTCAAGATGACACTT-1_Br8667_Post_IF,1,1,1,0,0,3
CGGGAGCTTCAGTGTA-1_Br8667_Post_IF,0,0,0,0,0,0
CCACAGTACCCATCCT-1_Br8667_Post_IF,0,0,0,0,0,0
GAGCGCGCACGAGTAG-1_Br8667_Post_IF,1,0,0,0,0,1
ACCAGTGCGGGAGACG-1_Br8667_Post_IF,3,0,0,0,0,3
TCCTTACGACGGTCCG-1_Br8667_Post_IF,0,0,0,0,0,0
TAGTCGATCACGGGTT-1_Br8667_Post_IF,2,0,0,0,0,2
AGACGAAGTGCCGGTC-1_Br8667_Post_IF,1,0,0,0,0,1
CGCTGGTGACTACCCT-1_Br8667_Post_IF,1,0,0,0,0,1
AGGCATTGTCGTAGGG-1_Br8667_Post_IF,1,0,1,0,0,2
TGGTAGAATATATGGG-1_Br8667_Post_IF,1,0,0,1,2,4
TTCTTATCCGCTGGGT-1_Br8667_Post_IF,1,0,0,0,0,1
AGTTTGGCACGGGTTG-1_Br8667_Post_IF,0,0,1,0,4,5
GCATCGGCCGTGTAGG-1_Br8667_Post_IF,0,0,0,0,0,0
ATGCGAGTCCCACCAC-1_Br8667_Post_IF,0,0,0,0,0,0
TCGGCGAACCCAAACC-1_Br8667_Post_IF,0,0,0,0,3,3
AGAGTAAACTTCACTA-1_Br8667_Post_IF,0,0,0,0,0,0
AAGCCGAAGCGGTTTA-1_Br8667_Post_IF,0,0,0,0,1,1
CCCGAGTTTCTCCGTA-1_Br8667_Post_IF,0,0,0,0,0,0
AATATCGAATCAATGC-1_Br8667_Post_IF,1,0,0,0,0,1
CGTTAAACTAGTTAGG-1_Br8667_Post_IF,0,0,0,0,0,0
TTAGAGGGATATACAG-1_Br8667_Post_IF,0,1,0,0,0,1
TTGTACACCTCGAACA-1_Br8667_Post_IF,3,5,0,0,0,8
GTGGGTACTGAGCGTA-1_Br8667_Post_IF,2,0,0,0,0,2
CTTAAGCAGCGAGCCG-1_Br8667_Post_IF,4,1,0,0,0,5
GCATTGACTTGCGGAA-1_Br8667_Post_IF,2,0,0,0,0,2
CCATAACCTGTGCAGT-1_Br8667_Post_IF,0,2,0,0,0,2
GGGCTACTATTTCGTG-1_Br8667_Post_IF,8,1,0,0,0,9
GGCGAGCGAAACGGCA-1_Br8667_Post_IF,1,0,1,0,0,2
GGAGACCATCTACATA-1_Br8667_Post_IF,3,2,0,0,0,5
AGACCAAACCACACCT-1_Br8667_Post_IF,5,2,1,0,0,8
CGACGCATCCGTACCT-1_Br8667_Post_IF,1,2,1,0,0,4
CCTAGGTAAAGGTAGC-1_Br8667_Post_IF,2,1,0,0,0,3
AGCGGCGGTTAGCGGT-1_Br8667_Post_IF,2,2,0,0,0,4
CTGGACGCAGTCCGGC-1_Br8667_Post_IF,0,3,0,0,0,3
AGCCTAATACCCACGT-1_Br8667_Post_IF,1,1,1,0,0,3
AATCTGGCTTTCTAGT-1_Br8667_Post_IF,1,3,2,0,0,6
CACCCTTGGTGAGACC-1_Br8667_Post_IF,1,2,0,0,0,3
GGATCTTGACTCAACC-1_Br8667_Post_IF,3,2,0,0,0,5
ACGAGGATACCACTCT-1_Br8667_Post_IF,4,1,0,0,0,5
GAGTTGATGGCAATTT-1_Br8667_Post_IF,2,1,0,0,0,3
GTGGCAAACAGCGGCA-1_Br8667_Post_IF,1,1,0,0,0,2
GATGTAACGAACCACC-1_Br8667_Post_IF,1,4,0,0,0,5
AGCCGTGGCTAAATGT-1_Br8667_Post_IF,2,3,0,0,0,5
CTCCCTCCTTTCGATC-1_Br8667_Post_IF,2,2,0,0,0,4
TTGGAAGAATACAGTC-1_Br8667_Post_IF,2,2,0,0,0,4
AGTTAAGTCAACCGCT-1_Br8667_Post_IF,2,0,0,0,0,2
CTCATGGTAATTTGCG-1_Br8667_Post_IF,1,0,0,0,0,1
AAAGTAGCATTGCTCA-1_Br8667_Post_IF,1,0,1,0,0,2
TTGTGGTAGGAGGGAT-1_Br8667_Post_IF,2,2,0,0,0,4
AGTCGTGGGCATTACG-1_Br8667_Post_IF,0,3,0,0,0,3
ACCTAAGTACCTTTCA-1_Br8667_Post_IF,1,1,0,0,0,2
GTAGAGGGAGACAAGT-1_Br8667_Post_IF,3,3,0,0,0,6
GATCCTCGACACTGGC-1_Br8667_Post_IF,2,3,1,0,0,6
CCTACATTCACAGACG-1_Br8667_Post_IF,0,2,0,0,0,2
TTGACCGTGTTAATGA-1_Br8667_Post_IF,2,2,1,0,0,5
TCTGTTACCCAGCATA-1_Br8667_Post_IF,1,0,0,0,0,1
CTAACTGGTCCGGTTC-1_Br8667_Post_IF,2,4,1,0,0,7
AGCGACAGGAACGGTC-1_Br8667_Post_IF,2,0,0,0,0,2
TAATAGAACAGAGTTA-1_Br8667_Post_IF,1,2,0,0,0,3
ACAGGTGGAGGTGAGG-1_Br8667_Post_IF,3,1,1,0,0,5
TGCGAGAATATTACCC-1_Br8667_Post_IF,2,2,0,0,0,4
TTGCGTCGGCCAACCG-1_Br8667_Post_IF,3,1,0,0,0,4
AGGCTTCCCGAAGAAG-1_Br8667_Post_IF,1,1,1,0,0,3
GCGGACCGCGTTGTGG-1_Br8667_Post_IF,3,1,0,0,0,4
GTAATCTGATTCTTCG-1_Br8667_Post_IF,2,2,1,0,0,5
CCGCGGAATGCGTCAC-1_Br8667_Post_IF,4,0,0,0,0,4
TTCCACACAGATTTGA-1_Br8667_Post_IF,6,4,0,0,0,10
CTTCTATTAATGCTAG-1_Br8667_Post_IF,1,0,1,0,0,2
CATTTGAGTGGTACGT-1_Br8667_Post_IF,1,0,0,0,0,1
TCACAGCAAACTCGAA-1_Br8667_Post_IF,2,3,1,0,0,6
CAGACGAACCTGATAC-1_Br8667_Post_IF,3,3,0,0,0,6
TAGCTAGAAGGCATGA-1_Br8667_Post_IF,0,0,0,0,0,0
ATCCAGAGCAACAACC-1_Br8667_Post_IF,0,0,0,0,0,0
TCCGGTTCGTCCGGTC-1_Br8667_Post_IF,2,2,0,0,0,4
CGCGCATGTTTGATTG-1_Br8667_Post_IF,2,2,1,0,0,5
TGGCGATCAAGTTATG-1_Br8667_Post_IF,0,1,0,0,0,1
CCCTTTGACAGGTCTT-1_Br8667_Post_IF,4,1,0,0,0,5
CAGAGACGGTCACCCA-1_Br8667_Post_IF,4,5,0,0,0,9
TAGCTCGCCTGATAAC-1_Br8667_Post_IF,2,1,1,0,0,4
TTGTGTTTCCCGAAAG-1_Br8667_Post_IF,1,1,0,0,0,2
TATACACAGACGCCTT-1_Br8667_Post_IF,3,0,0,0,0,3
ACATTAGTTTATATCC-1_Br8667_Post_IF,4,1,0,1,0,6
CCATCGCAGTTAAACT-1_Br8667_Post_IF,3,2,0,0,0,5
AATTAGCGCTGCAGCG-1_Br8667_Post_IF,0,2,0,0,0,2
TCCGCTTATCCCATTA-1_Br8667_Post_IF,2,2,0,0,0,4
GTTTGGGCTTGTGAGC-1_Br8667_Post_IF,2,1,0,0,0,3
CTTGTCAACATTCGAG-1_Br8667_Post_IF,2,3,0,0,0,5
GGACCAACAGGATAAC-1_Br8667_Post_IF,2,2,1,0,0,5
AAGCTAGATCGAGTAA-1_Br8667_Post_IF,0,1,1,0,0,2
TACCGTGCCTCGGACC-1_Br8667_Post_IF,1,1,2,0,0,4
GTAGCCAAACATGGGA-1_Br8667_Post_IF,1,2,0,0,0,3
TGCCAGTACGTGGAGA-1_Br8667_Post_IF,3,3,0,0,0,6
ATAAGGTGGAGAACAT-1_Br8667_Post_IF,1,3,0,0,0,4
CTTTAATATTGGTCGA-1_Br8667_Post_IF,0,1,0,0,0,1
TGGTTCAACGGGTAAT-1_Br8667_Post_IF,3,4,0,0,0,7
GCTGCTACTGCGTAGC-1_Br8667_Post_IF,1,1,0,0,0,2
CTGCACAACTACATAT-1_Br8667_Post_IF,2,1,0,0,1,4
ATATTCCACATAGTGA-1_Br8667_Post_IF,1,3,1,0,0,5
TGGCAAACTAAATTAC-1_Br8667_Post_IF,2,2,0,0,0,4
ACCGCAATAACTGCCT-1_Br8667_Post_IF,3,2,0,0,0,5
TCGCACCAGGAGGCAG-1_Br8667_Post_IF,1,0,0,0,0,1
ACTTCAGGCTGATCCC-1_Br8667_Post_IF,4,2,1,0,0,7
ACAAATCGCACCGAAT-1_Br8667_Post_IF,0,4,0,1,0,5
TCTGATGTATTCTGTC-1_Br8667_Post_IF,2,6,0,0,0,8
CTTTACCGAATAGTAG-1_Br8667_Post_IF,0,1,0,0,1,2
GCAGATCCATAAGACT-1_Br8667_Post_IF,1,1,0,0,0,2
TTCCTCGGACTAACCA-1_Br8667_Post_IF,0,1,0,0,0,1
TTATCCGGGATCTATA-1_Br8667_Post_IF,1,3,0,1,0,5
CTGGAAGACACGGTGG-1_Br8667_Post_IF,1,0,0,0,0,1
GTTCGTCTAAAGAACT-1_Br8667_Post_IF,3,1,0,0,0,4
GTCTATTGGTTCCGGT-1_Br8667_Post_IF,11,1,0,0,0,12
CTAGGCGCCCTATCAG-1_Br8667_Post_IF,1,1,0,0,0,2
AACGGACGTACGTATA-1_Br8667_Post_IF,1,1,0,0,0,2
AACACACGCTCGCCGC-1_Br8667_Post_IF,3,2,1,0,0,6
GCTACTATAGTAGAGT-1_Br8667_Post_IF,2,2,0,0,1,5
AGCATATCAATATGCT-1_Br8667_Post_IF,2,1,0,0,0,3
CGAACAGTATGGGCGT-1_Br8667_Post_IF,4,0,0,0,0,4
ACAATTGTGTCTCTTT-1_Br8667_Post_IF,2,0,0,0,0,2
GATCGCTACCCGATTT-1_Br8667_Post_IF,1,1,0,0,0,2
ATTGCGATCAGTAACT-1_Br8667_Post_IF,1,0,1,0,0,2
CAGCAGTCCAGACTAT-1_Br8667_Post_IF,2,0,0,0,0,2
AGAGGCTTCGGAAACC-1_Br8667_Post_IF,2,0,1,0,0,3
AAACAAGTATCTCCCA-1_Br8667_Post_IF,0,0,0,0,1,1
GGCAGCAAACCTATGC-1_Br8667_Post_IF,0,0,0,0,1,1
ACTAGTTGCGATCGTC-1_Br8667_Post_IF,0,0,0,0,0,0
TTGGACCATCTGGCAA-1_Br8667_Post_IF,1,1,0,0,1,3
CCCTCCTCGCTCGTAT-1_Br8667_Post_IF,0,1,0,0,2,3
GAGCGCAAATACTCCG-1_Br8667_Post_IF,0,0,0,0,0,0
ATTACATGTCAGTCTT-1_Br8667_Post_IF,0,0,0,0,3,3
TTGGGACGTAAGAGTT-1_Br8667_Post_IF,0,0,0,0,1,1
CTTCGGCCAATTGTTT-1_Br8667_Post_IF,0,0,0,0,2,2
AGACCGCTCCGCGGTT-1_Br8667_Post_IF,1,0,2,0,1,4
GACCGCGTCTGACGTG-1_Br8667_Post_IF,0,0,0,0,0,0
CCAAATAACAAGATTC-1_Br8667_Post_IF,0,0,0,0,3,3
CTCCCAATGAGTCGCG-1_Br8667_Post_IF,11,0,0,1,0,12
CCTCAACGATCGCTGT-1_Br8667_Post_IF,2,1,0,0,0,3
CGGTACGGCAAACCCA-1_Br8667_Post_IF,1,1,0,0,0,2
CAGATGTTTGTCCCAA-1_Br8667_Post_IF,2,0,0,0,0,2
GTTTGTTAGCCAAGTA-1_Br8667_Post_IF,2,1,0,0,0,3
ACGTGACAAAGTAAGT-1_Br8667_Post_IF,0,0,0,0,0,0
TTGTCACCGCGGTATC-1_Br8667_Post_IF,0,2,0,0,0,2
GATCTAACCGTATTCA-1_Br8667_Post_IF,1,0,0,0,0,1
ATGGAAATTTAAGGAG-1_Br8667_Post_IF,2,4,1,1,0,8
ATTGATCACCACATTT-1_Br8667_Post_IF,0,0,0,0,0,0
ACTGCTCGGAAGGATG-1_Br8667_Post_IF,2,1,0,0,0,3
TCTAAAGAACAGTCTC-1_Br8667_Post_IF,3,0,0,0,0,3
CTGGGTTGAGTTAAAG-1_Br8667_Post_IF,2,1,0,0,0,3
CCCAGTAAACTTGGGA-1_Br8667_Post_IF,0,1,2,0,0,3
AGATTCACAACCGATA-1_Br8667_Post_IF,1,4,0,0,0,5
AGAAGGTACACTTCAC-1_Br8667_Post_IF,1,2,0,0,0,3
GCAGGAACTTAGATCT-1_Br8667_Post_IF,0,2,0,0,0,2
AATCTAGGTTTACTTG-1_Br8667_Post_IF,2,2,1,0,0,5
CCCGGTGTATCGGAAT-1_Br8667_Post_IF,1,0,0,0,0,1
TTATCCTCAAGGAATA-1_Br8667_Post_IF,2,2,1,0,0,5
AGCATCATTTCGAAAG-1_Br8667_Post_IF,3,2,2,0,0,7
CGCGAGTCTGCCGGGT-1_Br8667_Post_IF,1,0,0,0,0,1
TGCGTCATGACTGAGC-1_Br8667_Post_IF,2,0,0,0,0,2
GTATGAAATTTCACTC-1_Br8667_Post_IF,0,0,0,0,0,0
TTGGTTGCGGTGCGCG-1_Br8667_Post_IF,1,1,1,0,0,3
ACAGAACTGAGAACAA-1_Br8667_Post_IF,0,2,1,0,0,3
CTACTATCATAGGTTT-1_Br8667_Post_IF,2,2,0,0,0,4
CCTCTATCGATTAGCA-1_Br8667_Post_IF,3,1,0,0,0,4
CCGTATCTCGTCGTAG-1_Br8667_Post_IF,1,2,0,0,0,3
TCACGATGTCCGTGGA-1_Br8667_Post_IF,0,0,0,0,0,0
TCAACAAAGATAATTC-1_Br8667_Post_IF,1,1,0,0,0,2
ATGACGCGTTCTATCC-1_Br8667_Post_IF,2,1,0,0,0,3
ATTTGCGCGAGTAGCT-1_Br8667_Post_IF,3,1,0,0,0,4
TTCTTGGACGATCTGC-1_Br8667_Post_IF,3,1,0,0,0,4
AGACGACGATGCCGCT-1_Br8667_Post_IF,1,0,2,1,0,4
GGTCTCTGAATGGACT-1_Br8667_Post_IF,0,1,0,0,0,1
GCTCAATCCGTTTATT-1_Br8667_Post_IF,1,2,0,0,0,3
CCAGAAAGCAACTCAT-1_Br8667_Post_IF,1,1,0,0,0,2
CACCGTTAGGGATCAC-1_Br8667_Post_IF,1,2,0,0,0,3
AATAACACTAGAACAA-1_Br8667_Post_IF,2,3,0,1,0,6
CACCCGGTTTGTGACT-1_Br8667_Post_IF,1,1,0,0,0,2
CCACCAACTTTACTGT-1_Br8667_Post_IF,1,0,1,0,0,2
AACTCTCAGTGTGCTC-1_Br8667_Post_IF,1,1,0,0,0,2
AAACCGTTCGTCCAGG-1_Br8667_Post_IF,1,0,0,0,0,1
CAGCGATTCCCTTCAA-1_Br8667_Post_IF,0,0,1,0,0,1
GCTAGCTTGAATAGCT-1_Br8667_Post_IF,1,0,1,0,0,2
TTGCGGCATCAGAAAG-1_Br8667_Post_IF,0,0,0,0,0,0
AATAGAACAGAGTGGC-1_Br8667_Post_IF,2,1,0,0,0,3
GCCATCGAGCTGCGTG-1_Br8667_Post_IF,3,1,0,0,0,4
ACACTGATCAAGGTGT-1_Br8667_Post_IF,4,3,0,0,0,7
ACCAACGCTTATTTAT-1_Br8667_Post_IF,2,4,0,0,0,6
GACATCGATTTATAAC-1_Br8667_Post_IF,0,4,0,0,0,4
CAGACACCGATCGCTG-1_Br8667_Post_IF,5,2,1,0,0,8
CCAAGAAAGTGGGCGA-1_Br8667_Post_IF,1,0,0,0,0,1
GGTAGACCGTTGGGCG-1_Br8667_Post_IF,4,3,0,0,0,7
TCGTTAGGAGTCCCTA-1_Br8667_Post_IF,4,1,0,0,0,5
ACGGCCAACATGGACT-1_Br8667_Post_IF,2,0,0,0,0,2
GTGAGTGGTACAACGC-1_Br8667_Post_IF,1,0,0,0,0,1
GAGACTTCGCGACCGA-1_Br8667_Post_IF,1,0,0,0,0,1
GAAGTCAGTTGCACTA-1_Br8667_Post_IF,0,1,0,0,0,1
GTTTGGTAGGGTCAAC-1_Br8667_Post_IF,1,1,1,0,0,3
ACGGCACTTGCTTGGG-1_Br8667_Post_IF,2,1,0,0,0,3
CCTCTGTACTATTCTA-1_Br8667_Post_IF,0,1,0,0,0,1
CTATTCATGTGTCCCA-1_Br8667_Post_IF,3,1,2,0,0,6
GCCCGATCTGTGGTCG-1_Br8667_Post_IF,2,0,0,0,0,2
TTAGAAGAACATGACT-1_Br8667_Post_IF,1,0,0,0,0,1
AGGATAAAGTCGGGAT-1_Br8667_Post_IF,1,1,0,0,0,2
CGGCAAACATCGTGCG-1_Br8667_Post_IF,3,0,0,0,0,3
CTAGTTACAACCCGGT-1_Br8667_Post_IF,1,1,1,0,0,3
TTCGACAGAGCCCGTG-1_Br8667_Post_IF,6,1,0,0,0,7
AAGCATACTCTCCTGA-1_Br8667_Post_IF,2,2,0,0,0,4
GACGACGATCCGCGTT-1_Br8667_Post_IF,2,2,2,0,0,6
GGTAGAAGACCGCCTG-1_Br8667_Post_IF,5,0,0,0,0,5
GAGATGGGAGTCGACA-1_Br8667_Post_IF,2,2,1,0,0,5
AACGATAATGCCGTAG-1_Br8667_Post_IF,1,1,1,0,0,3
TGGTCCCACGCTACGG-1_Br8667_Post_IF,4,1,0,0,0,5
CTGCTTGGCGATAGCT-1_Br8667_Post_IF,3,1,0,0,0,4
ATCGGAGACAGACGGC-1_Br8667_Post_IF,2,1,0,0,0,3
TAGCGTCCGGTGTGGT-1_Br8667_Post_IF,2,2,0,0,0,4
GTTGAGTCCCGCCGGT-1_Br8667_Post_IF,2,1,1,0,0,4
AAATAGGGTGCTATTG-1_Br8667_Post_IF,6,1,1,0,0,8
AAGTGTTTGGAGACGG-1_Br8667_Post_IF,2,1,0,0,0,3
AGCACTACCTCACCAG-1_Br8667_Post_IF,1,1,0,0,0,2
TGCCTTGGCCAGGCAA-1_Br8667_Post_IF,0,0,0,0,0,0
TCGTCTTAGGCGTTAA-1_Br8667_Post_IF,3,2,0,0,0,5
TTCTGACCGGGCTCAA-1_Br8667_Post_IF,3,0,0,0,0,3
CAGAACTTAGCCCTCT-1_Br8667_Post_IF,1,2,0,0,0,3
AGCTCCTTCGCACATC-1_Br8667_Post_IF,1,2,0,0,0,3
ACAGGCTTGCCCGACT-1_Br8667_Post_IF,1,2,0,0,0,3
GCTATACGTCTCGGAC-1_Br8667_Post_IF,3,0,0,0,0,3
GAGCCAGCTACCTGTG-1_Br8667_Post_IF,0,2,1,0,0,3
TGCTAAGTGTCTATTT-1_Br8667_Post_IF,1,2,0,0,0,3
GTCCTACGAATAGTCT-1_Br8667_Post_IF,2,1,1,0,1,5
CAGTGTCGGCTGGCCC-1_Br8667_Post_IF,2,1,0,0,0,3
CTATCGACGAAATACA-1_Br8667_Post_IF,1,1,0,1,0,3
CATCATTACCCTGAGG-1_Br8667_Post_IF,3,1,0,0,0,4
TAAGTTGCGACGTAGG-1_Br8667_Post_IF,0,2,0,0,0,2
AGTGCACGCTTAAGAA-1_Br8667_Post_IF,4,0,0,0,0,4
TGTGCCGGTGCCGGAA-1_Br8667_Post_IF,2,0,0,0,0,2
AGGAGGCCTTCGCGCG-1_Br8667_Post_IF,1,1,1,0,0,3
TCCGCGGCCCAATGAA-1_Br8667_Post_IF,2,1,0,0,0,3
TCCGTTAAGCTAATAT-1_Br8667_Post_IF,2,3,0,0,0,5
AAATCTAGCCCTGCTA-1_Br8667_Post_IF,3,1,0,0,1,5
CGCAGGCGATCCAAAC-1_Br8667_Post_IF,5,1,0,1,0,7
CCATATGGAAACTATA-1_Br8667_Post_IF,2,2,0,0,0,4
CACCGTATCCCATCCG-1_Br8667_Post_IF,1,0,0,0,1,2
GGTCAAGACTACTTCG-1_Br8667_Post_IF,3,0,2,0,0,5
CCCGTTTCGCAGATGT-1_Br8667_Post_IF,0,0,0,0,0,0
GTTATAATACGGTGAA-1_Br8667_Post_IF,3,2,0,0,0,5
ACTTGTGGATGGAACG-1_Br8667_Post_IF,3,0,1,0,1,5
GTTCGCTGAGACGTCT-1_Br8667_Post_IF,1,1,0,1,0,3
GACACTGGAACCCGAT-1_Br8667_Post_IF,0,0,0,0,0,0
CCCAGGTCTGAAGGCT-1_Br8667_Post_IF,1,1,0,0,0,2
TCTCGAGGAGGTTCGC-1_Br8667_Post_IF,1,0,0,0,3,4
ACTATCTGCCCGCGTA-1_Br8667_Post_IF,0,0,1,1,1,3
CCTAAATTGTATCCTA-1_Br8667_Post_IF,0,0,0,0,5,5
TGTGCCAGAGGCAAAG-1_Br8667_Post_IF,2,2,0,0,0,4
TGGCTTATGTATAATG-1_Br8667_Post_IF,2,0,0,0,0,2
GCAAGCTGGAAACCGC-1_Br8667_Post_IF,2,3,0,0,0,5
GATATCAAGCAGGAGC-1_Br8667_Post_IF,3,2,0,0,0,5
CACCAATCATCCGTCT-1_Br8667_Post_IF,1,1,0,0,0,2
CCACATGGCTCTTTAT-1_Br8667_Post_IF,0,1,0,0,0,1
GTCCTACTCTACGGGC-1_Br8667_Post_IF,1,2,0,0,0,3
CTCGAGACATACGATA-1_Br8667_Post_IF,2,1,0,0,0,3
TATCAGTGGCGTAGTC-1_Br8667_Post_IF,3,1,0,0,0,4
TGACAGGACAAGTCCA-1_Br8667_Post_IF,0,1,1,0,0,2
TATTAACACCAAAGCA-1_Br8667_Post_IF,2,1,0,0,0,3
TAGGCGATGAGGTCTC-1_Br8667_Post_IF,1,1,0,0,0,2
CCGCCGGAACTTCTCG-1_Br8667_Post_IF,1,1,0,1,0,3
GCCATTAGCCTCAAAC-1_Br8667_Post_IF,1,0,1,0,0,2
GTTAGGCTACCCGTTT-1_Br8667_Post_IF,0,1,1,0,0,2
GGGTATTCTAGCAAAC-1_Br8667_Post_IF,2,3,2,0,0,7
GCCCTAGCCGTCGCGA-1_Br8667_Post_IF,2,0,0,0,0,2
CAGATCCTGGTTTGAA-1_Br8667_Post_IF,2,1,0,0,0,3
CTTCAGTGGTCGCCTA-1_Br8667_Post_IF,2,0,0,1,0,3
GGGCAACCGCACGTGC-1_Br8667_Post_IF,1,2,2,0,0,5
GACCCAATTATGATAC-1_Br8667_Post_IF,1,1,0,0,0,2
GAAGCTCGGACCCGTC-1_Br8667_Post_IF,3,0,0,0,0,3
CGTCGGGTCTAAGCGC-1_Br8667_Post_IF,0,0,0,0,0,0
GAGGCCCGACTCCGCA-1_Br8667_Post_IF,0,0,0,0,0,0
TTGCCATAGCCCGCTC-1_Br8667_Post_IF,0,1,0,0,0,1
TAACATACACGCGATC-1_Br8667_Post_IF,2,1,1,0,0,4
CCGACGGGCATGAGGT-1_Br8667_Post_IF,2,2,2,0,0,6
AATGTGCCCGAGGTGT-1_Br8667_Post_IF,1,0,0,0,0,1
AGCTGTAACCTCAATC-1_Br8667_Post_IF,2,0,1,0,0,3
CGAGTGAAGGTACCAG-1_Br8667_Post_IF,1,0,0,0,0,1
AGTCTCACAAGACTAC-1_Br8667_Post_IF,1,1,1,0,0,3
AAATTGATAGTCCTTT-1_Br8667_Post_IF,6,0,0,0,0,6
TAAGTCGCCGAGTATC-1_Br8667_Post_IF,0,0,0,0,0,0
GCGGAGAAACTTCGCA-1_Br8667_Post_IF,3,2,0,0,0,5
GGCAAAGGCGCCAATA-1_Br8667_Post_IF,2,0,1,0,0,3
ATTTCCGGGTTCTGCG-1_Br8667_Post_IF,2,0,0,0,1,3
TAAACCCAGGAGGGCA-1_Br8667_Post_IF,1,0,0,0,0,1
TTCGGGCGCTAGTCTT-1_Br8667_Post_IF,2,2,0,0,0,4
GTGGAGTCGGCGGTTG-1_Br8667_Post_IF,2,0,1,0,0,3
GCACGCCTACTTAGAT-1_Br8667_Post_IF,1,1,0,0,0,2
CAATATTCTTGACCTA-1_Br8667_Post_IF,1,2,0,0,0,3
CGTTTGTGTAGAGGGT-1_Br8667_Post_IF,2,1,0,0,0,3
CATAGCGTTGCCCACC-1_Br8667_Post_IF,3,0,0,0,0,3
TGATACATTTAGCCGT-1_Br8667_Post_IF,3,0,0,0,0,3
TTCCGGCCTTGAGGCT-1_Br8667_Post_IF,0,0,0,0,0,0
CCTATACCGTCCTGTC-1_Br8667_Post_IF,1,0,0,0,0,1
TCGTTGCTATCCGGTC-1_Br8667_Post_IF,4,1,1,0,0,6
TGGCGACTGCTCCAAA-1_Br8667_Post_IF,0,1,0,1,0,2
CAGAGGCGATGCATGA-1_Br8667_Post_IF,0,0,0,0,0,0
TCACAGGAGAATAAGA-1_Br8667_Post_IF,2,0,0,0,0,2
GGGTTAACATTTGAGT-1_Br8667_Post_IF,1,0,1,0,0,2
GCGGGCGAGCCTTACC-1_Br8667_Post_IF,1,3,1,0,0,5
TGCCAATGGGTACTCT-1_Br8667_Post_IF,2,1,2,0,0,5
AGGGACTCTACGCGAC-1_Br8667_Post_IF,1,2,0,0,0,3
GACGCCGTAAAGGCTA-1_Br8667_Post_IF,2,1,0,0,0,3
AAAGGCTCTCGCGCCG-1_Br8667_Post_IF,3,0,0,0,0,3
CTGGCTGGTTGTCAGT-1_Br8667_Post_IF,0,0,0,0,0,0
ACATCCCGGCCATACG-1_Br8667_Post_IF,2,0,0,0,0,2
CTCTTGTCCCGCTTGG-1_Br8667_Post_IF,5,1,0,0,0,6
TACGCCTCCATTCCGA-1_Br8667_Post_IF,1,1,0,0,0,2
CGGAGCAATTTAATCG-1_Br8667_Post_IF,4,1,1,0,0,6
AACTAGGCTTGGGTGT-1_Br8667_Post_IF,0,2,1,0,0,3
GCGTCGCCAGGGTGAT-1_Br8667_Post_IF,2,1,2,0,0,5
GTTGGTCATGCTATCC-1_Br8667_Post_IF,1,0,0,0,0,1
GCTGGCGGCGCATGCT-1_Br8667_Post_IF,3,0,0,0,0,3
TGAGCGGAAAGTGTTC-1_Br8667_Post_IF,2,0,1,0,0,3
CTTTCTGTGCGGGCTT-1_Br8667_Post_IF,1,1,1,0,0,3
ATCTAATATCCTACGG-1_Br8667_Post_IF,3,0,0,0,0,3
AACCTTTAAATACGGT-1_Br8667_Post_IF,3,0,0,0,0,3
TTCACTCGAGCACCTA-1_Br8667_Post_IF,3,1,1,0,0,5
CTGCACTCCAGTACAG-1_Br8667_Post_IF,1,0,1,0,0,2
CCATTTCTACCTATTA-1_Br8667_Post_IF,1,1,1,0,0,3
CAAGCGGCACATAATT-1_Br8667_Post_IF,0,1,1,0,0,2
GTTAACATCACTTAAA-1_Br8667_Post_IF,2,1,1,0,0,4
ATATAAATGTAGCTGC-1_Br8667_Post_IF,3,2,1,0,0,6
GCCTCTATACATAGCA-1_Br8667_Post_IF,3,2,0,0,0,5
GTGTCGTATAGCGTTC-1_Br8667_Post_IF,2,1,0,0,0,3
ATACGTACTTAGCCAC-1_Br8667_Post_IF,0,1,1,0,0,2
GCTATCATACTCATGG-1_Br8667_Post_IF,3,0,2,0,0,5
TATCCAATTGGTTATC-1_Br8667_Post_IF,0,0,0,0,0,0
TCTCCCTGGGCAGCGT-1_Br8667_Post_IF,1,0,0,0,0,1
CCTATAATGAGTGCCC-1_Br8667_Post_IF,1,1,0,0,0,2
CAATGCGAGAAGTATC-1_Br8667_Post_IF,1,0,0,0,0,1
TACCAATAAAGTACCA-1_Br8667_Post_IF,1,1,0,0,0,2
GCTAGGCACCACGGAG-1_Br8667_Post_IF,3,2,0,0,0,5
GGTGGACTGCTCTGGC-1_Br8667_Post_IF,4,0,0,0,0,4
TATTCCGAGCTGTTAT-1_Br8667_Post_IF,1,1,0,0,0,2
TTGAGAAGTTTAGCAT-1_Br8667_Post_IF,4,2,0,0,0,6
GTCCGGACCTGAAATT-1_Br8667_Post_IF,2,1,2,0,0,5
CTGTGGTCGGGAGATA-1_Br8667_Post_IF,3,1,1,0,0,5
CATGTAAGAGACATTT-1_Br8667_Post_IF,2,2,0,0,0,4
CACGTTTCGTACACAC-1_Br8667_Post_IF,0,0,0,0,0,0
CATCCTCTCAAAGATC-1_Br8667_Post_IF,0,5,0,0,0,5
GATTAACCGAAAGCCC-1_Br8667_Post_IF,1,0,0,1,0,2
AACGCTGTTGCTGAAA-1_Br8667_Post_IF,0,1,0,0,0,1
TTCAGCTGGCGTGCCC-1_Br8667_Post_IF,3,0,0,0,0,3
TAGAGGTTCTACTTGT-1_Br8667_Post_IF,1,2,0,0,0,3
GTATCAAACGTTAGCT-1_Br8667_Post_IF,1,1,0,1,0,3
AATCATGTAAAGACTC-1_Br8667_Post_IF,0,0,1,1,0,2
AGTCACTAGCTCTCGA-1_Br8667_Post_IF,2,1,2,0,0,5
GCGAAACGATCGGGAG-1_Br8667_Post_IF,1,2,0,0,0,3
CATGGATTGTCTTCCG-1_Br8667_Post_IF,2,2,0,0,0,4
ATTGGATTACAGCGTA-1_Br8667_Post_IF,4,2,0,2,0,8
CACACACGCTAACGAG-1_Br8667_Post_IF,2,0,0,1,0,3
CTATGGGAAGCGGAAT-1_Br8667_Post_IF,1,3,1,0,0,5
TGCCTAATTGAAGATT-1_Br8667_Post_IF,3,2,1,0,0,6
TGGCAATGGGACGGCG-1_Br8667_Post_IF,3,3,0,0,1,7
ACCTCCGCCCTCGCTG-1_Br8667_Post_IF,2,5,1,0,0,8
CGGCAATAAGATCGCC-1_Br8667_Post_IF,1,1,0,0,0,2
CCTTGACCACTTTATT-1_Br8667_Post_IF,0,5,0,2,1,8
TCATTTAGAAGTGTGA-1_Br8667_Post_IF,5,4,0,1,0,10
CAGAATAACACACGGA-1_Br8667_Post_IF,0,0,0,0,0,0
TCTGAGCAATTGACTG-1_Br8667_Post_IF,1,0,0,2,0,3
CACAGTTCGCTTCCCA-1_Br8667_Post_IF,0,0,0,0,0,0
CATACACAAAGTCAGC-1_Br8667_Post_IF,2,1,1,0,0,4
TGCCGTTCTTAATCGG-1_Br8667_Post_IF,3,1,0,0,0,4
TCGAGTCTACGATTCG-1_Br8667_Post_IF,2,0,0,0,0,2
ACTTCCAGTGGAAGCT-1_Br8667_Post_IF,3,1,0,0,0,4
CAATTGGGCCGCACTC-1_Br8667_Post_IF,2,1,0,0,0,3
AAATCGCGGAAGGAGT-1_Br8667_Post_IF,2,1,0,0,0,3
ATATCAATTCCAGCCT-1_Br8667_Post_IF,2,3,0,0,0,5
CTTTGTCGAATGCTCC-1_Br8667_Post_IF,0,0,2,0,0,2
TGAGGCATGTACTGTG-1_Br8667_Post_IF,1,0,0,0,0,1
TTCGCCGCTCGCGCTA-1_Br8667_Post_IF,1,0,0,0,0,1
GACTCCTTCCAATTGA-1_Br8667_Post_IF,2,0,1,0,0,3
ACCGAAGAGTCTGGTT-1_Br8667_Post_IF,1,1,2,0,0,4
TGGCATGAAGTTTGGG-1_Br8667_Post_IF,3,3,0,0,0,6
ACGAGGTTTACAACGT-1_Br8667_Post_IF,2,2,0,0,0,4
AACCCATCCCATGATC-1_Br8667_Post_IF,3,1,0,0,0,4
TCGACAACTGAACCCG-1_Br8667_Post_IF,4,1,1,0,0,6
TATCTTGCAATACAAC-1_Br8667_Post_IF,4,1,1,0,0,6
TATTATGTTTGCCTGC-1_Br8667_Post_IF,6,0,0,0,0,6
GTCAAAGAAGTGGTGT-1_Br8667_Post_IF,6,0,0,0,0,6
GGGACAGAGTTACTCC-1_Br8667_Post_IF,0,2,0,0,0,2
AGCAACCGAAAGTAAT-1_Br8667_Post_IF,3,2,2,0,0,7
CTCTCTAACTGCCTAG-1_Br8667_Post_IF,1,0,0,0,0,1
ATACGGAACGTCGTTT-1_Br8667_Post_IF,1,1,0,0,0,2
TCGGTCCCGACAATAG-1_Br8667_Post_IF,1,1,0,0,0,2
CGCGCAAATGTCCAGA-1_Br8667_Post_IF,2,4,1,0,0,7
TCTAATACTGCCTCAG-1_Br8667_Post_IF,2,0,0,0,0,2
CTCGGTTGTCGGCCCT-1_Br8667_Post_IF,2,0,0,0,0,2
GGTAACCGGGAGGATA-1_Br8667_Post_IF,0,1,0,0,0,1
CAGGCGCACGGTGGTC-1_Br8667_Post_IF,2,1,0,0,0,3
TCATCGATGGTCCCAA-1_Br8667_Post_IF,1,1,1,0,0,3
CAAAGATTATTGGGCC-1_Br8667_Post_IF,2,1,0,0,0,3
ACAATGAATACGGAGA-1_Br8667_Post_IF,1,0,0,0,0,1
GCTCCTGACATACTGG-1_Br8667_Post_IF,1,0,0,0,0,1
GATGACAAGTAGGGCA-1_Br8667_Post_IF,4,0,1,0,0,5
TACGCCGAGGGTACCC-1_Br8667_Post_IF,3,2,0,0,0,5
AAGCGTCCCTCATCGA-1_Br8667_Post_IF,3,0,0,0,0,3
CACTCCTATGTAAGAT-1_Br8667_Post_IF,3,2,1,0,0,6
TCGAGCCAGGCAGGCC-1_Br8667_Post_IF,3,2,0,0,0,5
TCGTCAAGTACGCGCA-1_Br8667_Post_IF,1,0,0,0,0,1
CCCGTAGCTGGGAAGA-1_Br8667_Post_IF,2,1,0,0,0,3
ACCCTATGCCATATCG-1_Br8667_Post_IF,3,0,1,0,0,4
GTGGTATAGTCTGCCG-1_Br8667_Post_IF,3,0,0,0,0,3
CCGGTTTGTAATTGTG-1_Br8667_Post_IF,1,2,2,0,0,5
GTCGCCGTTGTGTGTT-1_Br8667_Post_IF,0,1,0,0,0,1
TACTGAACAGATTTAG-1_Br8667_Post_IF,1,1,1,0,0,3
TATTAACCTGACCGCG-1_Br8667_Post_IF,1,3,0,0,0,4
CTGTAGCCATCTCACT-1_Br8667_Post_IF,2,1,0,0,0,3
TACTATGGTTCCTCAG-1_Br8667_Post_IF,2,1,1,0,0,4
GAGTCAGACCAGAATC-1_Br8667_Post_IF,5,0,0,0,0,5
TAAGGCATAACATCAA-1_Br8667_Post_IF,2,0,0,0,0,2
CTTCCGCTCCGTGAAG-1_Br8667_Post_IF,2,0,0,0,0,2
GGGCTATGATCGATGG-1_Br8667_Post_IF,2,1,0,0,0,3
GGTCGGTCGTCCACAG-1_Br8667_Post_IF,1,0,0,0,0,1
GGGACCCGTATATCTT-1_Br8667_Post_IF,2,1,0,1,0,4
GAAAGCAGTGCACTTT-1_Br8667_Post_IF,2,0,0,0,0,2
AGCGCATAATGAATCG-1_Br8667_Post_IF,2,1,0,1,0,4
GCTGCTAAGTAGTCGA-1_Br8667_Post_IF,4,1,1,0,0,6
AATAGTCCGTCCCGAC-1_Br8667_Post_IF,0,0,2,0,0,2
AGCAGCCAGATGAATA-1_Br8667_Post_IF,0,2,0,1,0,3
CCTCGCGCTGTGCGAT-1_Br8667_Post_IF,2,0,0,0,0,2
TTGTGTATGCCACCAA-1_Br8667_Post_IF,0,0,1,0,0,1
TGCTCGGCGAAACCCA-1_Br8667_Post_IF,2,0,0,0,0,2
CGATTAAATATCTCCT-1_Br8667_Post_IF,1,0,0,0,0,1
TGCCGTGGATCGTCCT-1_Br8667_Post_IF,2,0,1,0,0,3
GTGGACGCATTTGTCC-1_Br8667_Post_IF,2,0,0,0,0,2
ACCCGGAAACTCCCAG-1_Br8667_Post_IF,3,0,0,0,0,3
CCGCATGTGGTACGAT-1_Br8667_Post_IF,1,0,0,0,0,1
GCAAACCTTGGCCATA-1_Br8667_Post_IF,3,0,2,0,0,5
ATTCACTGATGTTGGA-1_Br8667_Post_IF,3,0,0,0,0,3
ACTCCCTAATGCTAAA-1_Br8667_Post_IF,2,1,0,0,0,3
TCCTAAATTGGGAAGC-1_Br8667_Post_IF,1,0,1,1,0,3
GAACAGATTACTAAAT-1_Br8667_Post_IF,3,0,0,0,0,3
ATACAGGCCCTCCAAT-1_Br8667_Post_IF,4,0,2,0,0,6
CGATTCGCCTGGCTGC-1_Br8667_Post_IF,1,0,0,0,0,1
TCCGCCTGTCTACAAG-1_Br8667_Post_IF,3,0,0,0,0,3
CACATCTCACCGACGA-1_Br8667_Post_IF,1,0,0,0,0,1
CGTCGTCCTTCGCGAA-1_Br8667_Post_IF,1,2,0,0,0,3
CGTTGAATACCGCGCT-1_Br8667_Post_IF,4,3,1,0,0,8
ACCAATATGCAAGTTA-1_Br8667_Post_IF,1,1,1,1,0,4
ACGGATGGTGCGGATA-1_Br8667_Post_IF,2,1,1,0,0,4
CACCCTAACAAGATCT-1_Br8667_Post_IF,0,0,1,0,0,1
AAGCTCTTTCATGGTG-1_Br8667_Post_IF,1,3,0,0,0,4
CATGGGTATGCCTTAT-1_Br8667_Post_IF,3,2,0,0,0,5
GCGCGTCATTGGTACA-1_Br8667_Post_IF,1,0,0,0,0,1
TCTGAAGCACGTGGTC-1_Br8667_Post_IF,2,2,0,0,0,4
AAGTTCACTCCAAGCT-1_Br8667_Post_IF,1,1,0,0,0,2
TTGGACCTATAACAGT-1_Br8667_Post_IF,1,3,0,0,0,4
ATCAGCCTCATGCTGC-1_Br8667_Post_IF,0,0,0,0,0,0
AGTACTCTTATGCCCA-1_Br8667_Post_IF,4,1,0,0,0,5
GCGCTTAAATAATTGG-1_Br8667_Post_IF,2,2,0,0,0,4
TTGTGAACCTAATCCG-1_Br8667_Post_IF,8,0,0,0,0,8
AGTCGTCGACCACCAA-1_Br8667_Post_IF,3,1,2,0,0,6
TCCTTTAAATCCGCTT-1_Br8667_Post_IF,3,0,0,0,0,3
ACTGAAACGCCGTTAG-1_Br8667_Post_IF,2,2,0,0,0,4
GCACACACTGGTAGCC-1_Br8667_Post_IF,0,2,0,0,0,2
TAAGGGCCTGTCCGAT-1_Br8667_Post_IF,2,1,0,0,0,3
GCTAGAGTAGAGATGT-1_Br8667_Post_IF,2,0,0,0,0,2
CACAGGGCCATATAGT-1_Br8667_Post_IF,2,1,0,0,0,3
CCATGCCCTAGATTTC-1_Br8667_Post_IF,2,0,1,0,0,3
TCGCGTAGCAGTGTCC-1_Br8667_Post_IF,0,1,0,0,0,1
GACGAGGCTAATAAAC-1_Br8667_Post_IF,3,0,0,0,0,3
CTACACTCGCAGATGG-1_Br8667_Post_IF,2,0,0,0,0,2
ACGCATACGTTTACTA-1_Br8667_Post_IF,2,4,0,0,0,6
GGAGCAACATTTCAAG-1_Br8667_Post_IF,1,2,2,1,0,6
CGAGAGGGTAGCCGCG-1_Br8667_Post_IF,1,1,0,0,0,2
TCGTGTTCGACCACAA-1_Br8667_Post_IF,1,1,0,0,0,2
TCTACCCAATAGAGAG-1_Br8667_Post_IF,3,0,2,0,0,5
ATAAACGTTGCACCAC-1_Br8667_Post_IF,1,5,1,1,0,8
TCAACTGCAGAGTCAG-1_Br8667_Post_IF,0,7,0,2,0,9
GTAACATCTAAGATAA-1_Br8667_Post_IF,0,0,0,0,0,0
ATTTGGAGATTGCGGT-1_Br8667_Post_IF,2,2,0,0,0,4
AAGGGTTTGATTTCAG-1_Br8667_Post_IF,1,2,1,0,0,4
CCGGCCGCGAGCATAT-1_Br8667_Post_IF,2,0,1,0,0,3
GAGTTCTGTGGGTGCT-1_Br8667_Post_IF,0,0,1,0,0,1
AAACGAAGATGGAGTA-1_Br8667_Post_IF,0,0,0,0,0,0
AATTACGAGACCCATC-1_Br8667_Post_IF,0,0,0,0,0,0
CCTTTGAATTATGGCT-1_Br8667_Post_IF,1,2,2,0,0,5
CATGGTATTAGTTTGT-1_Br8667_Post_IF,2,0,0,1,0,3
AACGAAAGTCGTCCCA-1_Br8667_Post_IF,3,0,0,0,0,3
ACATAAGTCGTGGTGA-1_Br8667_Post_IF,3,0,0,0,0,3
GCACAACCTCGGGCGT-1_Br8667_Post_IF,2,0,0,0,0,2
ATGCACGCGCTGTTCA-1_Br8667_Post_IF,2,2,0,0,0,4
CGATGTTGTTATCTAC-1_Br8667_Post_IF,0,0,0,0,0,0
GTCTCCTGCCAGTATG-1_Br8667_Post_IF,2,1,4,0,0,7
GATGCCTTCTGCGGCA-1_Br8667_Post_IF,0,1,0,0,0,1
ACCGGTCAGGTACACC-1_Br8667_Post_IF,2,1,1,0,0,4
GTGGAGCGTTTACCGA-1_Br8667_Post_IF,2,2,1,0,0,5
AGGCGGTTTGTCCCGC-1_Br8667_Post_IF,0,3,0,0,0,3
TCCCTGGCGTATTAAC-1_Br8667_Post_IF,1,0,0,0,0,1
AAACACCAATAACTGC-1_Br8667_Post_IF,5,1,0,0,0,6
TGGACGCAATCCAGCC-1_Br8667_Post_IF,1,2,0,0,0,3
GGAACCTTGACTCTGC-1_Br8667_Post_IF,1,1,0,1,0,3
GTATCTCAGTCTTGAC-1_Br8667_Post_IF,2,1,1,0,0,4
GCTGAATCTTCCAATC-1_Br8667_Post_IF,0,3,0,0,0,3
AGATGCAAGACGTGCA-1_Br8667_Post_IF,2,1,1,0,0,4
TTAAGGCCCGTACTTT-1_Br8667_Post_IF,4,0,2,0,0,6
AGTATGCTGGAGACCA-1_Br8667_Post_IF,0,0,0,0,0,0
GCGGCAAAGTATTGCC-1_Br8667_Post_IF,3,0,0,0,0,3
GCGCAAATATATTCAA-1_Br8667_Post_IF,1,0,0,0,0,1
GAAGAAACGATATTGT-1_Br8667_Post_IF,4,0,0,0,0,4
GGACCTCTAGGCCGCC-1_Br8667_Post_IF,3,1,0,0,0,4
AACAGCTGTGTGGCAA-1_Br8667_Post_IF,1,0,0,0,0,1
TCGAATATCCCGCAGG-1_Br8667_Post_IF,4,1,0,0,0,5
GCGACCCAACCATCTG-1_Br8667_Post_IF,0,0,0,0,0,0
AGAGAAGGAGTACAAT-1_Br8667_Post_IF,3,0,0,0,0,3
GGCTCCTCCACCTGTT-1_Br8667_Post_IF,1,2,1,0,0,4
TCAGTGTATACGTCAT-1_Br8667_Post_IF,1,1,0,0,0,2
ATTATTATGTCCGTCA-1_Br8667_Post_IF,3,1,1,1,0,6
TTAGGTCATAACCGAC-1_Br8667_Post_IF,1,1,0,0,0,2
AAGATGGCACCGGACC-1_Br8667_Post_IF,1,1,1,0,0,3
CTACAAGAAATAACCC-1_Br8667_Post_IF,0,2,0,0,0,2
ACTATTTCCGGGCCCA-1_Br8667_Post_IF,3,1,0,0,0,4
TTGTTTCACATCCAGG-1_Br8667_Post_IF,5,2,0,0,0,7
CGCTGTGTGGATGTTG-1_Br8667_Post_IF,1,1,0,0,0,2
TCAACATAGCGCCCTA-1_Br8667_Post_IF,0,4,1,0,0,5
GGCCGTTTGGGTTTCA-1_Br8667_Post_IF,3,1,0,0,0,4
TACTCTTTCGTCTTCA-1_Br8667_Post_IF,2,3,1,0,0,6
TTCGCGCGCCATACGA-1_Br8667_Post_IF,2,0,0,0,0,2
CGGAAAGAATCAAACG-1_Br8667_Post_IF,3,0,2,0,0,5
AGGCAGGGAGCGTACT-1_Br8667_Post_IF,2,0,0,0,0,2
CCTTTAAGGGAGCACT-1_Br8667_Post_IF,1,0,0,0,0,1
CGCCCAGCACGCCTAG-1_Br8667_Post_IF,1,1,1,0,0,3
AGTATTTGGCACGACC-1_Br8667_Post_IF,0,1,1,0,0,2
TATCCGCACCGTCGGG-1_Br8667_Post_IF,2,0,0,1,0,3
ACCCGTGTCATCAGTA-1_Br8667_Post_IF,2,0,0,0,0,2
CAACTGCTCATCCGAT-1_Br8667_Post_IF,5,1,0,0,0,6
CCGGAGCGTACTTTCT-1_Br8667_Post_IF,2,0,0,0,0,2
TACCGTAGGTTAACTA-1_Br8667_Post_IF,0,0,0,0,0,0
TGAGGAGTGCCAGCTT-1_Br8667_Post_IF,0,0,2,0,0,2
CCAGTCTTGTCATAGA-1_Br8667_Post_IF,2,0,0,0,0,2
GGGCAGAGCAATCGTT-1_Br8667_Post_IF,2,0,0,0,0,2
TACCAAATAGCCCAGA-1_Br8667_Post_IF,5,0,1,0,0,6
TACCTACTCCCAGTAT-1_Br8667_Post_IF,3,1,0,0,0,4
TGTGAGACTAGCCCAA-1_Br8667_Post_IF,2,0,0,0,0,2
ATACCTAACCAAGAAA-1_Br8667_Post_IF,3,1,1,0,0,5
GTCGGGAAGCAGAAAC-1_Br8667_Post_IF,3,3,2,0,0,8
AATTAACGGATTTCCA-1_Br8667_Post_IF,1,0,0,0,0,1
GAACCCTCTGTGTTCT-1_Br8667_Post_IF,3,0,0,1,0,4
ATATAAAGCGCTCGTG-1_Br8667_Post_IF,3,2,0,0,0,5
CCTGGTCGAATGTGGG-1_Br8667_Post_IF,3,2,2,0,0,7
CTAGGTTCGGACGTGA-1_Br8667_Post_IF,5,0,0,0,0,5
TCGGGAGACAGCGTAC-1_Br8667_Post_IF,3,0,1,0,0,4
CATAAGAAGCTTGGCT-1_Br8667_Post_IF,2,3,0,0,0,5
AAGCACCCTGCGTATC-1_Br8667_Post_IF,2,1,1,1,0,5
AGTTTGCACCTGCCTC-1_Br8667_Post_IF,3,1,1,1,0,6
GACTGCAAATCGAGCT-1_Br8667_Post_IF,2,0,2,0,0,4
GTGTATATCAGCGGGC-1_Br8667_Post_IF,3,1,1,0,0,5
CTTCAACTCCACTTGG-1_Br8667_Post_IF,0,0,0,0,0,0
ACTTACGCATCCACGC-1_Br8667_Post_IF,2,0,1,0,0,3
CATGAGATGCACTCTC-1_Br8667_Post_IF,1,1,3,0,0,5
GAGCACCTGTGTCCAG-1_Br8667_Post_IF,4,0,0,0,0,4
CGCGACCGCGACAGAT-1_Br8667_Post_IF,2,3,1,0,0,6
GTCCCGCGACGTTATG-1_Br8667_Post_IF,2,0,2,0,0,4
GCAGTGTGGCTATAGG-1_Br8667_Post_IF,5,1,0,0,0,6
ATACTGCCTTACACCG-1_Br8667_Post_IF,2,1,1,0,0,4
TACAGAAACGGTGGGC-1_Br8667_Post_IF,2,3,1,0,0,6
GGCGCGGAGATCTTTC-1_Br8667_Post_IF,4,0,0,0,0,4
CGTTAATGTCCCGACG-1_Br8667_Post_IF,1,0,0,0,0,1
GCTAACTGAAGTCTGA-1_Br8667_Post_IF,3,2,0,0,0,5
AGTGATAACCTGCGCG-1_Br8667_Post_IF,2,0,1,0,0,3
TATGATCTTCTCTTTA-1_Br8667_Post_IF,3,1,2,1,0,7
TGTACCTACACGAGGG-1_Br8667_Post_IF,0,2,0,0,0,2
ATATCGTTCCTCGAAC-1_Br8667_Post_IF,1,1,0,0,0,2
CGGCGCCATCAATCCC-1_Br8667_Post_IF,2,1,3,0,0,6
CCTGTTTGAAGACACG-1_Br8667_Post_IF,2,1,0,3,0,6
GCCACTCAGAGCGCGA-1_Br8667_Post_IF,2,0,1,0,0,3
TCGGCTTGTATCGACG-1_Br8667_Post_IF,1,3,0,0,0,4
TAGATGGTTCCTTACT-1_Br8667_Post_IF,3,1,0,0,0,4
ATCGTTAGCTAGCGGA-1_Br8667_Post_IF,4,0,0,0,0,4
ACAGCGACATTCTCAT-1_Br8667_Post_IF,1,1,1,0,1,4
ATTCAACCATTTAAGG-1_Br8667_Post_IF,1,1,0,0,0,2
CACTCTTCTGCTAGCC-1_Br8667_Post_IF,3,0,2,0,0,5
CTAACTGATAATCGCC-1_Br8667_Post_IF,3,0,0,0,0,3
TGATGTCAATTAAGTG-1_Br8667_Post_IF,2,0,1,0,0,3
CGCCGTTCAGCATAGT-1_Br8667_Post_IF,1,1,1,0,0,3
ATACTACCCGTACCAC-1_Br8667_Post_IF,0,1,0,0,0,1
CCACTGTTTGGATTAA-1_Br8667_Post_IF,2,0,0,0,0,2
CACTACGGGAGCTGCC-1_Br8667_Post_IF,1,0,0,2,0,3
GACCAAACGTTGACTG-1_Br8667_Post_IF,1,1,0,0,0,2
ATTCCCGAAGGTACAG-1_Br8667_Post_IF,2,1,0,0,0,3
CTAACAGCACAATAAC-1_Br8667_Post_IF,3,1,1,0,0,5
TTGTGCGGAAGCGGAT-1_Br8667_Post_IF,2,1,0,0,0,3
GGGCACTATTGACCAT-1_Br8667_Post_IF,1,1,0,0,0,2
CCATAGAGGCTGCCAG-1_Br8667_Post_IF,3,2,0,0,0,5
CCGAAGCATTGACCAA-1_Br8667_Post_IF,0,0,0,0,0,0
TACTGAGGGAAGAAAG-1_Br8667_Post_IF,1,1,0,0,0,2
TATGTAGAAACCCGGC-1_Br8667_Post_IF,2,1,1,0,0,4
TGGTTAACTTACATTT-1_Br8667_Post_IF,0,0,0,1,0,1
AGAACCCTCAATTGGG-1_Br8667_Post_IF,3,1,0,0,0,4
CCTATATCGTGTCACG-1_Br8667_Post_IF,1,1,1,0,0,3
ACGGCTGGATGTAGAA-1_Br8667_Post_IF,6,2,0,0,0,8
CTCGCATTGCATAGCC-1_Br8667_Post_IF,1,1,0,0,0,2
ACTTTGGTCGTGCTCC-1_Br8667_Post_IF,2,1,0,0,0,3
GCTGGTTTAGGCCATA-1_Br8667_Post_IF,10,1,0,0,0,11
TGTCGTTATCACATAT-1_Br8667_Post_IF,1,1,0,0,0,2
ACACATGATCAAATCT-1_Br8667_Post_IF,0,0,0,0,0,0
TATCCATCTCGGTTAG-1_Br8667_Post_IF,1,2,1,0,0,4
CTCGTCGAGGGCTCAT-1_Br8667_Post_IF,1,0,0,0,0,1
ATCAATGCCGTGGCTG-1_Br8667_Post_IF,4,3,0,0,0,7
GAAACATAGGAAACAG-1_Br8667_Post_IF,1,3,0,1,0,5
TAATAGGTCACCAGAA-1_Br8667_Post_IF,3,2,1,0,0,6
CACCAGTCAGCATGCA-1_Br8667_Post_IF,3,0,1,0,0,4
GAGCGCTGTTAGGTAA-1_Br8667_Post_IF,1,0,0,0,0,1
CCCTATGTAGAGCAGA-1_Br8667_Post_IF,0,0,0,0,0,0
GATCGCTATATCTCAG-1_Br8667_Post_IF,3,1,1,0,0,5
AAGGGACTATGCATTC-1_Br8667_Post_IF,2,1,0,0,0,3
CTCGGGTTCTCTGGCC-1_Br8667_Post_IF,2,0,0,0,0,2
TATATATCGAGAAATG-1_Br8667_Post_IF,1,0,0,0,0,1
ACCCGAGCGAAATTAC-1_Br8667_Post_IF,2,1,0,0,0,3
TTGTTTCATTAGTCTA-1_Br8667_Post_IF,0,1,0,0,0,1
ATGGGACCTGCTGAAC-1_Br8667_Post_IF,2,0,0,0,0,2
TGCGACGGCCGAACGT-1_Br8667_Post_IF,1,1,0,0,0,2
AGCTAACAAGCAATGT-1_Br8667_Post_IF,1,0,1,0,0,2
CGTGTCTCGTTACGAC-1_Br8667_Post_IF,3,1,0,1,0,5
CTAAATCCGGTGTACA-1_Br8667_Post_IF,4,1,1,0,0,6
GAATAGTGCTCGATTA-1_Br8667_Post_IF,0,0,1,0,0,1
AACAATACATTGTCGA-1_Br8667_Post_IF,2,0,0,0,0,2
CACATCGTGCACGCGC-1_Br8667_Post_IF,2,1,0,0,0,3
ACCGTGACCACGTGGG-1_Br8667_Post_IF,3,0,1,0,0,4
CCCAATGAGATTTGCA-1_Br8667_Post_IF,1,1,0,0,0,2
TCAGCAGTAGGCCCTG-1_Br8667_Post_IF,1,1,0,0,0,2
CTACTCAAGGTATAGT-1_Br8667_Post_IF,2,1,0,0,0,3
TAGTAGCTTATACCAG-1_Br8667_Post_IF,2,1,1,0,0,4
ACGTTCGTTCAGGAAA-1_Br8667_Post_IF,3,0,0,0,0,3
TTAGAATAAGGGTCGG-1_Br8667_Post_IF,13,0,0,0,0,13
TTCTAGAAAGTCTTAT-1_Br8667_Post_IF,2,1,1,0,0,4
CCTTCAGTTAAAGTGA-1_Br8667_Post_IF,2,1,1,0,0,4
TAGCTAGTGATGATGG-1_Br8667_Post_IF,3,1,2,0,0,6
AGCCCGGTAGCCTGTA-1_Br8667_Post_IF,0,0,1,0,0,1
TACCTCAGTTGTCTGT-1_Br8667_Post_IF,0,1,0,0,0,1
GACGGGTTGGCCCGTA-1_Br8667_Post_IF,0,1,1,0,0,2
GAAACCTATACAAATG-1_Br8667_Post_IF,5,0,1,0,0,6
TCCACCTCTAGCCTTT-1_Br8667_Post_IF,1,0,1,0,0,2
AAGACCCAACTGAACA-1_Br8667_Post_IF,1,0,0,0,0,1
CATACACGGTTCCCAC-1_Br8667_Post_IF,3,0,0,0,0,3
ACTACGCGTTAGAATT-1_Br8667_Post_IF,1,4,0,0,0,5
CTTGGCCAAGCTGGGA-1_Br8667_Post_IF,0,2,0,0,0,2
TTACCCTAGGGATTGG-1_Br8667_Post_IF,2,2,2,0,0,6
TTCGCACTGTACGACA-1_Br8667_Post_IF,1,1,0,0,0,2
TAGGTGTTCCACAGAT-1_Br8667_Post_IF,4,2,1,1,0,8
GAAGCCTGCACATTCC-1_Br8667_Post_IF,2,1,0,0,0,3
GGCTTTCAATAAGGGT-1_Br8667_Post_IF,2,0,0,0,0,2
TCCAGGGTATATACGA-1_Br8667_Post_IF,3,1,2,0,0,6
CTCGCCGAATGTAGGG-1_Br8667_Post_IF,1,0,0,0,0,1
AGGAAGCTGTCCGCCG-1_Br8667_Post_IF,1,1,0,0,0,2
GTCTCAAGGCCCGGCT-1_Br8667_Post_IF,3,2,1,1,0,7
ACCGACACATCTCCCA-1_Br8667_Post_IF,2,0,1,0,0,3
TATACGCGTCATCACT-1_Br8667_Post_IF,3,2,0,0,0,5
ATCTGGGCTGTTCTTG-1_Br8667_Post_IF,2,1,3,0,0,6
TCAAATTTGAGACTCA-1_Br8667_Post_IF,1,0,2,0,0,3
GTTAAGGGTGCGATGT-1_Br8667_Post_IF,2,2,0,0,0,4
AGCAAAGGCCGCTAGT-1_Br8667_Post_IF,2,0,0,0,0,2
TTATAGGTAATTGTCT-1_Br8667_Post_IF,1,0,0,0,0,1
TTGTGCAGCCACGTCA-1_Br8667_Post_IF,1,1,0,0,0,2
ACGGACTCTCAAAGCG-1_Br8667_Post_IF,1,1,0,0,0,2
ATGCTCTGGCGCGGTA-1_Br8667_Post_IF,2,0,2,0,0,4
ATAATCTTGGAGAACC-1_Br8667_Post_IF,1,2,0,0,0,3
CTCATTGCTCTAACAA-1_Br8667_Post_IF,2,3,0,0,0,5
TAGGTGACGATAACCT-1_Br8667_Post_IF,1,0,0,0,0,1
CGGATCCTCAAGGACT-1_Br8667_Post_IF,1,1,0,0,0,2
GGGCGTGGTTTCCCAG-1_Br8667_Post_IF,1,1,1,0,0,3
TGGCTATGTGACATAC-1_Br8667_Post_IF,0,1,1,0,0,2
CTTAGTGTAGTAGCAT-1_Br8667_Post_IF,5,0,3,1,0,9
GGATTGCTGTGACTCC-1_Br8667_Post_IF,1,1,0,0,0,2
ACTTCCATGCGGGACA-1_Br8667_Post_IF,1,1,0,0,0,2
ACTCAAGTGCAAGGCT-1_Br8667_Post_IF,4,0,0,0,0,4
ACAAGGATGCTTTAGG-1_Br8667_Post_IF,1,0,0,0,0,1
TTGAACGACGTGCTGA-1_Br8667_Post_IF,4,0,1,0,0,5
ATTCATCGTTGAGGCA-1_Br8667_Post_IF,3,2,0,0,0,5
TGCAACCCATCTGCGG-1_Br8667_Post_IF,0,1,1,0,0,2
AGTGCTAAACACAGCA-1_Br8667_Post_IF,3,1,0,0,0,4
AACTCCAGAGCGTGTT-1_Br8667_Post_IF,1,0,3,0,0,4
TCTCCACAAGTTGAAT-1_Br8667_Post_IF,2,3,1,0,0,6
CTTTGCATCGCTCTTG-1_Br8667_Post_IF,2,1,0,0,0,3
TCACAAACCGAGGTAC-1_Br8667_Post_IF,1,0,0,0,0,1
CCGTAGGAAATCCCTG-1_Br8667_Post_IF,0,2,1,0,0,3
AAACATTTCCCGGATT-1_Br8667_Post_IF,5,1,0,1,0,7
GCCTCCGACAATTCAC-1_Br8667_Post_IF,2,2,1,0,0,5
TCTGCATACCTTGCTT-1_Br8667_Post_IF,0,1,0,0,0,1
ACCCATTTGTCCCTCT-1_Br8667_Post_IF,3,0,2,0,0,5
CTGCAGAGAATCAGAG-1_Br8667_Post_IF,4,0,1,0,0,5
GGAAACTAAATGGGCC-1_Br8667_Post_IF,1,0,0,0,0,1
CAACCTACCGAGCAGT-1_Br8667_Post_IF,1,0,0,0,0,1
CCGTAGGGTTGTTTAC-1_Br8667_Post_IF,1,0,2,0,0,3
GGTTTGTGACCTGAGG-1_Br8667_Post_IF,0,2,0,0,0,2
TAACCTAGGGAGTCCA-1_Br8667_Post_IF,0,4,1,0,0,5
TTCCATCGACAGCGTG-1_Br8667_Post_IF,3,0,0,0,0,3
ATCTCCCACGGAATAT-1_Br8667_Post_IF,0,0,0,0,0,0
AAACATGGTGAGAGGA-1_Br8667_Post_IF,1,3,0,0,0,4
ATCATTGTACCGCATT-1_Br8667_Post_IF,2,0,1,0,0,3
TCAGCTTGAGCTTTCG-1_Br8667_Post_IF,4,2,1,1,0,8
CCGCGCAAGATACCCA-1_Br8667_Post_IF,2,1,0,0,0,3
CTATACTTAAAGCGAG-1_Br8667_Post_IF,5,1,0,0,0,6
ACCGTCCACTGGGCCC-1_Br8667_Post_IF,1,0,0,0,0,1
AAGACCAAATAACTCA-1_Br8667_Post_IF,2,1,0,0,0,3
TGTTTCTGAAGCGTGC-1_Br8667_Post_IF,3,2,1,0,0,6
TTCTCTTACAGGTGAT-1_Br8667_Post_IF,1,0,0,0,0,1
AATTCATTGTCATGCA-1_Br8667_Post_IF,3,0,0,0,0,3
GCCCGAGAGTCTAAAT-1_Br8667_Post_IF,1,1,0,0,0,2
ATATAGAGTATTGGTC-1_Br8667_Post_IF,2,0,0,0,0,2
TTGAAGGATGGGCGCC-1_Br8667_Post_IF,1,0,0,0,0,1
TAGTACCACAACTTTC-1_Br8667_Post_IF,3,0,1,0,0,4
ATCCCATCCACAGCGC-1_Br8667_Post_IF,1,1,0,1,0,3
CTTAGGTATAGACCAG-1_Br8667_Post_IF,2,0,1,0,0,3
TGACTCCGAATCATAC-1_Br8667_Post_IF,1,0,0,0,0,1
ACTACATCCCGACAAG-1_Br8667_Post_IF,2,0,0,0,0,2
TTGCCGCAGACCTACA-1_Br8667_Post_IF,2,0,0,0,0,2
TAAGAGGGACAGGGAC-1_Br8667_Post_IF,1,0,0,0,0,1
CGAATGAAGTCATTGC-1_Br8667_Post_IF,2,0,0,0,0,2
AAGGGAACGACTGGCT-1_Br8667_Post_IF,2,1,0,0,0,3
CGAATCTGCTCGACGC-1_Br8667_Post_IF,0,0,0,0,0,0
ATCGTGGAAAGTCTGG-1_Br8667_Post_IF,0,0,0,0,0,0
CCTATGGCTCCTAGTG-1_Br8667_Post_IF,0,1,1,0,0,2
CGTCGCTTGGTTATAC-1_Br8667_Post_IF,3,1,0,0,0,4
TGCTTAGAGAGAATGC-1_Br8667_Post_IF,0,1,0,1,0,2
GATTGCTCCAGTTGCA-1_Br8667_Post_IF,5,1,0,0,0,6
CGTGCTTCTACCTAAA-1_Br8667_Post_IF,0,0,0,0,0,0
ACTCCAATATCATCAT-1_Br8667_Post_IF,2,1,0,0,0,3
GCCGACCCACGACTGC-1_Br8667_Post_IF,1,1,0,0,0,2
GAGGGTAGTAACAAAG-1_Br8667_Post_IF,2,1,0,0,0,3
GGCCGAGACTCTGGTG-1_Br8667_Post_IF,1,2,0,0,0,3
TATATAGGGCTTTACG-1_Br8667_Post_IF,9,0,0,0,0,9
TGCCGGATGTACGAGC-1_Br8667_Post_IF,1,0,0,0,0,1
AGGTAGATCGAGATAT-1_Br8667_Post_IF,3,0,0,0,0,3
GATCAACATAAAGGGA-1_Br8667_Post_IF,1,0,1,0,0,2
TAACAGCGTTTGTGCT-1_Br8667_Post_IF,0,0,0,0,0,0
CTATAGGCGTTGATGT-1_Br8667_Post_IF,4,0,3,0,0,7
GGTTTAATTACCATCG-1_Br8667_Post_IF,1,0,0,0,0,1
CTCTTCTGGAAGTTAG-1_Br8667_Post_IF,1,0,0,0,0,1
ATCTGACATGGAAGGA-1_Br8667_Post_IF,0,0,2,0,0,2
TACGTACTAGTGCTGA-1_Br8667_Post_IF,0,1,1,0,0,2
ATGACTATCAGCTGTG-1_Br8667_Post_IF,2,0,0,1,0,3
CTTTGGGATTGTTGCA-1_Br8667_Post_IF,2,0,0,0,0,2
AGACTGTTACCGGGTC-1_Br8667_Post_IF,3,0,1,0,0,4
TCCTAACCGTCGGGCA-1_Br8667_Post_IF,3,1,0,0,0,4
ACGCAAACTAATAGAT-1_Br8667_Post_IF,0,2,0,0,0,2
AAGTGAGTCGGGTTTA-1_Br8667_Post_IF,0,1,1,0,0,2
TAAAGCGGTATTTCCA-1_Br8667_Post_IF,1,0,0,0,0,1
CTCCTCCAGCTCACAC-1_Br8667_Post_IF,5,0,3,0,0,8
CGGTCCGTCGCAAGCC-1_Br8667_Post_IF,4,2,0,0,0,6
CCTATATTTGTCCTGG-1_Br8667_Post_IF,0,0,0,0,0,0
TCCAATAAAGGCTACC-1_Br8667_Post_IF,1,2,0,0,0,3
AAAGGCTACGGACCAT-1_Br8667_Post_IF,4,1,0,0,0,5
CGTGACCAGTCCTCTG-1_Br8667_Post_IF,1,2,1,0,0,4
GATCTGCTATCTAAGG-1_Br8667_Post_IF,2,1,1,0,0,4
CGAATGACGCATAATG-1_Br8667_Post_IF,1,2,1,0,0,4
GCTCAATGTAATACCG-1_Br8667_Post_IF,4,1,1,0,0,6
CTATGCCCGAATGCAA-1_Br8667_Post_IF,2,0,1,0,0,3
CACAGGGCCGTTGTCA-1_Br8667_Post_IF,1,1,1,0,0,3
TCAATACGCCGTCATG-1_Br8667_Post_IF,1,1,1,0,0,3
AGCGGACACTTCGTAG-1_Br8667_Post_IF,3,0,1,0,0,4
ATACGTTATGCACGGA-1_Br8667_Post_IF,1,0,2,0,0,3
GAGTAGATACTAGTTG-1_Br8667_Post_IF,1,0,2,0,0,3
CCAGCTCGAACGCATT-1_Br8667_Post_IF,3,0,1,1,0,5
TGCTTCCCAAGCAGTA-1_Br8667_Post_IF,4,0,1,0,0,5
GTAGACACGCCTGACT-1_Br8667_Post_IF,4,2,3,0,0,9
CTCACATTTACTAAAT-1_Br8667_Post_IF,0,1,0,0,0,1
GAATGCGAATCGGTTC-1_Br8667_Post_IF,1,0,0,2,0,3
TAAGGCCCGTCACCCT-1_Br8667_Post_IF,2,0,1,0,0,3
GAGTATGCGCGTGCAT-1_Br8667_Post_IF,2,0,1,0,0,3
ATCCACATCGACAGAA-1_Br8667_Post_IF,0,3,1,0,0,4
TAGACGAAACGCCAAT-1_Br8667_Post_IF,2,0,0,1,1,4
CAGCAGTCTGTGCTGC-1_Br8667_Post_IF,0,0,0,0,0,0
CTCACTGTGATACTTA-1_Br8667_Post_IF,6,1,2,0,0,9
TTAATTGCTTTGGGTG-1_Br8667_Post_IF,3,1,2,0,0,6
GTAGTCTACGATATTG-1_Br8667_Post_IF,3,1,0,0,0,4
TTGCCGCTTTCTAGTA-1_Br8667_Post_IF,2,1,0,0,0,3
GAACCTTTAACGATCC-1_Br8667_Post_IF,2,1,0,0,0,3
TGGACCAATCTAAGAT-1_Br8667_Post_IF,0,0,0,0,0,0
CTAGTAGAAAGGGATT-1_Br8667_Post_IF,1,0,1,1,0,3
AACCTCGCTTTAGCCC-1_Br8667_Post_IF,5,3,1,0,0,9
GAGTGTCAACCAGAAA-1_Br8667_Post_IF,1,3,3,0,0,7
GTGATCCTTGTCATGA-1_Br8667_Post_IF,0,0,0,0,0,0
CTCAACTAACCCGGAT-1_Br8667_Post_IF,5,0,3,0,0,8
AGTGGCGTCTGAAGGT-1_Br8667_Post_IF,1,0,0,0,0,1
GGGAAGGGCTTTCTCA-1_Br8667_Post_IF,1,1,1,0,0,3
AGGCCTGAGAATCTCG-1_Br8667_Post_IF,4,0,1,3,0,8
AGCCACAGGTTACCCG-1_Br8667_Post_IF,2,0,2,0,0,4
TGCAATCTAACACGGT-1_Br8667_Post_IF,2,1,1,0,0,4
GTTTGGGTTTCGCCCG-1_Br8667_Post_IF,2,2,1,0,0,5
CCTATGTCCACTCCAC-1_Br8667_Post_IF,6,1,0,0,0,7
CTGCCTTTCTAGTAAA-1_Br8667_Post_IF,2,0,0,0,0,2
TTAGTAAACCTGCTCT-1_Br8667_Post_IF,2,2,3,0,0,7
TTGTGGTGGTACTAAG-1_Br8667_Post_IF,0,1,2,0,0,3
CCTCCTGTTGTGTCGT-1_Br8667_Post_IF,4,0,0,0,0,4
ACAAAGCATGACCTAG-1_Br8667_Post_IF,2,3,1,0,0,6
ATAGCAACTAGGGAAG-1_Br8667_Post_IF,0,2,2,0,0,4
CCGCTCTTCCGAACTA-1_Br8667_Post_IF,2,1,0,0,0,3
TAGAATAGCCGATGAA-1_Br8667_Post_IF,0,2,0,0,0,2
GGTCTCCGTCCAGGTT-1_Br8667_Post_IF,0,2,0,0,0,2
TAATTACGTCAGTAGA-1_Br8667_Post_IF,0,3,0,0,0,3
TACGTAAAGCGGAGTG-1_Br8667_Post_IF,1,0,0,1,0,2
GCTACAATCGAGGATA-1_Br8667_Post_IF,5,3,2,0,0,10
TCAGCCAATCCGTAAA-1_Br8667_Post_IF,2,0,0,0,0,2
ATCATAGCCCTATGTA-1_Br8667_Post_IF,1,0,0,1,0,2
GAGGCCTGTTGATACA-1_Br8667_Post_IF,0,0,1,3,0,4
ATATACGCTCGTGACG-1_Br8667_Post_IF,0,0,1,1,0,2
CCCTTTAATGGAGTTC-1_Br8667_Post_IF,0,0,1,0,0,1
GGACAAGCCATGATCG-1_Br8667_Post_IF,2,1,0,0,0,3
TCCAATGCGTCGCCGC-1_Br8667_Post_IF,0,2,1,0,0,3
AAAGAATGACCTTAGA-1_Br8667_Post_IF,3,1,1,0,0,5
CCTATTATTCCGGCCG-1_Br8667_Post_IF,1,0,0,0,0,1
CAGTAAGGGACGTCTC-1_Br8667_Post_IF,3,0,1,0,0,4
GGGATGGACCCGCGTC-1_Br8667_Post_IF,1,1,0,0,0,2
GACGCATACCCGTCGG-1_Br8667_Post_IF,4,1,0,1,0,6
GGGCAGGATTTCTGTG-1_Br8667_Post_IF,0,0,1,0,0,1
TATCTGAGCCGATATT-1_Br8667_Post_IF,0,0,0,0,0,0
AATGTATGGCACTGTA-1_Br8667_Post_IF,1,1,0,0,0,2
GCCTTTGTCAGTGGAC-1_Br8667_Post_IF,2,1,0,0,0,3
AACCATAGGGTTGAAC-1_Br8667_Post_IF,5,0,0,0,0,5
AAACTTAATTGCACGC-1_Br8667_Post_IF,5,1,0,0,0,6
TAGGCGGCTGCAAAGA-1_Br8667_Post_IF,0,1,0,0,0,1
TCCATCAATACTAATC-1_Br8667_Post_IF,0,1,0,0,0,1
ACCTCGAACTTATGCT-1_Br8667_Post_IF,1,2,1,0,0,4
ACAAACCATGCGTCCT-1_Br8667_Post_IF,4,0,0,0,0,4
ACACCGGTCTGACCGC-1_Br8667_Post_IF,5,0,1,0,0,6
ATGGCAGCATTACGAT-1_Br8667_Post_IF,4,0,0,0,0,4
CTGGTGAATGGGCCTA-1_Br8667_Post_IF,1,0,0,0,0,1
CACAGAGACGAGGACG-1_Br8667_Post_IF,1,1,1,0,0,3
GCACAAACCCTAGATG-1_Br8667_Post_IF,3,1,0,0,0,4
ACTATGTCCAGCTGCC-1_Br8667_Post_IF,2,2,1,0,0,5
AAGCCGCCGTGAAATC-1_Br8667_Post_IF,3,0,0,0,0,3
ATGGGTGTATACCTCC-1_Br8667_Post_IF,0,1,1,0,0,2
TAAGCGCGAATCAAAT-1_Br8667_Post_IF,1,0,0,0,0,1
AGCCCGGCATTAGAGG-1_Br8667_Post_IF,4,2,0,0,0,6
GTGATCAAGCGTGCAC-1_Br8667_Post_IF,2,0,0,0,0,2
CTGCCTTTAATACCTT-1_Br8667_Post_IF,1,0,0,0,0,1
TACCTCCACACCAATG-1_Br8667_Post_IF,0,0,1,0,0,1
GAGCATCAACAACTTG-1_Br8667_Post_IF,2,0,0,0,0,2
CATACGAACTAGCTGG-1_Br8667_Post_IF,1,3,0,0,0,4
GGGAACGGTTTCAGAT-1_Br8667_Post_IF,3,1,0,0,0,4
AGGGTGCCGTTCTTTA-1_Br8667_Post_IF,7,0,1,0,0,8
ACGACTGGTCATACTC-1_Br8667_Post_IF,4,2,0,0,0,6
GGATCTTACTGCCCTT-1_Br8667_Post_IF,0,2,0,0,0,2
TACTCCTCTAGTTGAC-1_Br8667_Post_IF,4,3,1,0,0,8
GTAGCTCCGGGAGGCT-1_Br8667_Post_IF,1,2,1,0,0,4
GGACTCGTGAGTGGTC-1_Br8667_Post_IF,4,1,1,0,0,6
GTAGTTCGAAGGCGAA-1_Br8667_Post_IF,2,0,1,1,0,4
CTCAAACCACTGCCCG-1_Br8667_Post_IF,1,2,0,0,0,3
GAGGGAGTCAGATCGC-1_Br8667_Post_IF,1,1,1,0,0,3
GCGTCCCTAAGACATA-1_Br8667_Post_IF,3,1,2,0,0,6
TCTCTTACCGCGAACC-1_Br8667_Post_IF,0,2,2,0,0,4
GGCTACTATACACTCC-1_Br8667_Post_IF,3,0,2,0,0,5
CGTTGCCCGCGTGGGA-1_Br8667_Post_IF,4,0,0,0,0,4
TATAGAGTCGCTTGAA-1_Br8667_Post_IF,2,2,1,0,0,5
ATGTTGTAGTCTGTTT-1_Br8667_Post_IF,0,1,1,0,0,2
AGTATACACAGCGACA-1_Br8667_Post_IF,4,1,0,0,0,5
TGTGGTTGCTAAAGCT-1_Br8667_Post_IF,1,0,0,0,0,1
TGATTCCCGGTTACCT-1_Br8667_Post_IF,3,2,1,1,0,7
CACTGACGATTGTGGA-1_Br8667_Post_IF,4,0,1,0,0,5
AACATTGTGACTCGAG-1_Br8667_Post_IF,1,0,0,0,0,1
GTCCAATATTTAGCCT-1_Br8667_Post_IF,1,2,1,0,0,4
GCTCTTTCCGCTAGTG-1_Br8667_Post_IF,3,2,1,1,0,7
GGGTCAGGAGCTAGAT-1_Br8667_Post_IF,0,3,0,0,0,3
AGGTGGTGACCTTCGC-1_Br8667_Post_IF,1,3,0,0,0,4
CCCGGGTCGTTCAGGG-1_Br8667_Post_IF,2,0,3,1,0,6
AGCCAAGCTTTGTGTC-1_Br8667_Post_IF,6,0,1,1,0,8
TGTGGCGGGCTTCTGG-1_Br8667_Post_IF,2,2,1,0,0,5
CGAGGGTATCCAGGTG-1_Br8667_Post_IF,3,2,0,0,0,5
CGTTCAGACCCGCGAA-1_Br8667_Post_IF,6,1,3,0,0,10
TCATATGAGCTTTGTT-1_Br8667_Post_IF,1,0,1,0,0,2
AGTTGACGGTCCTTGC-1_Br8667_Post_IF,4,3,0,0,0,7
ATAATTAGCTAAGTAG-1_Br8667_Post_IF,1,0,1,0,0,2
GGTCTTGAGCGCTCTT-1_Br8667_Post_IF,2,0,1,0,0,3
CGTTGTCGGCAATTGA-1_Br8667_Post_IF,3,2,2,1,0,8
TCTTGCTCCCGATACT-1_Br8667_Post_IF,4,1,2,0,0,7
AGCAGAAGGAGAAAGA-1_Br8667_Post_IF,2,1,2,1,0,6
GAAGCCACTGATTATG-1_Br8667_Post_IF,1,2,0,1,0,4
TGCTCTTGAGAGTTTG-1_Br8667_Post_IF,3,3,0,0,1,7
GACATCCGTCGAACTG-1_Br8667_Post_IF,2,1,0,0,0,3
AGATATAATACGACTA-1_Br8667_Post_IF,1,2,2,0,0,5
TCGCTACTGGCTTTGA-1_Br8667_Post_IF,1,2,1,0,0,4
GTGACAGCTTCCCACT-1_Br8667_Post_IF,1,1,1,0,0,3
GTGACGCAGGTTTCAT-1_Br8667_Post_IF,1,3,2,0,0,6
GGGAAGACGGTCTGTC-1_Br8667_Post_IF,2,1,1,0,0,4
CGTCGCATGTGAGCCA-1_Br8667_Post_IF,0,2,2,0,0,4
AGAAGGTTGTAGGTCG-1_Br8667_Post_IF,3,1,1,0,0,5
GGCCGGCGTCTGCTAT-1_Br8667_Post_IF,0,5,2,0,0,7
TTGACCAGGAACAACT-1_Br8667_Post_IF,2,3,2,0,0,7
AGTCGTATAAAGCAGA-1_Br8667_Post_IF,3,3,2,0,0,8
GGCGTAGGGAAAGCTG-1_Br8667_Post_IF,1,1,1,1,0,4
AAACCTAAGCAGCCGG-1_Br8667_Post_IF,5,3,0,0,0,8
ATTGCCTTTATGTTTG-1_Br8667_Post_IF,2,3,2,0,0,7
CAGGCAGTCTTACCAG-1_Br8667_Post_IF,2,2,0,0,0,4
AGCTAAGTACGCAGGC-1_Br8667_Post_IF,4,5,1,0,0,10
AAATCCGATACACGCC-1_Br8667_Post_IF,1,3,2,0,0,6
CGAGAGCTTTCACTAC-1_Br8667_Post_IF,2,4,0,2,0,8
CGCCCAGCGTTTCACG-1_Br8667_Post_IF,1,2,0,2,0,5
TTAAGTATTGTTATCC-1_Br8667_Post_IF,2,1,1,0,0,4
AAACGGGCGTACGGGT-1_Br8667_Post_IF,1,1,3,3,0,8
GTATCCTTTGGTAACC-1_Br8667_Post_IF,7,0,1,0,0,8
CATAGTCAAATACATA-1_Br8667_Post_IF,0,1,3,0,0,4
TCTATGCTATAACGAC-1_Br8667_Post_IF,1,0,3,0,0,4
ACGTTCTGTACAAGTC-1_Br8667_Post_IF,3,2,2,0,0,7
CGCGAAGTGGCATACT-1_Br8667_Post_IF,5,1,1,1,0,8
ACCAACCGCACTCCAC-1_Br8667_Post_IF,2,0,7,0,0,9
GTCATGCGCGAGGGCT-1_Br8667_Post_IF,1,0,2,0,0,3
TAGGCTAAAGTGGCAC-1_Br8667_Post_IF,1,1,0,2,0,4
TGGCTACACTCTACCT-1_Br8667_Post_IF,0,4,0,1,0,5
TGTCCACGGCTCAACT-1_Br8667_Post_IF,2,3,2,1,0,8
AATTGCAGCAATCGAC-1_Br8667_Post_IF,3,0,1,0,0,4
GTCAACCAGGCCTATA-1_Br8667_Post_IF,6,1,0,1,0,8
ATCTTATCGCACACCC-1_Br8667_Post_IF,1,1,0,0,0,2
GTCTATTGCATGCTCG-1_Br8667_Post_IF,5,1,0,1,0,7
GCACGTGGTTTACTTA-1_Br8667_Post_IF,0,1,1,2,0,4
ATTCGCGCCTTGAGAG-1_Br8667_Post_IF,0,2,0,1,0,3
AGCGATGCGCCTAATA-1_Br8667_Post_IF,0,3,2,0,0,5
TCTATAGGTGGGTAAT-1_Br8667_Post_IF,0,0,0,0,0,0
TGTAAGACTGATAAGA-1_Br8667_Post_IF,1,2,0,0,0,3
GTCACTCATGAGCGAT-1_Br8667_Post_IF,3,0,2,0,0,5
CGGTTTACTGAACATT-1_Br8667_Post_IF,1,1,0,0,0,2
GAGATCGATCTTACTC-1_Br8667_Post_IF,3,1,2,0,0,6
TCTTTCATCCGTCCTT-1_Br8667_Post_IF,2,0,0,1,0,3
TCGGATCTGGATGACC-1_Br8667_Post_IF,3,0,1,0,1,5
GTCCTAGGATACCTTA-1_Br8667_Post_IF,1,0,0,0,0,1
TGTACCCGACCCTAAT-1_Br8667_Post_IF,3,0,0,0,0,3
AGGTTCTCCTTTCCGG-1_Br8667_Post_IF,1,0,0,0,0,1
AATTGCGTGGATTACA-1_Br8667_Post_IF,3,0,0,0,0,3
CGATAGCGATACAGTG-1_Br8667_Post_IF,4,0,0,0,0,4
CGCCCTAATTGTTCAA-1_Br8667_Post_IF,2,0,0,0,0,2
ATTATGAGACCCAATT-1_Br8667_Post_IF,1,1,1,0,0,3
CCTCCTAGCTAGAGTC-1_Br8667_Post_IF,1,1,0,0,0,2
CGAAGGGTTTCAGATT-1_Br8667_Post_IF,3,0,1,0,0,4
CACAAGCTAAGAAAGG-1_Br8667_Post_IF,2,2,1,0,0,5
CACCGGTAGAGACATT-1_Br8667_Post_IF,1,0,0,0,0,1
ACTCATGGCAGCCTTC-1_Br8667_Post_IF,2,0,0,0,0,2
CATCCAATATAGTTTG-1_Br8667_Post_IF,1,0,0,0,0,1
CAGATATGAAGATGAC-1_Br8667_Post_IF,2,1,0,0,0,3
GCAAAGGGCGTTAGCC-1_Br8667_Post_IF,3,1,0,0,0,4
CTGTTGTTCAGTCGTA-1_Br8667_Post_IF,1,2,0,0,0,3
AAAGGCCCTATAATAC-1_Br8667_Post_IF,0,0,0,1,0,1
AACATTGAAGTTGATC-1_Br8667_Post_IF,4,2,1,0,0,7
GCTAGCGATAGGTCTT-1_Br8667_Post_IF,1,1,0,0,0,2
ATTGCCTATTAGACCG-1_Br8667_Post_IF,1,2,1,0,0,4
GGGCGTTTACATTCAT-1_Br8667_Post_IF,2,1,0,0,0,3
CCTCTACAAGGATTGG-1_Br8667_Post_IF,1,0,0,0,0,1
AGTGACTGTGACACAA-1_Br8667_Post_IF,0,0,0,0,0,0
AGCCCTCCCTGGTGGC-1_Br8667_Post_IF,0,2,1,0,0,3
CGGTTGAGTATCCTTC-1_Br8667_Post_IF,0,0,0,0,0,0
CATTATCCCATTAACG-1_Br8667_Post_IF,2,1,0,0,0,3
AATGTGCTAATCTGAG-1_Br8667_Post_IF,0,1,0,0,0,1
CTTAGTTGAGGAATCG-1_Br8667_Post_IF,0,1,2,0,0,3
CTTCTGGGCGTACCTA-1_Br8667_Post_IF,1,0,0,0,0,1
AGTCAAATGATGTGAT-1_Br8667_Post_IF,4,0,2,0,0,6
TGAACAAGCAGGGACT-1_Br8667_Post_IF,4,1,0,0,0,5
AATACCGGAGGGCTGT-1_Br8667_Post_IF,1,1,0,1,0,3
GTTTGGTGATCGGTGC-1_Br8667_Post_IF,7,0,4,0,0,11
GACTGCTGGTGAGAAA-1_Br8667_Post_IF,4,2,0,0,0,6
CGATCCTCGCAACATA-1_Br8667_Post_IF,1,1,1,0,0,3
CCAACCTTATGTAACT-1_Br8667_Post_IF,1,3,1,0,0,5
CGTGGTACCCAAAGGC-1_Br8667_Post_IF,2,1,1,0,0,4
AACCCGACAACCCGTG-1_Br8667_Post_IF,3,3,1,0,0,7
TATGTAAAGTGCTTAA-1_Br8667_Post_IF,0,1,1,0,0,2
GCAAGTGTAAAGCATG-1_Br8667_Post_IF,2,1,1,0,0,4
GTAACTGCCCAAGGAG-1_Br8667_Post_IF,4,0,0,0,0,4
GGTGCATAAATGATTA-1_Br8667_Post_IF,4,2,2,0,0,8
TAGTCCCGGAGACCAC-1_Br8667_Post_IF,3,0,0,0,0,3
CGGCCAGAGCGACCAT-1_Br8667_Post_IF,3,4,1,0,0,8
TGAATGAGTGTTTCCC-1_Br8667_Post_IF,3,1,0,0,0,4
TTCACTTCCTAGAACG-1_Br8667_Post_IF,2,3,0,0,0,5
CGCTTAGTATTGATAC-1_Br8667_Post_IF,4,3,0,0,0,7
AACGCGACCTTGGGCG-1_Br8667_Post_IF,0,3,2,0,0,5
GTGCACCAGCTTCAAC-1_Br8667_Post_IF,2,0,0,0,0,2
TTCTATTAAACGCAGC-1_Br8667_Post_IF,4,3,1,1,0,9
TGGCAAGCACAAGTCG-1_Br8667_Post_IF,1,2,1,0,0,4
ATCTGCTGTTATCGCC-1_Br8667_Post_IF,2,0,2,0,0,4
AATTCCAAGCATGTAC-1_Br8667_Post_IF,4,0,0,0,0,4
AAACGGTTGCGAACTG-1_Br8667_Post_IF,3,2,0,0,0,5
GAAGGAGTCGAGTGCG-1_Br8667_Post_IF,2,0,2,0,0,4
GGCAAGCCCATAGTGG-1_Br8667_Post_IF,2,2,0,0,0,4
TGACCAAATCTTAAAC-1_Br8667_Post_IF,1,1,1,0,0,3
TTCGGTACTGTAGAGG-1_Br8667_Post_IF,2,2,0,0,0,4
ATGTACGATGACGTCG-1_Br8667_Post_IF,0,2,0,1,0,3
ATCTAGCTTGTGAGGG-1_Br8667_Post_IF,4,0,1,0,0,5
AGCGGGTCTGACACTC-1_Br8667_Post_IF,2,3,3,0,0,8
GAGGTACGCGTGTCCC-1_Br8667_Post_IF,2,1,0,0,0,3
GCACTGCCTACCTTTA-1_Br8667_Post_IF,6,2,2,0,0,10
GGAGCGAGGCCTACTT-1_Br8667_Post_IF,1,2,0,0,0,3
AAACTCGGTTCGCAAT-1_Br8667_Post_IF,0,4,2,2,0,8
GGCGCTTCATTCCCTG-1_Br8667_Post_IF,1,1,2,0,0,4
TGCTCGGTGGGTCACC-1_Br8667_Post_IF,0,0,0,0,0,0
AAGCGCAGGGCTTTGA-1_Br8667_Post_IF,0,2,3,0,0,5
GACCTTCCACGTCTAC-1_Br8667_Post_IF,1,4,1,1,0,7
GTTAGCCCATGACATC-1_Br8667_Post_IF,0,1,1,2,0,4
AATTCGATTCGAGGAT-1_Br8667_Post_IF,0,2,2,0,0,4
AGTCTTTAAAGTGTCC-1_Br8667_Post_IF,1,0,0,0,0,1
GACTAGGCCGTTAGGT-1_Br8667_Post_IF,2,2,2,0,0,6
TCCAAGCCTAGACACA-1_Br8667_Post_IF,0,2,1,4,0,7
GATTGGGAAAGGTTGT-1_Br8667_Post_IF,3,2,4,0,0,9
GATGAGGAACCTTCGG-1_Br8667_Post_IF,2,2,0,0,0,4
TGAATACCGACGCGTA-1_Br8667_Post_IF,1,0,1,0,0,2
AATCGTGAGCCGAGCA-1_Br8667_Post_IF,0,2,2,0,0,4
GCGAAGAATCTGACGG-1_Br8667_Post_IF,1,5,1,0,0,7
GAACAACTGGGATGAA-1_Br8667_Post_IF,0,4,0,0,0,4
TCGCCGACATATTCGC-1_Br8667_Post_IF,2,3,4,0,0,9
CGTAGAGAGTAATTAT-1_Br8667_Post_IF,1,4,0,0,0,5
CGATAGTCGTACTGCA-1_Br8667_Post_IF,2,1,4,1,0,8
CGCATGCCGAATGCGT-1_Br8667_Post_IF,2,2,1,0,0,5
CTCTAGCCCTCGGAAA-1_Br8667_Post_IF,1,0,1,0,0,2
TCCAACTCAGCTATCT-1_Br8667_Post_IF,1,2,0,0,0,3
GTCTAGTGAGCCGCTT-1_Br8667_Post_IF,0,3,2,0,0,5
TACCGAATAATTGTAA-1_Br8667_Post_IF,2,2,0,1,0,5
ATATAACACGGGCGCA-1_Br8667_Post_IF,2,3,0,0,0,5
GCATGCTAATAACGAT-1_Br8667_Post_IF,0,4,4,2,0,10
TCCGGGCTTGACGGGA-1_Br8667_Post_IF,2,1,0,1,0,4
ATTATTCAGAGTCACT-1_Br8667_Post_IF,2,0,1,0,1,4
TAGCAGTATGACTAAA-1_Br8667_Post_IF,1,1,0,0,1,3
TATGAAGAATTAAGGT-1_Br8667_Post_IF,2,2,0,0,0,4
CAAGGCCAGTGGTGCA-1_Br8667_Post_IF,1,0,1,0,0,2
TGCGTACGGCTAATTG-1_Br8667_Post_IF,2,2,1,0,0,5
CAGATAATGGGCGGGT-1_Br8667_Post_IF,0,3,1,0,0,4
GAGAACGGTTCTGACT-1_Br8667_Post_IF,2,5,0,0,0,7
CGCTTCGGTCTAAGAC-1_Br8667_Post_IF,2,1,2,0,0,5
AGCATTACGAGGCAAG-1_Br8667_Post_IF,4,0,0,0,0,4
AAGTTGTGATGTTATA-1_Br8667_Post_IF,1,1,2,0,0,4
TTGCTCATAGTACGTG-1_Br8667_Post_IF,0,1,0,1,0,2
TACTTAAACATGTACA-1_Br8667_Post_IF,0,1,0,0,0,1
AGTGAGTCGAATTAAC-1_Br8667_Post_IF,4,2,0,0,0,6
TAGGCCTATATAGTCT-1_Br8667_Post_IF,0,0,0,0,0,0
ACTCGCCGTTCGATAA-1_Br8667_Post_IF,0,0,0,0,0,0
GGTACGTTGCGGCCGG-1_Br8667_Post_IF,0,0,0,0,0,0
TATTGCCGGGCTTGTA-1_Br8667_Post_IF,1,0,0,1,0,2
GGTAAACTCTGCGCTG-1_Br8667_Post_IF,0,0,0,0,0,0
TCCCTTGTCTGAAACT-1_Br8667_Post_IF,0,4,0,3,0,7
CATGATCGCTTTGAGA-1_Br8667_Post_IF,0,0,0,0,0,0
GGACGGGCGACCAACC-1_Br8667_Post_IF,0,1,0,7,0,8
GAGAGGCCTATGTGTA-1_Br8667_Post_IF,1,2,0,1,0,4
TCGTAACTCCCAAGAC-1_Br8667_Post_IF,0,0,1,6,0,7
CGTATCTAGAACTAAG-1_Br8667_Post_IF,0,0,0,0,0,0
GCACCTTCCCGAAGGT-1_Br8667_Post_IF,0,0,1,6,0,7
TGACTCTAACTGGTAA-1_Br8667_Post_IF,1,0,0,1,0,2
ATCCGGACCAGCCTGA-1_Br8667_Post_IF,0,0,0,0,0,0
CGAATTCCCGGTTCAA-1_Br8667_Post_IF,0,0,0,0,0,0
TAGTTTGATCGGTCGC-1_Br8667_Post_IF,1,1,0,0,0,2
AGTCGAAACGATTCAG-1_Br8667_Post_IF,2,0,0,0,0,2
ACGTCGGGCAACTCGG-1_Br8667_Post_IF,1,0,0,0,0,1
ACTTGCTCTATCTACC-1_Br8667_Post_IF,2,0,0,0,0,2
ATTACGGGCTACGGTT-1_Br8667_Post_IF,2,0,0,0,0,2
GCAAACGTAAGCGACC-1_Br8667_Post_IF,3,0,0,0,0,3
TTCGGACTGGGCATGG-1_Br8667_Post_IF,5,0,0,0,0,5
GGGCCATTCGTGCTGG-1_Br8667_Post_IF,1,1,2,0,0,4
GAGTTGTCACCAGTCT-1_Br8667_Post_IF,1,1,1,0,0,3
AGTAATTTGCAAGCGT-1_Br8667_Post_IF,1,0,0,0,0,1
GTGGCCGGTTTCTCGG-1_Br8667_Post_IF,0,3,2,0,0,5
ATCTTAGGGCATTAAT-1_Br8667_Post_IF,0,1,0,0,0,1
CTACATATCGCGGGAC-1_Br8667_Post_IF,3,0,0,0,0,3
ATGGTATTTACTGATT-1_Br8667_Post_IF,4,0,0,0,0,4
CCGTCAACCTCTGGCG-1_Br8667_Post_IF,1,1,1,0,0,3
GCTTCGACGTTCAATC-1_Br8667_Post_IF,3,2,1,1,0,7
GACCGATTAAATATGT-1_Br8667_Post_IF,1,0,0,0,0,1
GTCGAATTTGGGCGCT-1_Br8667_Post_IF,2,3,2,0,0,7
TCACGGCCCAAGAGAG-1_Br8667_Post_IF,1,0,1,1,0,3
CTACGATCCTATCCTA-1_Br8667_Post_IF,1,0,0,0,0,1
TGCAGTGGTAGGGAAC-1_Br8667_Post_IF,5,0,0,0,0,5
TTGCCTAATCCAAAGT-1_Br8667_Post_IF,3,0,2,0,0,5
AGCGAGACGTGAAGGC-1_Br8667_Post_IF,1,0,2,0,0,3
TTCTACCTCAATCGGT-1_Br8667_Post_IF,0,0,0,0,0,0
TACGCTGCTGTGTTAA-1_Br8667_Post_IF,3,0,1,0,0,4
TAGTCCTGCACTAAGC-1_Br8667_Post_IF,0,1,0,0,0,1
AGCACACGTTTAGACT-1_Br8667_Post_IF,2,1,1,0,0,4
GTTCGACAATTGTATA-1_Br8667_Post_IF,2,0,2,0,0,4
CCATGTTCATCTATAT-1_Br8667_Post_IF,0,3,0,1,0,4
CCCTCGATAATACACA-1_Br8667_Post_IF,2,2,0,0,0,4
ACTGCCCGCCATTCTC-1_Br8667_Post_IF,1,0,1,0,0,2
CTATATCCAGCCTGGC-1_Br8667_Post_IF,3,2,0,0,0,5
CGCACGTCTGTTTATG-1_Br8667_Post_IF,3,1,1,0,0,5
AATCAGGTTTCATTTA-1_Br8667_Post_IF,1,1,2,0,0,4
AGAGAAACACCAGAAA-1_Br8667_Post_IF,4,0,0,0,0,4
ACCCGATTGGTTCCGA-1_Br8667_Post_IF,1,0,0,0,0,1
TACCAGGAATCCCGTC-1_Br8667_Post_IF,0,0,0,0,0,0
AAGTGCTTCTCTATTG-1_Br8667_Post_IF,3,2,2,0,0,7
TGCATGTGACCCATAG-1_Br8667_Post_IF,3,0,1,0,0,4
TAGATTCAAAGTGCGG-1_Br8667_Post_IF,3,3,0,0,0,6
AGGGTCAGAGCACTCG-1_Br8667_Post_IF,4,2,0,0,0,6
GTGAGATAACCTTATA-1_Br8667_Post_IF,4,1,2,0,0,7
GTGTCAGTGTACGTGG-1_Br8667_Post_IF,2,0,0,0,0,2
CTGTAGTGAGGATCGA-1_Br8667_Post_IF,2,7,0,0,0,9
GATAGTGCGAGTAAGT-1_Br8667_Post_IF,5,0,0,0,0,5
AGGGTTCAGACGGTCC-1_Br8667_Post_IF,0,5,1,0,0,6
GGACTCGACAGCGCAT-1_Br8667_Post_IF,1,2,0,0,0,3
CACTCTCAAGCATCGA-1_Br8667_Post_IF,5,1,0,0,0,6
GAGCGGAATGCGGTGT-1_Br8667_Post_IF,1,2,1,0,0,4
CAGTTCGAGGACCCGA-1_Br8667_Post_IF,1,1,0,0,0,2
CGTAACTTCGACACTT-1_Br8667_Post_IF,3,0,1,0,0,4
TGATCACCACACTGAC-1_Br8667_Post_IF,2,4,0,1,0,7
CATACTTCTTTCTCCG-1_Br8667_Post_IF,3,2,1,0,0,6
CAAGTAAGTGATAGAC-1_Br8667_Post_IF,1,2,0,0,0,3
AGCCCGCAACAAGCAG-1_Br8667_Post_IF,0,3,0,0,0,3
GCTCCATGCAAAGCAA-1_Br8667_Post_IF,2,0,0,0,0,2
TCGTACCGACGTCAAG-1_Br8667_Post_IF,2,0,2,2,0,6
ATTATCGGAATGTACG-1_Br8667_Post_IF,0,1,2,0,0,3
ACCTACTATAAATCTA-1_Br8667_Post_IF,8,0,3,1,1,13
TATCCTATCAACTGGT-1_Br8667_Post_IF,0,0,0,0,0,0
GCGCGGTCTAGTAACT-1_Br8667_Post_IF,5,3,1,0,0,9
CCTTCGTATAGAATCC-1_Br8667_Post_IF,0,2,0,0,0,2
TGGGCGATACAATAAG-1_Br8667_Post_IF,1,1,1,0,0,3
TGACATGTAACGTGAC-1_Br8667_Post_IF,3,0,1,0,0,4
TTGGGAAGACGAGCCG-1_Br8667_Post_IF,2,1,1,0,0,4
GGTGTAAATCGATTGT-1_Br8667_Post_IF,3,1,1,0,0,5
GAACTGTGGAGAGACA-1_Br8667_Post_IF,0,1,0,0,0,1
TCCACATCGTATATTG-1_Br8667_Post_IF,2,2,0,0,0,4
CCTATGGTCAAAGCTG-1_Br8667_Post_IF,0,2,0,0,0,2
TCCTTGTCCTTTAATT-1_Br8667_Post_IF,1,0,1,1,0,3
AAGTTTATGGGCCCAA-1_Br8667_Post_IF,0,0,0,0,0,0
GTCCGGGTTCACATTA-1_Br8667_Post_IF,0,0,1,0,0,1
ATGTAGCGCGCGTAGG-1_Br8667_Post_IF,3,4,2,1,0,10
TACGGAAGCCAAACCA-1_Br8667_Post_IF,2,1,2,0,0,5
GCCCTGAGGATGGGCT-1_Br8667_Post_IF,2,1,3,0,1,7
CGGGCGATGGATCACG-1_Br8667_Post_IF,4,0,2,0,1,7
TGCGGACTTGACTCCG-1_Br8667_Post_IF,0,1,2,2,0,5
TAATACTAGAACAGAC-1_Br8667_Post_IF,1,0,1,0,0,2
TCAAATTGTTGTGCCG-1_Br8667_Post_IF,0,1,5,0,0,6
GGGCAGTCAACGCCAA-1_Br8667_Post_IF,1,1,1,3,0,6
TCGCTGCCAATGCTGT-1_Br8667_Post_IF,1,3,1,2,0,7
TACGTGGGCCCAGGGC-1_Br8667_Post_IF,0,0,0,1,0,1
GCCTACGTTCTGTGCA-1_Br8667_Post_IF,0,0,0,0,0,0
TTGCGTGTGTAGGCAT-1_Br8667_Post_IF,0,3,0,1,0,4
TCCTAAAGATTCAGAC-1_Br8667_Post_IF,3,0,1,0,3,7
TGGGTGCACAAGCCAT-1_Br8667_Post_IF,1,0,2,0,0,3
GGGAGCGACCGTAGTG-1_Br8667_Post_IF,0,1,0,1,0,2
CATAGAGGAGATACTA-1_Br8667_Post_IF,1,1,0,0,0,2
CTTCGATTGCGCAAGC-1_Br8667_Post_IF,2,1,2,0,0,5
GTGCCTGAGACCAAAC-1_Br8667_Post_IF,1,1,0,1,0,3
TCATCCTCAGCTGCTT-1_Br8667_Post_IF,1,4,1,0,0,6
TGCAACTACTGGTTGA-1_Br8667_Post_IF,0,2,2,4,0,8
ATGTTGATTAGAGACT-1_Br8667_Post_IF,1,4,0,0,0,5
GTTTCTAGAGGCGCGG-1_Br8667_Post_IF,0,0,3,2,0,5
TACAAGGGCTTCTTTA-1_Br8667_Post_IF,0,0,1,3,0,4
ACAGGCACGGATCCTT-1_Br8667_Post_IF,3,0,1,1,0,5
CCCAAGTCATTACACT-1_Br8667_Post_IF,3,1,0,1,0,5
ACTCTGACCTAATAGA-1_Br8667_Post_IF,1,1,0,0,0,2
GGATGGCTTGAAGTAT-1_Br8667_Post_IF,2,0,4,1,0,7
ACCCTCCCGTCAGGGC-1_Br8667_Post_IF,2,2,0,0,0,4
AGCTTCTTCTCGAGCA-1_Br8667_Post_IF,1,4,1,0,0,6
TTGCGCTTGATCAATA-1_Br8667_Post_IF,2,1,0,1,0,4
TGGGTGTAATAGATTT-1_Br8667_Post_IF,0,1,0,0,0,1
CATGGTTTATTAATCA-1_Br8667_Post_IF,2,0,0,0,0,2
TTGCCTTCTCGCCGGG-1_Br8667_Post_IF,3,2,1,0,0,6
TTAAAGTAAGTCGCCA-1_Br8667_Post_IF,0,1,0,1,0,2
AGTTGGCAAGGCTAGA-1_Br8667_Post_IF,1,1,1,0,0,3
CCGCACTTGCAATGAC-1_Br8667_Post_IF,4,0,1,0,0,5
AATGTTGTCGTGAGAC-1_Br8667_Post_IF,2,0,1,0,0,3
CCAAGGTTGCCCTTTC-1_Br8667_Post_IF,1,2,0,2,0,5
TGTGACTAGAGTTTGC-1_Br8667_Post_IF,0,2,0,0,0,2
TTGTGATCTGTTCAGT-1_Br8667_Post_IF,0,1,0,0,0,1
GGAGTTGATTCTGTGT-1_Br8667_Post_IF,0,1,1,0,0,2
GTAGTGAGCAACCTCA-1_Br8667_Post_IF,0,1,0,0,0,1
AAGACATACGTGGTTT-1_Br8667_Post_IF,2,0,0,2,0,4
CATCCCGAGATTCATA-1_Br8667_Post_IF,1,0,0,0,0,1
GGCCGCAGGAACCGCA-1_Br8667_Post_IF,3,1,2,1,0,7
CCAGAAACTGATGCGA-1_Br8667_Post_IF,1,1,2,0,0,4
ACCCGTAGTCTAGTTG-1_Br8667_Post_IF,1,0,0,0,0,1
AGGGTCTGGACGCAGT-1_Br8667_Post_IF,0,2,0,0,0,2
TTGAAACCCTCATTCC-1_Br8667_Post_IF,2,1,1,1,0,5
TCAATCCCGCGCCAAA-1_Br8667_Post_IF,1,2,0,2,0,5
AGGACATCGGCACACT-1_Br8667_Post_IF,0,1,1,0,1,3
GACAAGACGCCCGTGC-1_Br8667_Post_IF,0,3,1,0,0,4
GAGTAAATTAAGAACC-1_Br8667_Post_IF,0,0,0,3,0,3
TAAGTCGGTGAGCTAG-1_Br8667_Post_IF,1,1,1,4,0,7
CTTACTGACTCCTCTG-1_Br8667_Post_IF,0,3,0,4,0,7
GGGCGATCCATAGGCC-1_Br8667_Post_IF,1,0,0,1,0,2
CGTATTGTTTGGCGCC-1_Br8667_Post_IF,3,1,1,0,0,5
CGCGTGGGCCTGTGTT-1_Br8667_Post_IF,1,2,0,0,0,3
AAATCTGCCCGCGTCC-1_Br8667_Post_IF,1,1,1,0,0,3
GCTGAAGGGTTCTTGG-1_Br8667_Post_IF,1,1,3,0,0,5
TAATTGCGCTGATTAC-1_Br8667_Post_IF,0,0,0,0,2,2
TCGCGCGTTTACATGA-1_Br8667_Post_IF,2,2,0,0,0,4
TAACTGAAATACGCCT-1_Br8667_Post_IF,2,0,1,0,0,3
CCTGTCGTGTATGAAG-1_Br8667_Post_IF,0,1,1,0,0,2
CGGGAACGCCCTGCAT-1_Br8667_Post_IF,0,4,1,0,0,5
AGTTGCGGTCCTCAAC-1_Br8667_Post_IF,1,1,1,0,0,3
GGGTCCTTGGAAGAAG-1_Br8667_Post_IF,3,0,0,0,0,3
CGGGAAGTACCGTGGC-1_Br8667_Post_IF,1,0,1,0,0,2
ACGGTCACCGAGAACA-1_Br8667_Post_IF,1,0,0,0,0,1
TAGACTCAGTTGGCCT-1_Br8667_Post_IF,1,0,0,0,0,1
CCTTCCGCAACGCTGC-1_Br8667_Post_IF,2,1,2,0,0,5
CAGTGTTAATCTCTCA-1_Br8667_Post_IF,1,0,0,1,0,2
CAGGCCAGTACCACCT-1_Br8667_Post_IF,9,0,0,0,0,9
GATCGCTGTGGTGCGT-1_Br8667_Post_IF,0,0,0,0,0,0
GTATCTCGGGCGCTTT-1_Br8667_Post_IF,6,1,0,0,0,7
CCGGGCTAAGAATTTC-1_Br8667_Post_IF,0,1,1,0,0,2
CTTCACGCCCTGGTAC-1_Br8667_Post_IF,1,1,0,1,0,3
CGGATGAATGCTGTGA-1_Br8667_Post_IF,1,0,1,0,0,2
CTCTGCAGGCATTCTT-1_Br8667_Post_IF,0,3,0,0,0,3
TCAAAGTCACGGCGTC-1_Br8667_Post_IF,5,1,0,0,0,6
TGGGTTTCGGGCGTAC-1_Br8667_Post_IF,0,0,0,0,0,0
TGCTATGGCAAAGGGA-1_Br8667_Post_IF,3,1,0,0,0,4
TTCACGGTCGTCACGT-1_Br8667_Post_IF,0,0,0,0,0,0
CGTAAAGCAAGAAATC-1_Br8667_Post_IF,1,1,0,0,0,2
CTGATCCCTTTATGCA-1_Br8667_Post_IF,3,0,1,0,0,4
GAGTATACCCTAATCA-1_Br8667_Post_IF,4,1,0,1,0,6
CCACGGCAGGTGTAGG-1_Br8667_Post_IF,0,1,0,0,0,1
ACGTACTTTGGCACGG-1_Br8667_Post_IF,1,0,0,0,0,1
CCTGAGAATAAATGCA-1_Br8667_Post_IF,2,2,0,0,0,4
TTGATGCCGCTCGTCG-1_Br8667_Post_IF,3,0,0,0,0,3
GCCAGGAAAGAACACT-1_Br8667_Post_IF,3,1,1,0,0,5
TCCGACCGCTAATCAA-1_Br8667_Post_IF,2,3,0,1,0,6
TATATCAAAGTGATCT-1_Br8667_Post_IF,3,2,1,0,0,6
CCTCGGTTTCCTTGCC-1_Br8667_Post_IF,1,3,0,0,0,4
TAAATTTAGTAACACC-1_Br8667_Post_IF,1,2,0,0,0,3
CTCGTTACGGCTACCA-1_Br8667_Post_IF,3,3,0,0,0,6
GCCGTCGGTTTCGGGC-1_Br8667_Post_IF,2,1,2,0,0,5
GTTCCGTCCGCCTGCA-1_Br8667_Post_IF,2,1,2,0,0,5
CTAGGGATAGGGACAA-1_Br8667_Post_IF,3,0,1,0,0,4
GTCCAGGCACGTGTGC-1_Br8667_Post_IF,1,4,1,0,0,6
GAGGAATATCTCTTTG-1_Br8667_Post_IF,1,2,0,0,1,4
CGTTCAAGGAAACGGA-1_Br8667_Post_IF,2,1,1,1,0,5
GTGGGAACAAACCGGG-1_Br8667_Post_IF,2,1,1,1,0,5
GGGCACGTAGTACTGT-1_Br8667_Post_IF,2,3,1,1,0,7
ACTACAAAGAGAGGTG-1_Br8667_Post_IF,2,1,1,0,1,5
GGTGTAGGTAAGTAAA-1_Br8667_Post_IF,3,1,1,1,0,6
CCTGTTCAACCTCGGG-1_Br8667_Post_IF,4,1,1,0,0,6
TGAGGTGTGTGGCGGA-1_Br8667_Post_IF,3,1,1,1,0,6
ATTGTCTGTTTCATGT-1_Br8667_Post_IF,2,0,2,0,0,4
GCCGGTCGTATCTCTC-1_Br8667_Post_IF,3,1,1,1,0,6
ATATGGGATAGCAACT-1_Br8667_Post_IF,3,1,1,1,0,6
GATAGAACCCGCTAGG-1_Br8667_Post_IF,1,1,1,0,0,3
ATCCCATTTCCGTGGG-1_Br8667_Post_IF,5,2,0,0,0,7
GATGCTACCTTCGATG-1_Br8667_Post_IF,1,2,1,0,0,4
TGCAAAGTTCGTCTGT-1_Br8667_Post_IF,3,2,1,0,0,6
GTTCAGTCGCCAAATG-1_Br8667_Post_IF,2,0,1,0,0,3
GTCTCCGCCTCAATAC-1_Br8667_Post_IF,2,2,0,1,0,5
AGTAGAAGGCGCCTCA-1_Br8667_Post_IF,0,1,1,0,0,2
GTTGTAGATTTATGAG-1_Br8667_Post_IF,3,0,1,1,0,5
CTATTTGCTTGGAGGA-1_Br8667_Post_IF,2,0,0,0,0,2
AGCCATATAGTATGTG-1_Br8667_Post_IF,2,0,2,0,0,4
TGTTCCGGCCTGAGCT-1_Br8667_Post_IF,4,1,5,0,0,10
TGCCGTGGGACCCAAT-1_Br8667_Post_IF,3,0,0,0,0,3
TTGCAAGAAGACTCCT-1_Br8667_Post_IF,0,0,2,0,0,2
CCGCTCCAGGGCGATC-1_Br8667_Post_IF,2,0,2,0,1,5
CAAACCCTCCGGCGGG-1_Br8667_Post_IF,1,3,0,0,0,4
CGGACCTTTACGTCCC-1_Br8667_Post_IF,1,1,1,1,0,4
ACGTAGGAGAGTCGCT-1_Br8667_Post_IF,5,0,2,0,0,7
CTGCGACCTCGCCGAA-1_Br8667_Post_IF,1,1,0,1,0,3
GGCCCAGCTGGTTTGC-1_Br8667_Post_IF,1,3,1,0,0,5
GGATTAATCATGGACC-1_Br8667_Post_IF,2,3,0,0,0,5
GAGATGGCTTTAATCA-1_Br8667_Post_IF,4,2,0,1,0,7
AGTACAGAAGCTTATA-1_Br8667_Post_IF,2,0,0,1,0,3
GCGGCTTTAGCAAGTT-1_Br8667_Post_IF,1,0,7,2,0,10
ACCGAGTCTCCTTATT-1_Br8667_Post_IF,1,4,5,1,0,11
GACCACACTTCCCTTT-1_Br8667_Post_IF,0,2,3,2,0,7
TGTAGCCAATTCCGTT-1_Br8667_Post_IF,1,1,2,1,0,5
CTCGTCTGTGCCTTCG-1_Br8667_Post_IF,0,0,1,1,0,2
GGACTCTTTGACTAAG-1_Br8667_Post_IF,2,0,2,1,0,5
TCATCGACGACCGTCG-1_Br8667_Post_IF,0,0,2,0,1,3
TACTACGTGCAATGCG-1_Br8667_Post_IF,3,0,0,0,0,3
CCCTACTTGAACAATG-1_Br8667_Post_IF,1,2,0,0,0,3
GCAGCTGTCAACGCAT-1_Br8667_Post_IF,0,1,0,1,1,3
ATCTACCATCTGCTCC-1_Br8667_Post_IF,3,1,0,1,0,5
TCTCAAATCAATCGGG-1_Br8667_Post_IF,0,1,6,4,0,11
ACTCCGGCCGACCACT-1_Br8667_Post_IF,3,2,0,0,0,5
TACACCTCTTCGAATC-1_Br8667_Post_IF,0,0,2,1,1,4
GTGGCTGTTTCTGTTC-1_Br8667_Post_IF,0,1,0,3,0,4
ACGACTCTAGGGCCGA-1_Br8667_Post_IF,2,2,2,0,0,6
TCGTTTACGCGACCCT-1_Br8667_Post_IF,0,1,0,0,0,1
AGGATATCCGACTGCA-1_Br8667_Post_IF,2,0,1,1,0,4
GACACTTCCAATTACC-1_Br8667_Post_IF,2,2,0,1,0,5
ACGGTACAGTTCAATG-1_Br8667_Post_IF,1,0,0,0,0,1
CTTGATGACCATCCAG-1_Br8667_Post_IF,3,5,4,2,0,14
CTGGTAAAGACTTACA-1_Br8667_Post_IF,1,4,4,0,0,9
CTTGCCCACCCACGCA-1_Br8667_Post_IF,1,3,1,0,0,5
CATTACGCAGGAAGGG-1_Br8667_Post_IF,0,5,2,4,0,11
GGACAACCATGAAGCC-1_Br8667_Post_IF,2,0,0,1,0,3
GTTATCAAGCTATCGA-1_Br8667_Post_IF,1,7,0,3,0,11
AGGTGCACGTCCACAT-1_Br8667_Post_IF,3,2,2,1,0,8
AAAGAATGTGGACTAA-1_Br8667_Post_IF,0,1,2,6,0,9
ACCAAGTCATCGGCAG-1_Br8667_Post_IF,1,3,3,3,0,10
AGTAACTATAGCAGCC-1_Br8667_Post_IF,0,0,2,2,0,4
GGGAAAGAATGCCAAC-1_Br8667_Post_IF,4,0,1,0,0,5
AATCGGTATAGCCCTC-1_Br8667_Post_IF,0,1,4,3,0,8
GGCACTGCGGTGGTTT-1_Br8667_Post_IF,1,1,0,1,0,3
CGTCCTCATCGCGTGC-1_Br8667_Post_IF,1,1,0,1,0,3
CTTAACTTACAGTATA-1_Br8667_Post_IF,1,0,0,1,0,2
GTGAGTCGACTAATAG-1_Br8667_Post_IF,2,2,0,0,0,4
TGTACTTCCGGGCATG-1_Br8667_Post_IF,0,1,3,0,0,4
CACAAACCGCAGAACT-1_Br8667_Post_IF,2,2,0,0,0,4
GCTTTACACAACTGGG-1_Br8667_Post_IF,1,2,0,3,0,6
CACCGATGATGGGTAC-1_Br8667_Post_IF,0,1,1,0,0,2
TCAATATACAGGAGGC-1_Br8667_Post_IF,1,2,1,0,0,4
AACGACCTCCTAGCCG-1_Br8667_Post_IF,0,2,0,6,0,8
GTTACCAAGGCGTACG-1_Br8667_Post_IF,0,0,0,1,1,2
TAGCTCACTGTGTTTG-1_Br8667_Post_IF,2,1,1,5,0,9
TCGGCAGGGTTAAGGG-1_Br8667_Post_IF,0,0,2,6,0,8
CAGAGCGATGGATGCT-1_Br8667_Post_IF,0,0,0,1,0,1
TCCGCTGGGTCGATCG-1_Br8667_Post_IF,3,1,0,0,0,4
TTAGCATCCCTCACGT-1_Br8667_Post_IF,2,2,1,0,0,5
AGCCTTGTCACTGATA-1_Br8667_Post_IF,0,2,2,0,0,4
GTTTCTTGTTAGAGCT-1_Br8667_Post_IF,2,1,1,0,0,4
TCGGAGTCCTGGTTGC-1_Br8667_Post_IF,3,0,2,0,0,5
ACGGGTTGTGACCTGT-1_Br8667_Post_IF,1,1,1,0,0,3
TGACAGAAATCTTGCT-1_Br8667_Post_IF,0,2,0,0,0,2
TAGCCATGATTGCCTA-1_Br8667_Post_IF,2,2,0,0,0,4
CGAAGCCACAGCATGG-1_Br8667_Post_IF,4,0,2,0,0,6
ACCCGTAGCAGAGAAT-1_Br8667_Post_IF,3,1,1,0,0,5
AGCTTGATCAGGGTAG-1_Br8667_Post_IF,3,0,0,0,0,3
CTATAAGTAGGGTTTG-1_Br8667_Post_IF,1,1,0,0,0,2
TATAGTTAGGTGTACT-1_Br8667_Post_IF,1,0,1,0,0,2
TACGCTGATAGTTGTA-1_Br8667_Post_IF,2,0,0,0,0,2
TTCTCAATTGCTACAA-1_Br8667_Post_IF,2,0,0,0,0,2
GTTGCCCTAACGGGTG-1_Br8667_Post_IF,2,2,2,0,0,6
GACATTTCGCCCAGCC-1_Br8667_Post_IF,1,0,0,0,0,1
GTAACTACGTAGACCT-1_Br8667_Post_IF,1,1,0,0,0,2
CCAGTGTACAGACCGA-1_Br8667_Post_IF,0,0,0,0,0,0
GCCCGATGCCCAGTTC-1_Br8667_Post_IF,1,2,2,0,0,5
CGAACCTCTTTCCTAG-1_Br8667_Post_IF,3,0,0,0,0,3
CATGCACATGAGAGGC-1_Br8667_Post_IF,4,1,0,0,0,5
CCAAATCAAAGGGCAA-1_Br8667_Post_IF,3,0,1,1,0,5
GTAGTTTAAGCACACG-1_Br8667_Post_IF,1,2,2,0,0,5
TAAGTGAATAGTCTAC-1_Br8667_Post_IF,2,0,0,0,0,2
GGTCCACGTCTATTTG-1_Br8667_Post_IF,4,1,0,0,0,5
CCCTCAGATCGAGAAC-1_Br8667_Post_IF,2,3,0,0,0,5
ACATTCGCGCGGAATA-1_Br8667_Post_IF,1,1,0,0,0,2
CTATGAACACCTTGCC-1_Br8667_Post_IF,2,2,1,1,0,6
CGAATGGTAGGTCGTC-1_Br8667_Post_IF,1,3,0,0,0,4
TCGACATAGCGTAGCG-1_Br8667_Post_IF,3,1,3,0,0,7
GACGTTGCTCGGCGGC-1_Br8667_Post_IF,0,3,4,0,0,7
CTCGAGGCAAGTTTCA-1_Br8667_Post_IF,2,5,0,0,0,7
GCTGGGAGCGCGTCAA-1_Br8667_Post_IF,2,1,2,0,0,5
GACGATATCACTGGGT-1_Br8667_Post_IF,1,2,3,0,0,6
CAGCTCTGGGCTCACT-1_Br8667_Post_IF,3,0,2,0,0,5
TAGTCTGCGGCACATT-1_Br8667_Post_IF,1,0,0,0,0,1
TGGTCGATATACCTCT-1_Br8667_Post_IF,1,0,0,0,0,1
TTCAGTTCAAGAGGAG-1_Br8667_Post_IF,4,0,0,0,0,4
GTCTGTAGGTTGAACA-1_Br8667_Post_IF,1,1,0,0,0,2
GAGAGTCTCGGGAGAG-1_Br8667_Post_IF,1,0,1,0,0,2
TTGTTTGTATTACACG-1_Br8667_Post_IF,0,0,0,1,1,2
GCACAGCACGGGCCGA-1_Br8667_Post_IF,3,2,1,0,0,6
AAACAGTGTTCCTGGG-1_Br8667_Post_IF,3,0,3,0,0,6
TGGAGAATAATCGTCC-1_Br8667_Post_IF,0,2,1,0,0,3
CGCCGCGTTCTGAACG-1_Br8667_Post_IF,0,1,2,0,0,3
CATGCGTTGAGAGGAG-1_Br8667_Post_IF,2,0,1,1,0,4
TACGCTCCTAGAACTG-1_Br8667_Post_IF,3,1,0,0,0,4
CCTTGTGAACGTGGTT-1_Br8667_Post_IF,1,0,0,0,0,1
TTAAAGGCGATGCTCG-1_Br8667_Post_IF,3,1,0,0,0,4
TAAAGTGCACGTCTCG-1_Br8667_Post_IF,2,4,1,0,0,7
TGTCCGCAAACAATTC-1_Br8667_Post_IF,4,1,0,0,0,5
AGGCCTATCATACCAA-1_Br8667_Post_IF,2,0,0,0,0,2
ACTGGGATGCCAGTGC-1_Br8667_Post_IF,0,0,0,0,0,0
CGATCCACCATTGTTG-1_Br8667_Post_IF,1,1,0,0,0,2
GGGCATGCATGTCGAG-1_Br8667_Post_IF,0,1,2,0,0,3
TCCAGGCAGGACGATC-1_Br8667_Post_IF,2,0,1,1,0,4
CAATGACCCTTAATTT-1_Br8667_Post_IF,4,1,1,0,0,6
ATCAAGATCCCAGGAC-1_Br8667_Post_IF,1,0,1,0,0,2
CTCAGAGCTAATGTCG-1_Br8667_Post_IF,1,2,0,0,0,3
CTGCGATTTCGAGATT-1_Br8667_Post_IF,1,1,1,1,0,4
ATGGTATTGGGAACCG-1_Br8667_Post_IF,0,4,1,0,0,5
TAGGTTCTGCTGAGAA-1_Br8667_Post_IF,5,1,2,0,0,8
GCCTGTCCCGGTGCAT-1_Br8667_Post_IF,1,0,3,0,0,4
GGCCTGCTCTGATGTT-1_Br8667_Post_IF,1,1,1,0,0,3
TAGAGGGAGTTTATCT-1_Br8667_Post_IF,1,0,2,0,0,3
CTCTACATCCTGCGTG-1_Br8667_Post_IF,1,0,0,0,0,1
ACACATTTCCGTAGAC-1_Br8667_Post_IF,3,1,1,0,0,5
TGGGTGTTAAGTAGAA-1_Br8667_Post_IF,0,0,1,0,0,1
GAGCTCAACATGAGCG-1_Br8667_Post_IF,0,0,0,0,0,0
GCACACAGCTATTACC-1_Br8667_Post_IF,1,0,1,2,0,4
GCGACGGTAGTCTCCT-1_Br8667_Post_IF,5,1,0,0,0,6
GTATCAAGGTACTTCC-1_Br8667_Post_IF,0,4,0,0,0,4
GGAAAGGGAATTGAGC-1_Br8667_Post_IF,1,2,1,1,0,5
TACACAGCCGTGGTGC-1_Br8667_Post_IF,1,1,0,0,0,2
CGGTTGGGCAGGGTCC-1_Br8667_Post_IF,1,0,0,1,0,2
GCACGCCGATTCCCGC-1_Br8667_Post_IF,1,0,3,3,0,7
CGCTTTCCGCCAAGGT-1_Br8667_Post_IF,1,2,3,3,0,9
TGCCCGATAGTTAGAA-1_Br8667_Post_IF,1,1,2,3,0,7
TCAGAACGGCGGTAAT-1_Br8667_Post_IF,0,0,0,7,0,7
CCACTCAGATCCGCAA-1_Br8667_Post_IF,1,0,1,1,0,3
GAAGGGTCATTAAGAC-1_Br8667_Post_IF,0,2,2,1,0,5
GCGGTCTTGCTTTCAC-1_Br8667_Post_IF,0,1,1,0,0,2
GGAAGGACACCGTATA-1_Br8667_Post_IF,0,0,1,2,0,3
CGCGGGAATTCCTTTC-1_Br8667_Post_IF,0,0,1,0,1,2
TCTATCCGATTGCACA-1_Br8667_Post_IF,0,0,2,2,2,6
TACTCGTTTGAATCAA-1_Br8667_Post_IF,2,0,4,2,0,8
GTCTGCCGACTCGACG-1_Br8667_Post_IF,0,2,3,4,1,10
TACGGGTAATAACATA-1_Br8667_Post_IF,1,2,5,2,0,10
CCAGTTCGGTAACTCA-1_Br8667_Post_IF,0,0,0,4,0,4
CGTGCACACCACTGTA-1_Br8667_Post_IF,0,1,0,1,0,2
CTTCAGTTGGACAACG-1_Br8667_Post_IF,1,1,1,1,0,4
TGATCTATCACACTCT-1_Br8667_Post_IF,0,0,0,0,0,0
TAGCAGATACTTAGGG-1_Br8667_Post_IF,3,0,0,0,0,3
CACCGGGCATCACAAG-1_Br8667_Post_IF,5,1,1,1,0,8
AGTGGCCCGCAAATGG-1_Br8667_Post_IF,2,1,0,0,0,3
CTCGCTAGGTAAGCGA-1_Br8667_Post_IF,1,0,1,0,0,2
GATAGATAGTACAGTC-1_Br8667_Post_IF,1,0,1,2,0,4
CGAGACTACTGCTGCT-1_Br8667_Post_IF,1,3,1,1,0,6
ACATTTGAAACCTAAC-1_Br8667_Post_IF,1,0,0,6,0,7
GACACAGCCGGGACTG-1_Br8667_Post_IF,1,1,0,5,0,7
ACGGAACACGAGTGCC-1_Br8667_Post_IF,1,1,0,4,0,6
ACGCCAGTGCGTTTGC-1_Br8667_Post_IF,0,2,2,2,0,6
GCACCTAGGCGAGTCC-1_Br8667_Post_IF,1,0,0,0,0,1
TCACTATCCCTTCGGT-1_Br8667_Post_IF,2,3,3,3,0,11
ATTGGTTGTGCATTAC-1_Br8667_Post_IF,3,1,1,2,0,7
CTGGCGATTTACATGT-1_Br8667_Post_IF,1,0,0,0,1,2
TCCACCAAGACATAGG-1_Br8667_Post_IF,2,1,0,1,0,4
AACGTCGCTGCACTTC-1_Br8667_Post_IF,1,0,0,1,0,2
GTCTCCCGAGTCCCGT-1_Br8667_Post_IF,2,1,0,0,0,3
AGCCCGCACTACAATG-1_Br8667_Post_IF,1,0,0,0,0,1
GGCACGCTGCTACAGT-1_Br8667_Post_IF,2,2,0,0,0,4
GCTTGAGTGACCTCTG-1_Br8667_Post_IF,2,2,0,0,0,4
ATAGCCATAACAGTCA-1_Br8667_Post_IF,2,1,0,2,0,5
TAGGAGGCTCGAGAAC-1_Br8667_Post_IF,1,5,0,2,0,8
GTCGGGTGAAGTACCG-1_Br8667_Post_IF,4,2,0,0,0,6
CACCCGCGTTTGACAC-1_Br8667_Post_IF,0,2,1,2,0,5
TCTCAGGCTACTCGCT-1_Br8667_Post_IF,0,0,1,4,0,5
CCCATTATTGTATCCT-1_Br8667_Post_IF,0,0,0,0,0,0
ATACAGCGTCCACTGA-1_Br8667_Post_IF,1,1,0,1,0,3
TCACGATTAATACGTT-1_Br8667_Post_IF,0,4,0,0,0,4
CGTGAACTGACCCGAT-1_Br8667_Post_IF,0,2,0,1,0,3
TCGATGTTACGGCCGT-1_Br8667_Post_IF,0,1,0,0,0,1
GACCGGTGATACTCTC-1_Br8667_Post_IF,3,3,1,0,0,7
TCTGTTTAGATTGTTC-1_Br8667_Post_IF,3,0,0,0,0,3
GCTACTCGGACGCAGA-1_Br8667_Post_IF,2,3,2,0,0,7
AAGAAAGTTTGATGGG-1_Br8667_Post_IF,1,2,0,0,0,3
CGCCAGTAGTACCTTG-1_Br8667_Post_IF,2,1,0,0,0,3
CTCCCTTGTATCAAGG-1_Br8667_Post_IF,4,2,2,2,0,10
ACTTTATACACCACTT-1_Br8667_Post_IF,4,1,1,0,0,6
AGATCTGGAGAGGATA-1_Br8667_Post_IF,1,2,2,1,0,6
TCATCCATCTGATCAC-1_Br8667_Post_IF,1,2,1,0,0,4
AGAACACGGCGATGGT-1_Br8667_Post_IF,3,5,1,3,0,12
CCGCTCCGGATAAGCT-1_Br8667_Post_IF,3,0,0,0,2,5
TGGTCGGGTACAGGGC-1_Br8667_Post_IF,2,0,2,2,0,6
ACGGACGCAGCGACAA-1_Br8667_Post_IF,3,1,1,0,0,5
ACATGCTTACGGCAGC-1_Br8667_Post_IF,0,1,2,2,0,5
CAGGGAGATAGGCCAG-1_Br8667_Post_IF,2,1,0,0,0,3
TCGCCACCCGGATTAC-1_Br8667_Post_IF,1,3,1,2,0,7
TCTTGGTCAATGATAC-1_Br8667_Post_IF,3,1,0,0,0,4
CATAGGGACACTTGTG-1_Br8667_Post_IF,0,0,0,0,0,0
CACGAGCAAACCAGAC-1_Br8667_Post_IF,1,3,0,1,0,5
GGGATATTGATCGCCA-1_Br8667_Post_IF,1,0,3,3,0,7
TAATGTCGGTTCATGG-1_Br8667_Post_IF,3,3,0,0,0,6
CGATTTGTCATTAATG-1_Br8667_Post_IF,1,3,0,1,0,5
TTAAGATACCCAGAGA-1_Br8667_Post_IF,5,2,0,0,0,7
CGACCGTTGGTATTCG-1_Br8667_Post_IF,2,4,0,0,0,6
ACTACCATCCGAGGGC-1_Br8667_Post_IF,3,2,1,0,0,6
TCTACGCACGATCTCC-1_Br8667_Post_IF,0,0,1,1,0,2
AAGCCACTTGCAGGTA-1_Br8667_Post_IF,0,3,3,0,0,6
ACGTTGTCGTTGAAAG-1_Br8667_Post_IF,2,1,0,0,0,3
ACCGCTAGTCATTGGT-1_Br8667_Post_IF,4,1,0,0,0,5
CATGAGTCCATCACGG-1_Br8667_Post_IF,3,1,2,0,0,6
ATGTCTTGTTTGACTC-1_Br8667_Post_IF,0,4,1,0,0,5
TCCCAAACATCCTCTA-1_Br8667_Post_IF,0,0,1,0,0,1
CAACGCGATGAGCCAA-1_Br8667_Post_IF,1,3,1,0,0,5
GACACCCAAAGACGCG-1_Br8667_Post_IF,1,2,4,0,0,7
ACGTTCACTATGCCGC-1_Br8667_Post_IF,0,0,2,0,0,2
ATGGACTGCTTAGTTG-1_Br8667_Post_IF,3,0,1,0,0,4
CCATGGCAAACGCTCA-1_Br8667_Post_IF,0,2,1,0,0,3
TTGTCTCGGCAAGATG-1_Br8667_Post_IF,4,1,3,0,0,8
TTCGAACGAAACATGC-1_Br8667_Post_IF,3,1,0,0,0,4
GGAAAGTCTTGATTGT-1_Br8667_Post_IF,0,1,2,1,0,4
ATCATAGATCGACGAG-1_Br8667_Post_IF,2,2,1,1,0,6
GATTAGAAACAAGCGT-1_Br8667_Post_IF,1,1,0,0,0,2
GCTGCGAAGAATTATT-1_Br8667_Post_IF,0,0,0,0,0,0
TTCCAGTGGGTTTCGT-1_Br8667_Post_IF,2,1,4,0,0,7
GCTCATTGATCATATC-1_Br8667_Post_IF,0,1,1,1,0,3
ATACGAGGTTTGTAAG-1_Br8667_Post_IF,1,1,0,0,0,2
GTCTATACACGCATGG-1_Br8667_Post_IF,0,1,1,0,0,2
GATTTGCGCTAACACC-1_Br8667_Post_IF,3,1,1,0,0,5
TGGTGCCCTGCCTTAC-1_Br8667_Post_IF,2,1,0,1,0,4
TCGAATCGCAGGGTAG-1_Br8667_Post_IF,0,2,0,0,0,2
GGTAGGCCAATATCAC-1_Br8667_Post_IF,1,3,1,0,0,5
CGTAAATAACAAAGGG-1_Br8667_Post_IF,0,0,0,1,0,1
GACTCTAGAGTTCCAA-1_Br8667_Post_IF,1,1,3,1,0,6
ACTTGTTACCGGATCA-1_Br8667_Post_IF,3,1,1,1,0,6
GGCATTGAACATCTCA-1_Br8667_Post_IF,0,0,2,0,0,2
AACCCGCTGTATTCCA-1_Br8667_Post_IF,0,1,0,0,0,1
TAACAGGTTCCCTTAG-1_Br8667_Post_IF,1,1,0,0,0,2
GTTCTTGTAACTCAAT-1_Br8667_Post_IF,2,1,0,1,0,4
GATTCTGTTAATGAGT-1_Br8667_Post_IF,0,2,0,0,0,2
GGACACCTCGGTGTTG-1_Br8667_Post_IF,2,0,4,0,0,6
CGATCGAGAAGCACCA-1_Br8667_Post_IF,1,0,2,1,0,4
CTGCTCTGACGGCAAA-1_Br8667_Post_IF,0,1,2,0,0,3
CCCAGGAAGAATTCGA-1_Br8667_Post_IF,1,1,0,0,0,2
TGTCGTGGGTATAGGC-1_Br8667_Post_IF,0,1,0,1,0,2
ATATGTCTAGAGCGTG-1_Br8667_Post_IF,2,0,2,0,0,4
GCGGGCAGACGGGTGA-1_Br8667_Post_IF,1,1,0,0,0,2
CGAAGATCAGTTTCAT-1_Br8667_Post_IF,0,0,1,0,0,1
ACGCCACTCGAAACAG-1_Br8667_Post_IF,0,1,0,1,0,2
CTTAGATGTTTCATCC-1_Br8667_Post_IF,1,0,0,2,0,3
GCGAATGGACTAGCGA-1_Br8667_Post_IF,0,2,0,1,0,3
TAAATTGTGGGTAAAG-1_Br8667_Post_IF,0,1,2,0,0,3
ATTTATACTGGTAAAG-1_Br8667_Post_IF,0,2,0,3,0,5
GCGTCGTAACATGGTC-1_Br8667_Post_IF,0,0,2,2,0,4
CGGTATGGGCACTCTG-1_Br8667_Post_IF,1,3,0,2,0,6
CTATCACAACGCTGGA-1_Br8667_Post_IF,0,1,1,5,0,7
ACCACACGGTTGATGG-1_Br8667_Post_IF,0,1,0,2,0,3
TCAGCGCACGCCGTTT-1_Br8667_Post_IF,1,1,0,0,0,2
AATGTTAAGACCCTGA-1_Br8667_Post_IF,0,1,3,7,0,11
CTTACATAGATTTCTT-1_Br8667_Post_IF,0,2,1,2,0,5
AACATAGCGTGTATCG-1_Br8667_Post_IF,0,0,3,4,0,7
AGCAGTCGAAGCATGC-1_Br8667_Post_IF,0,2,1,1,0,4
GTACTACGGCCTCGTT-1_Br8667_Post_IF,0,1,0,2,0,3
TTGGCCAAATTGTATC-1_Br8667_Post_IF,0,2,0,0,1,3
TCAGAGGACGCGTTAG-1_Br8667_Post_IF,2,2,1,2,0,7
AGTAATCTAAGGGTGG-1_Br8667_Post_IF,4,2,0,2,0,8
AATTATACCCAGCAAG-1_Br8667_Post_IF,0,2,3,3,0,8
CCCTACCCACACCCAG-1_Br8667_Post_IF,5,1,1,0,0,7
CTCTGTCCATGCACCA-1_Br8667_Post_IF,0,1,1,6,0,8
TCGCCTCCTTCGGCTC-1_Br8667_Post_IF,4,2,0,2,0,8
CCTGATTCGCGAAGAA-1_Br8667_Post_IF,0,1,1,2,0,4
GACTTCAACGCATCAA-1_Br8667_Post_IF,1,0,0,2,0,3
GCTTCCCGTAAGCTCC-1_Br8667_Post_IF,0,0,0,0,0,0
AGAACTGTACTTTGTA-1_Br8667_Post_IF,0,3,0,3,0,6
CCTTAAGTACGCAATT-1_Br8667_Post_IF,0,0,0,0,0,0
GGCCAATTGTATAGAC-1_Br8667_Post_IF,0,2,0,0,0,2
AGAATACAGGCTATCC-1_Br8667_Post_IF,1,0,0,0,0,1
AATACCTGATGTGAAC-1_Br8667_Post_IF,2,0,0,0,0,2
GCTTCCATGTAACCGC-1_Br8667_Post_IF,0,0,0,0,0,0
TCTAACCTAGCCTGCG-1_Br8667_Post_IF,0,0,0,0,0,0
GTCTTACCACGCCAAG-1_Br8667_Post_IF,7,0,0,0,0,7
CGTTTCGGTTATATGC-1_Br8667_Post_IF,0,0,0,1,0,1
CTGTCCTGCGCACTAC-1_Br8667_Post_IF,1,0,0,1,0,2
GCCCAGCGACACAAAG-1_Br8667_Post_IF,4,2,0,1,0,7
TATAGCTATTATCTCT-1_Br8667_Post_IF,2,0,1,0,0,3
AAGCTATGGATTGACC-1_Br8667_Post_IF,1,1,0,0,0,2
CCGAAACACGACCTCT-1_Br8667_Post_IF,5,1,0,0,0,6
ATCAGAAGCTGGTTGC-1_Br8667_Post_IF,0,2,0,0,0,2
TGAACCTGAATGTGAG-1_Br8667_Post_IF,2,0,1,0,0,3
TCAGAGCATGTCAACG-1_Br8667_Post_IF,3,1,0,0,0,4
ATACCCTCCCGGCCAA-1_Br8667_Post_IF,2,0,0,0,0,2
GCCACCTTATTCGCGA-1_Br8667_Post_IF,1,1,0,0,0,2
CAACGAGCTTATTATG-1_Br8667_Post_IF,3,0,1,0,0,4
GATCCAACCTTTAAAC-1_Br8667_Post_IF,0,0,1,0,0,1
TTGTGGAGACAGCCGG-1_Br8667_Post_IF,4,4,0,1,0,9
AGATAATCACACCTAT-1_Br8667_Post_IF,1,2,1,0,0,4
GGTTAGGGATGCTAAT-1_Br8667_Post_IF,1,2,0,0,0,3
TCATGAAGCGCTGCAT-1_Br8667_Post_IF,5,1,4,0,0,10
CCAGGCGAGATGGTCT-1_Br8667_Post_IF,0,3,1,1,0,5
CGACTTGCCGGGAAAT-1_Br8667_Post_IF,3,0,0,0,0,3
GTGCCAAACGTTTCGA-1_Br8667_Post_IF,0,1,0,7,0,8
TGCTCAAAGGATGCAC-1_Br8667_Post_IF,0,0,0,0,0,0
GCCTCAGGTACCGGTC-1_Br8667_Post_IF,0,3,1,5,0,9
ACAAGTAATTGTAAGG-1_Br8667_Post_IF,1,1,0,0,0,2
TTAGAGTATTGTCGAG-1_Br8667_Post_IF,3,5,0,2,0,10
GTCATCCCAAACTCAC-1_Br8667_Post_IF,2,1,0,1,0,4
CTCCTAGTAATCGTGA-1_Br8667_Post_IF,0,1,1,2,0,4
CCCTCATCACAGAGTA-1_Br8667_Post_IF,1,0,1,0,0,2
GGAAACAGAGCTTGGG-1_Br8667_Post_IF,0,0,0,5,0,5
ACATCGCAATATTCGG-1_Br8667_Post_IF,0,0,0,1,0,1
TTAGCCATAGGGCTCG-1_Br8667_Post_IF,5,3,3,6,0,17
CGGATTCTGCCTTATG-1_Br8667_Post_IF,2,2,1,3,0,8
TTGTTGGCAATGACTG-1_Br8667_Post_IF,0,2,1,0,0,3
GGATCTACCGTTCGTC-1_Br8667_Post_IF,1,3,0,3,0,7
GGTGGGATTAGGTCCC-1_Br8667_Post_IF,0,3,1,3,0,7
AATAGGCACGACCCTT-1_Br8667_Post_IF,0,1,1,1,0,3
GAGGTCCGTTCGCTGT-1_Br8667_Post_IF,0,2,1,0,0,3
TGACAACTTAAAGGTG-1_Br8667_Post_IF,0,4,1,0,0,5
AGCTAAGCTCCGTCCG-1_Br8667_Post_IF,0,2,1,3,0,6
CTAGCCCGGGAGACGA-1_Br8667_Post_IF,2,0,0,2,0,4
CCCAGATTCCCGTGAC-1_Br8667_Post_IF,2,0,1,0,0,3
GCCCGTTCACACAATT-1_Br8667_Post_IF,0,0,0,5,0,5
ACAAACTCCATCAGAG-1_Br8667_Post_IF,1,2,0,0,0,3
GGTTCCGTACGACTAA-1_Br8667_Post_IF,0,3,0,2,0,5
TTGCGGAAAGCTGCCC-1_Br8667_Post_IF,0,1,0,0,0,1
GGAACTCGTGAATACG-1_Br8667_Post_IF,0,0,1,2,0,3
GGTTACCGCTCCCTAC-1_Br8667_Post_IF,4,1,1,0,0,6
AGCGACTTTGAAGACA-1_Br8667_Post_IF,1,2,0,0,0,3
CCGTTTCCTTTCCGTG-1_Br8667_Post_IF,0,0,0,0,0,0
TGGATGGCATCTTGGA-1_Br8667_Post_IF,2,5,0,1,0,8
CAAGTCGTTGAAATCT-1_Br8667_Post_IF,3,1,0,0,0,4
TGCAAACGTACTAGTT-1_Br8667_Post_IF,1,2,0,0,0,3
GGCTGTCCTACTGCGG-1_Br8667_Post_IF,0,0,1,0,0,1
TACTGCATGATTAAAT-1_Br8667_Post_IF,5,0,0,0,0,5
CGGACCTCTGTAGTTA-1_Br8667_Post_IF,1,0,2,1,0,4
CCCTAGCTCTAAGGTC-1_Br8667_Post_IF,1,2,0,0,0,3
GTAACAGGTTAACGGC-1_Br8667_Post_IF,1,0,6,0,0,7
CCCGCAAATAATCATC-1_Br8667_Post_IF,0,2,0,0,0,2
AATCCCGCTCAGAGCC-1_Br8667_Post_IF,1,1,1,0,0,3
AACGTCATCCGGCTTG-1_Br8667_Post_IF,2,2,0,0,0,4
CTCGTGGCACTGAAAG-1_Br8667_Post_IF,0,0,2,1,0,3
CTTTATCCGACGCATG-1_Br8667_Post_IF,1,2,1,0,0,4
AAATGACTGATCAAAC-1_Br8667_Post_IF,5,1,1,0,0,7
TTCGTGCATGTTATAG-1_Br8667_Post_IF,2,0,1,0,0,3
ATCAAAGAGCCGTGGT-1_Br8667_Post_IF,0,3,1,0,0,4
ATGTCATAATAAACGA-1_Br8667_Post_IF,1,1,0,1,0,3
CTTAATCGACTTAGTA-1_Br8667_Post_IF,2,2,3,0,0,7
CTAAAGGATGAGATAC-1_Br8667_Post_IF,0,1,0,2,0,3
GTGCTATCCAGCTGGA-1_Br8667_Post_IF,0,0,0,1,0,1
GACAGAGGTCTTCAGT-1_Br8667_Post_IF,0,3,2,2,0,7
TCGATTTACGAAACGA-1_Br8667_Post_IF,1,2,0,4,0,7
AGGCTTAAGTTGCACA-1_Br8667_Post_IF,0,0,0,11,0,11
TAGGATCTTAACCGCA-1_Br8667_Post_IF,0,0,1,4,0,5
GACTTTCGAGCGGTTC-1_Br8667_Post_IF,0,1,0,3,0,4
CCCTGGGAGGGATCCT-1_Br8667_Post_IF,0,0,1,3,0,4
TAGTAGTTGCCGGACA-1_Br8667_Post_IF,0,0,0,1,0,1
GCCCTAAGTGCAGGAT-1_Br8667_Post_IF,0,1,3,5,0,9
ACTTGGGCTTTCGCCA-1_Br8667_Post_IF,0,0,0,1,0,1
CATGATACGGTGAAAC-1_Br8667_Post_IF,0,0,1,5,0,6
TCCTGCAGCCGCCAAT-1_Br8667_Post_IF,0,0,0,11,0,11
GTCCGTTAGAGGGCCT-1_Br8667_Post_IF,0,0,0,2,0,2
GCTTTATTAAGTTACC-1_Br8667_Post_IF,0,0,0,1,0,1
AATCGAGGTCTCAAGG-1_Br8667_Post_IF,0,0,3,7,0,10
GTGCTGTTAGAACATA-1_Br8667_Post_IF,0,0,0,1,0,1
GGCTTCTCGTGGGTGG-1_Br8667_Post_IF,2,2,1,1,0,6
CCTACAGTTGAGGGAG-1_Br8667_Post_IF,0,0,0,0,0,0
TATCCCTCGATCTGCA-1_Br8667_Post_IF,0,0,0,0,0,0
CCGGTATCTGGCGACT-1_Br8667_Post_IF,0,0,0,3,0,3
CTCTAACACCGGCAGC-1_Br8667_Post_IF,1,2,1,1,0,5
CTTCATCACCAGGGCT-1_Br8667_Post_IF,0,0,0,2,0,2
GGCTGGCAATCCCACG-1_Br8667_Post_IF,0,0,0,0,0,0
CAAACCATAAGCGTAT-1_Br8667_Post_IF,0,0,0,1,0,1
CATGTGGGCTCATCAC-1_Br8667_Post_IF,0,1,0,4,0,5
GATTATCTTGCATTAT-1_Br8667_Post_IF,0,0,0,0,0,0
TGTACTATCGCTCGTT-1_Br8667_Post_IF,0,0,0,0,0,0
