key,other,micro,oligo,astro,neuron,n_cells
TCGGCTAACTTCCCTT-1_Br6432_Ant_IF,0,0,0,0,0,0
ATATCGTGCCAGACCC-1_Br6432_Ant_IF,1,0,0,0,0,1
ACGCTTAGTGTCTCTC-1_Br6432_Ant_IF,1,1,0,1,1,4
TAGTGGAACTCATACA-1_Br6432_Ant_IF,0,0,0,0,0,0
GTTATTAAATACGACC-1_Br6432_Ant_IF,1,0,0,0,0,1
CCTGACGCAACCTTTA-1_Br6432_Ant_IF,2,0,0,1,0,3
AACTGGGTTCGAGCCG-1_Br6432_Ant_IF,0,0,0,0,0,0
CATGCACGTGTTACTG-1_Br6432_Ant_IF,0,0,0,2,0,2
CCTACGCGACCTTACA-1_Br6432_Ant_IF,0,0,1,1,1,3
GAGGTCTTAGTGGGTC-1_Br6432_Ant_IF,2,0,4,1,0,7
GTCACCTGTCTATGTC-1_Br6432_Ant_IF,1,2,3,0,0,6
CCTGTGCGGATTGTAA-1_Br6432_Ant_IF,0,3,5,0,0,8
GGAGGCGAAGAACCGC-1_Br6432_Ant_IF,3,0,2,0,0,5
GCTCCGGACGTTGATA-1_Br6432_Ant_IF,0,3,1,1,0,5
TGACCCAGCATTCCCG-1_Br6432_Ant_IF,1,0,1,1,0,3
TGTAATGCCTTCGGAC-1_Br6432_Ant_IF,0,0,1,0,1,2
TACGATCCAAGCCACT-1_Br6432_Ant_IF,1,0,0,0,1,2
AGATTCAAGCGGGTCG-1_Br6432_Ant_IF,6,0,0,0,0,6
GTAACATCAGCTCATC-1_Br6432_Ant_IF,4,0,0,0,0,4
GGGCCTATACAACCGG-1_Br6432_Ant_IF,0,0,0,0,0,0
TTATAGATGCACATTA-1_Br6432_Ant_IF,3,0,4,0,1,8
TATTCCGGCAGTCCTA-1_Br6432_Ant_IF,1,0,0,0,0,1
ATGTGTAGTTTAGTCA-1_Br6432_Ant_IF,4,0,1,0,1,6
AAGTTTACTAATGGCA-1_Br6432_Ant_IF,3,0,3,0,0,6
GATTGACACTCTGCTC-1_Br6432_Ant_IF,4,1,0,0,1,6
TATCACAGCACGGGCA-1_Br6432_Ant_IF,0,0,0,0,0,0
ACCGTTCCCGCTCTGA-1_Br6432_Ant_IF,2,0,0,0,2,4
CCGCCACCACAATCCA-1_Br6432_Ant_IF,0,0,0,0,0,0
CATTCACTGACAGCTA-1_Br6432_Ant_IF,2,0,1,0,0,3
CGGCTGCAAGATTAAG-1_Br6432_Ant_IF,0,1,0,0,0,1
CATGAACCTCTTATCA-1_Br6432_Ant_IF,2,0,0,0,1,3
TTAATGCGAGGTAACT-1_Br6432_Ant_IF,2,1,0,0,2,5
AATAAGTCCTCGAGAC-1_Br6432_Ant_IF,2,0,1,0,2,5
ACCAGCCCGGTCTTTG-1_Br6432_Ant_IF,4,0,2,0,2,8
CTACGAACTAGGTCGA-1_Br6432_Ant_IF,2,0,0,0,0,2
ACATCTCAACGCGTAA-1_Br6432_Ant_IF,1,2,1,0,0,4
CACTACTCAGTTCTGT-1_Br6432_Ant_IF,1,0,0,0,0,1
CCGACTCGCATAGTCT-1_Br6432_Ant_IF,1,1,0,0,0,2
CATTTATCGTTCAAGA-1_Br6432_Ant_IF,0,0,2,0,2,4
CAAACGTGGTCTTGCG-1_Br6432_Ant_IF,1,1,1,0,0,3
TAGAAACCACTAAGTA-1_Br6432_Ant_IF,0,0,0,0,1,1
ACTGATTTAGTGATTC-1_Br6432_Ant_IF,0,0,2,0,2,4
TCGTATTTCGTCCGGA-1_Br6432_Ant_IF,1,1,1,0,0,3
CGGAAATTTCACATCC-1_Br6432_Ant_IF,0,0,0,0,2,2
ATCCACGCTAAATGTT-1_Br6432_Ant_IF,0,0,0,0,0,0
GTTCAATCTATGTCAA-1_Br6432_Ant_IF,0,0,0,0,0,0
ATAAAGGTCAAGTACG-1_Br6432_Ant_IF,1,0,0,1,2,4
CAACTCCAACGTTTAG-1_Br6432_Ant_IF,0,1,1,0,0,2
TAGGAACAGCCTCCAG-1_Br6432_Ant_IF,0,1,0,1,0,2
ATGGGAACGGAAGCGG-1_Br6432_Ant_IF,3,0,1,0,1,5
CACACGTTTCAATGGG-1_Br6432_Ant_IF,2,0,2,0,0,4
GGTGTTCTGTTTCTAC-1_Br6432_Ant_IF,1,1,2,2,0,6
AGTAACGTTCATCCTG-1_Br6432_Ant_IF,0,1,4,0,0,5
GTATAGTGGCCCATGT-1_Br6432_Ant_IF,1,0,4,1,0,6
TCTACACGTTCATGCA-1_Br6432_Ant_IF,0,0,4,0,0,4
AATCTGGGTAGACCCT-1_Br6432_Ant_IF,1,1,3,3,0,8
TCGGTTAGCCATGTAG-1_Br6432_Ant_IF,1,2,1,0,0,4
TGCCATGGCTTATAAG-1_Br6432_Ant_IF,3,1,0,0,0,4
TAAGTAAATGTGCCGC-1_Br6432_Ant_IF,2,4,2,1,0,9
GTGTCCGATAAGGCAT-1_Br6432_Ant_IF,1,4,2,0,0,7
TGGCACGAGCTCGAGT-1_Br6432_Ant_IF,1,2,3,0,1,7
ACCGGTCTGAGTACGG-1_Br6432_Ant_IF,2,1,2,0,0,5
GAACTTAGCGCCCGGT-1_Br6432_Ant_IF,1,2,1,1,0,5
AGTAGCTAGACGCCGA-1_Br6432_Ant_IF,3,0,0,1,0,4
ATAGGAATCTAAGCTT-1_Br6432_Ant_IF,2,1,5,0,0,8
CTTCCTGCATATTTAC-1_Br6432_Ant_IF,0,1,2,2,0,5
CAATATGTAGATTTAC-1_Br6432_Ant_IF,0,1,4,2,0,7
ACAAGGCCTACCAGCC-1_Br6432_Ant_IF,2,2,2,0,0,6
TTATAGTCCAAGGTGC-1_Br6432_Ant_IF,1,1,2,1,1,6
AAACGCCCGAGATCGG-1_Br6432_Ant_IF,2,2,1,0,0,5
CCTCGTTACGCCTGTT-1_Br6432_Ant_IF,1,1,0,2,0,4
GAACGGTGTAAAGCAG-1_Br6432_Ant_IF,1,4,3,2,0,10
ACGCATAAATGACATG-1_Br6432_Ant_IF,2,0,3,0,0,5
GGTTCGATGCTGAGTT-1_Br6432_Ant_IF,1,2,0,0,0,3
CTTTGGCAGACAGAGT-1_Br6432_Ant_IF,0,2,2,0,0,4
TTCGTGGGCTGGAAGC-1_Br6432_Ant_IF,2,0,1,0,1,4
CAAAGGTTAAATTCAG-1_Br6432_Ant_IF,1,1,1,0,1,4
GTTTGGCGTCAGGCAC-1_Br6432_Ant_IF,1,1,0,0,0,2
GCTTTCTATCTCAACT-1_Br6432_Ant_IF,1,2,1,0,1,5
TGCATCTCCGGATCTT-1_Br6432_Ant_IF,2,0,0,0,2,4
CTGAAACGGCCCTCAG-1_Br6432_Ant_IF,1,0,1,0,1,3
TAGCAGTAAATACGCG-1_Br6432_Ant_IF,3,0,0,0,0,3
CGGGCTACTTAAATTG-1_Br6432_Ant_IF,2,1,0,0,1,4
ATTATGCTCAGTATTG-1_Br6432_Ant_IF,2,1,0,0,0,3
TGATGCTCACGTAGTC-1_Br6432_Ant_IF,3,0,1,0,1,5
GTCTAAGATGCCCAGC-1_Br6432_Ant_IF,0,0,0,0,0,0
AACCCGATAGGGCTTC-1_Br6432_Ant_IF,0,0,1,0,0,1
CGCTATCGTGGCTTTA-1_Br6432_Ant_IF,0,0,0,0,0,0
CGTCTCTCGCCGAGGC-1_Br6432_Ant_IF,0,0,1,0,1,2
TTATGCGTCCCGGTCC-1_Br6432_Ant_IF,0,0,0,0,0,0
AGACATAGATCCTTCC-1_Br6432_Ant_IF,2,0,0,0,1,3
GGTGAAACCGGGAATG-1_Br6432_Ant_IF,0,0,2,0,1,3
AACTGGTGTGGGCCTT-1_Br6432_Ant_IF,0,1,0,0,0,1
GTAGCGCTGTTGTAGT-1_Br6432_Ant_IF,0,0,0,0,0,0
TTGTTTGTGTAAATTC-1_Br6432_Ant_IF,0,0,0,0,0,0
GGATCAAAGGACGAGG-1_Br6432_Ant_IF,2,2,0,0,0,4
CGTAGCGCCGACGTTG-1_Br6432_Ant_IF,5,0,2,0,0,7
CAAGTGAACTTTGGTT-1_Br6432_Ant_IF,1,1,0,0,1,3
GTAGACAACCGATGAA-1_Br6432_Ant_IF,4,0,1,0,0,5
CAATGGTCGGCCTGGG-1_Br6432_Ant_IF,1,0,0,0,1,2
ACAGATTAGGTTAGTG-1_Br6432_Ant_IF,1,0,2,0,0,3
GTTATCACCTTCTGAA-1_Br6432_Ant_IF,2,0,2,0,1,5
TGGTATCGGTCTGTAT-1_Br6432_Ant_IF,2,1,1,0,1,5
GGAATAACCTCAAGAA-1_Br6432_Ant_IF,3,0,1,0,1,5
ATTATCTCGACAGATC-1_Br6432_Ant_IF,2,0,2,0,0,4
CCGAGGGATGTTAGGC-1_Br6432_Ant_IF,0,2,1,0,0,3
TGAGATCAAATACTCA-1_Br6432_Ant_IF,1,0,0,0,2,3
AAACGAAGAACATACC-1_Br6432_Ant_IF,5,1,1,0,0,7
CTGGTCCTAACTTGGC-1_Br6432_Ant_IF,2,0,1,0,0,3
TGCACGAGTCGGCAGC-1_Br6432_Ant_IF,3,2,2,0,1,8
ATAGTCTTTGACGTGC-1_Br6432_Ant_IF,4,0,1,0,1,6
TGGAGCTAAAGTTCCC-1_Br6432_Ant_IF,1,0,2,0,3,6
GGGTGGTCCAGCCTGT-1_Br6432_Ant_IF,0,0,1,0,2,3
CATGCATGGAGACCCT-1_Br6432_Ant_IF,2,0,2,0,1,5
ACACGGCACTATGCAT-1_Br6432_Ant_IF,4,1,2,0,2,9
CCCTGGTATGGGCGGC-1_Br6432_Ant_IF,0,0,0,0,1,1
GGAGGATTGAAAGGAG-1_Br6432_Ant_IF,0,0,3,0,1,4
CCGCTGGTGCCATTCA-1_Br6432_Ant_IF,1,0,0,0,1,2
GTTAGAGTGTGCCGCT-1_Br6432_Ant_IF,6,1,0,0,0,7
TCGGAATGACCATCAA-1_Br6432_Ant_IF,2,0,0,0,0,2
TTCAATTAGCCATAAT-1_Br6432_Ant_IF,1,0,1,0,0,2
GATGTGTTGTCACAAG-1_Br6432_Ant_IF,1,0,0,0,1,2
TCTTTCTCTTAAGGAG-1_Br6432_Ant_IF,2,0,1,0,0,3
ACCCTTTAGTTCTCCA-1_Br6432_Ant_IF,1,0,2,0,0,3
ACCACAACTCAGAACA-1_Br6432_Ant_IF,0,1,2,0,1,4
TATGATAAATCTAACG-1_Br6432_Ant_IF,1,0,0,0,0,1
GATCCTCTTGCGCTTA-1_Br6432_Ant_IF,1,0,1,0,0,2
TTCTACCTTTATGTTG-1_Br6432_Ant_IF,0,0,0,0,0,0
GAAATACCTGCTGGCT-1_Br6432_Ant_IF,0,0,1,0,0,1
ATTCTGAGTATGAACT-1_Br6432_Ant_IF,1,2,0,1,0,4
GGATTAAGCTAAGGTC-1_Br6432_Ant_IF,0,0,1,0,1,2
AGTACGTGGCCTGTCT-1_Br6432_Ant_IF,0,0,1,0,1,2
TCAGGGTGCACGAAAC-1_Br6432_Ant_IF,4,0,2,0,0,6
AAATTTACCGAAATCC-1_Br6432_Ant_IF,3,1,1,0,0,5
TTGAGGCATTTAACTC-1_Br6432_Ant_IF,3,1,2,0,0,6
AACCAGTATCACTCTT-1_Br6432_Ant_IF,0,2,2,2,0,6
CACCGGAGATATCTCC-1_Br6432_Ant_IF,1,0,1,0,1,3
GACTGGGCGCCGCAAC-1_Br6432_Ant_IF,0,1,0,0,0,1
CACGTCTATGATGTGG-1_Br6432_Ant_IF,0,2,3,0,0,5
TTAAGACGAACGAACC-1_Br6432_Ant_IF,0,4,2,0,0,6
TGACCAGCTTCAAAGT-1_Br6432_Ant_IF,1,0,1,0,0,2
AGAGTTAGAGACCGAT-1_Br6432_Ant_IF,1,3,3,0,0,7
TTCGGACTGATGCCTT-1_Br6432_Ant_IF,1,1,4,0,0,6
CTCGAATGGAACGTAT-1_Br6432_Ant_IF,1,1,1,0,0,3
GGACGGCTTGCGCAAC-1_Br6432_Ant_IF,0,3,3,0,0,6
CTAAGTACAGGGCTAC-1_Br6432_Ant_IF,2,3,1,1,0,7
ACAAATTCAGATCTGA-1_Br6432_Ant_IF,0,2,1,2,0,5
CATGGAAATGGGACCA-1_Br6432_Ant_IF,0,1,2,0,0,3
GGTGGACCACGTGTTA-1_Br6432_Ant_IF,0,1,0,0,0,1
CACGACGTAATAGTAA-1_Br6432_Ant_IF,2,3,2,1,0,8
CGGGTTCGGCACGTAT-1_Br6432_Ant_IF,1,0,6,0,0,7
CTGGGCTATCCTTTGG-1_Br6432_Ant_IF,0,3,4,0,0,7
GTATTAGGGTTCGCGT-1_Br6432_Ant_IF,2,0,2,1,1,6
TCATTCGTATAATTTG-1_Br6432_Ant_IF,1,2,3,0,0,6
AATAGCAAGCCTCCTG-1_Br6432_Ant_IF,2,2,2,3,0,9
CATCTACCCGAGAACG-1_Br6432_Ant_IF,0,2,2,2,2,8
GCTTCAGTGGGATTAC-1_Br6432_Ant_IF,1,0,2,0,0,3
TCTGTGATGGAGGTTG-1_Br6432_Ant_IF,2,1,4,0,0,7
ATCCACTTTCAGACTA-1_Br6432_Ant_IF,1,1,0,0,1,3
ATGGTTACGAAACATG-1_Br6432_Ant_IF,0,2,0,0,0,2
GGCCCAATCTAGAGGG-1_Br6432_Ant_IF,0,0,2,0,1,3
GATGGTGAAATAACCC-1_Br6432_Ant_IF,0,0,0,0,1,1
AGAGGGACAATTGTCC-1_Br6432_Ant_IF,4,2,1,0,0,7
CGCGTACATTCTGGAA-1_Br6432_Ant_IF,1,0,0,0,0,1
CAAGAAACCCTAAACT-1_Br6432_Ant_IF,1,0,0,0,1,2
TTGGTGCGGTGTTGAA-1_Br6432_Ant_IF,0,0,1,0,1,2
GGTTCCCTAGTGTCTC-1_Br6432_Ant_IF,4,2,2,0,1,9
CGATAACCAATTTGAG-1_Br6432_Ant_IF,1,0,1,0,0,2
GCCCACTGGTCCACAA-1_Br6432_Ant_IF,1,0,3,0,0,4
GAGGGCCGGCAGAGTC-1_Br6432_Ant_IF,0,0,0,0,1,1
CGACACGGATGCCCAC-1_Br6432_Ant_IF,1,0,0,0,1,2
ATACTCTCGCCACTCT-1_Br6432_Ant_IF,0,0,1,0,0,1
TCGTTGGCTCGTCAAT-1_Br6432_Ant_IF,0,0,0,0,0,0
GGTGAACGGGCTAGCC-1_Br6432_Ant_IF,0,0,0,0,0,0
GCACTGTGCAAATGTA-1_Br6432_Ant_IF,1,0,0,0,0,1
ACGAGAACCCATCACG-1_Br6432_Ant_IF,1,2,0,0,0,3
CCAGCTACGCCTCATA-1_Br6432_Ant_IF,0,0,0,0,0,0
TCCCGGTCAGGAATTT-1_Br6432_Ant_IF,0,0,0,0,0,0
TCGCATTCAATGACTT-1_Br6432_Ant_IF,1,0,0,0,0,1
CTGGTTCAACGCATCA-1_Br6432_Ant_IF,2,0,0,0,0,2
GGTGATTTCATCTTGT-1_Br6432_Ant_IF,4,0,1,0,0,5
CACCCTTTCCTCGCTC-1_Br6432_Ant_IF,0,1,0,0,4,5
CAACTTGTAGTGGGCA-1_Br6432_Ant_IF,3,1,2,0,1,7
AATATCAAGGTCGGAT-1_Br6432_Ant_IF,0,0,0,0,1,1
ACTCAGACCTGCTTCT-1_Br6432_Ant_IF,0,1,1,0,1,3
TTGGAGTCTCCCTTCT-1_Br6432_Ant_IF,1,1,0,0,3,5
GGATACTCATGAATTG-1_Br6432_Ant_IF,1,0,0,0,1,2
TGGGCACAAACAGAAC-1_Br6432_Ant_IF,0,0,0,0,1,1
GAGCCACGGTAGTAGG-1_Br6432_Ant_IF,2,0,0,0,2,4
TCGATAGGCTAGTCGC-1_Br6432_Ant_IF,1,0,1,0,1,3
TAACCGCCCGCAGTGC-1_Br6432_Ant_IF,2,0,0,0,0,2
GCCTATTTGCTACACA-1_Br6432_Ant_IF,1,0,0,0,0,1
TTGACGATTCAGCACG-1_Br6432_Ant_IF,1,0,1,0,0,2
TTAAACCGGTAGCGAC-1_Br6432_Ant_IF,0,1,1,0,3,5
ACCGAAAGGGCCCTGC-1_Br6432_Ant_IF,1,1,0,0,0,2
ACGTTCCGCGCTCCGT-1_Br6432_Ant_IF,4,0,0,0,0,4
ATACCAGGCTAATAGA-1_Br6432_Ant_IF,0,1,0,0,1,2
CGGCTTTGTATGATAA-1_Br6432_Ant_IF,1,0,0,0,0,1
CTTGACCCGAAAGATA-1_Br6432_Ant_IF,0,1,0,0,0,1
CGCAGAAACATTTGCG-1_Br6432_Ant_IF,7,0,0,0,0,7
GACCCGTCGCCGGCTA-1_Br6432_Ant_IF,1,0,1,0,1,3
AATCGGGACACTACGA-1_Br6432_Ant_IF,3,0,2,0,1,6
GTCACAAAGTTTCCAA-1_Br6432_Ant_IF,3,0,1,0,1,5
TATATTCGCGTCGATA-1_Br6432_Ant_IF,1,0,0,0,0,1
CCTCCCGACAATCCCT-1_Br6432_Ant_IF,1,0,0,0,1,2
CGACATGCGATCTTCT-1_Br6432_Ant_IF,4,0,0,0,0,4
AACACGACTGTACTGA-1_Br6432_Ant_IF,2,1,1,0,1,5
CCCAACCACACTAACA-1_Br6432_Ant_IF,2,0,2,0,1,5
CACCGCCGACCAGCGA-1_Br6432_Ant_IF,2,0,3,0,2,7
TGGTATCGCATCCCAA-1_Br6432_Ant_IF,3,0,1,0,2,6
CAGAGTGATTTAACGT-1_Br6432_Ant_IF,1,2,0,0,0,3
AACCCTGGTGGAACCA-1_Br6432_Ant_IF,3,0,0,0,1,4
GTCAGTTGTGCTCGTT-1_Br6432_Ant_IF,4,0,0,0,1,5
ATTGACGTAACTCGGT-1_Br6432_Ant_IF,2,0,1,0,0,3
GATGTCGGTCAACTGC-1_Br6432_Ant_IF,1,0,2,0,2,5
AGGGCAGCGGCGTGGT-1_Br6432_Ant_IF,3,1,3,0,0,7
ACATCGTTAACCTAGT-1_Br6432_Ant_IF,0,0,0,0,1,1
TCCATTGTGACCTCGT-1_Br6432_Ant_IF,2,0,0,0,0,2
TGTTTAATACTTCATC-1_Br6432_Ant_IF,3,0,1,0,1,5
TTGCTGGCCGGGCTTC-1_Br6432_Ant_IF,1,0,0,0,0,1
CATATTATTTGCCCTA-1_Br6432_Ant_IF,0,0,0,0,0,0
CTGCCTAGCCACCAAG-1_Br6432_Ant_IF,2,1,3,0,1,7
ACGAGATATTTGCTTA-1_Br6432_Ant_IF,2,2,0,0,1,5
GACTACAATTGCTCGT-1_Br6432_Ant_IF,1,0,1,0,0,2
AACGTGATGAAGGACA-1_Br6432_Ant_IF,1,0,0,0,1,2
ACTCTCTTATACACGA-1_Br6432_Ant_IF,3,0,1,0,1,5
CGCATCATGGCTTCAG-1_Br6432_Ant_IF,1,0,3,0,1,5
CGGCTCTTCGTCGAAC-1_Br6432_Ant_IF,1,0,2,0,0,3
ATTCTTCGTACTTATG-1_Br6432_Ant_IF,3,1,0,0,0,4
AGTGAGGGTTTCTGAC-1_Br6432_Ant_IF,2,0,1,0,0,3
GCCAGGCGTTCGCATG-1_Br6432_Ant_IF,0,1,3,0,0,4
GACTAACACAGCACCT-1_Br6432_Ant_IF,2,1,2,1,0,6
CAATGGAATCTACATA-1_Br6432_Ant_IF,1,1,3,0,0,5
GTGGTCAGCGAAGTAT-1_Br6432_Ant_IF,0,1,0,0,0,1
ATGGCTGGAAATGGCC-1_Br6432_Ant_IF,2,0,4,0,0,6
ATCAGGTCGCCATTGC-1_Br6432_Ant_IF,1,0,0,0,0,1
TATCACCATGTAAAGT-1_Br6432_Ant_IF,2,1,2,1,0,6
AGCGCTTATGGGCAAG-1_Br6432_Ant_IF,1,1,1,1,0,4
AAGCGGCGTCATGGGT-1_Br6432_Ant_IF,3,0,2,0,0,5
ACTAATACGTCAGGCG-1_Br6432_Ant_IF,0,2,3,0,0,5
GGCTGAGCATCGTAAG-1_Br6432_Ant_IF,1,0,3,0,1,5
CGGTTGGGTTCAAGTT-1_Br6432_Ant_IF,1,1,2,0,0,4
GACTGATTGGTCACAA-1_Br6432_Ant_IF,2,1,4,0,0,7
AGACGGGCCGATTTAA-1_Br6432_Ant_IF,2,1,0,1,0,4
ACCAGTGCCCGGTCAA-1_Br6432_Ant_IF,0,1,2,0,0,3
GTCCTTTAATGACTTC-1_Br6432_Ant_IF,2,0,0,0,0,2
CCTACAAGTCCGGAAT-1_Br6432_Ant_IF,6,1,0,0,0,7
GCCTGCTACACTGAGA-1_Br6432_Ant_IF,1,2,0,0,0,3
GACTCGGTCGGCGGAT-1_Br6432_Ant_IF,1,0,2,2,0,5
CTAGACATATATGTAG-1_Br6432_Ant_IF,4,1,0,0,0,5
TCGCCCAACTGACTCC-1_Br6432_Ant_IF,3,0,1,1,0,5
AAACTAACGTGGCGAC-1_Br6432_Ant_IF,1,2,4,0,0,7
AACTGAGGTCAGCGTC-1_Br6432_Ant_IF,1,0,2,0,0,3
ACAATGATTCTTCTAC-1_Br6432_Ant_IF,11,2,1,1,0,15
ATAAGTACCCGATTGT-1_Br6432_Ant_IF,2,1,1,2,1,7
ATTGGGAGTTCTGTAA-1_Br6432_Ant_IF,0,0,0,0,0,0
CGAACATAGTCAGAAA-1_Br6432_Ant_IF,2,2,0,2,0,6
TAGCTCAGATCCTAGT-1_Br6432_Ant_IF,2,1,1,0,1,5
GTGTCGTATTCACCTT-1_Br6432_Ant_IF,0,1,1,0,0,2
CTCACCGATCCAAACT-1_Br6432_Ant_IF,0,0,0,0,0,0
ATATGTGCACAAACCA-1_Br6432_Ant_IF,0,1,1,0,0,2
CAGTCCAACGCCTTCT-1_Br6432_Ant_IF,3,1,2,0,0,6
TCGTCCGGGTACACTC-1_Br6432_Ant_IF,2,1,2,0,0,5
GCAGAAACGTAATCCA-1_Br6432_Ant_IF,2,1,2,0,2,7
TTCGAGCCGGCGCTAC-1_Br6432_Ant_IF,2,2,0,0,1,5
GGAAGATAAGACTGTA-1_Br6432_Ant_IF,1,2,1,0,4,8
ATAAGCAAACACCGAG-1_Br6432_Ant_IF,0,1,0,0,0,1
GCATAAATTGAACGCC-1_Br6432_Ant_IF,0,1,1,0,1,3
CGCCGGTGTCGCAGTA-1_Br6432_Ant_IF,2,1,0,0,0,3
TGCGTGATTGGGTGTC-1_Br6432_Ant_IF,0,0,0,0,0,0
TTCGCATCCGGAAGCA-1_Br6432_Ant_IF,0,0,0,0,0,0
CCCTAGTGTCAGGTGT-1_Br6432_Ant_IF,0,0,0,0,0,0
TTACCGCCTTAGGGAA-1_Br6432_Ant_IF,0,0,0,0,0,0
CCAGTCCATTATTCGA-1_Br6432_Ant_IF,0,0,0,0,0,0
CGTAAACGCTTGAGTG-1_Br6432_Ant_IF,0,0,0,0,0,0
ATTCCTTCCAGGCGGT-1_Br6432_Ant_IF,0,0,0,0,0,0
TTCCTTTCTGTGTTGC-1_Br6432_Ant_IF,3,0,1,2,0,6
AGTTGACATCGGCTGG-1_Br6432_Ant_IF,0,0,0,3,0,3
AACTCGATGGCGCAGT-1_Br6432_Ant_IF,0,0,0,1,0,1
TAATTAGATGGATATG-1_Br6432_Ant_IF,0,0,0,0,0,0
GAGGGCATCGCGTATC-1_Br6432_Ant_IF,1,0,0,0,0,1
CTTGTGAGTCTTTGAC-1_Br6432_Ant_IF,5,1,0,0,0,6
TCAACACATTGGGTAA-1_Br6432_Ant_IF,1,0,1,1,0,3
ACTGTATACGCGAGCA-1_Br6432_Ant_IF,1,0,0,0,0,1
GTGAAACGTGCTCCAC-1_Br6432_Ant_IF,1,0,1,1,0,3
CGAGTGCTATAGTTCG-1_Br6432_Ant_IF,1,0,1,0,0,2
GTACTGCATGAAGCGT-1_Br6432_Ant_IF,2,0,0,0,0,2
GTAACTTGCGGCAGTC-1_Br6432_Ant_IF,3,0,0,0,0,3
GAATCGCCGGACACGG-1_Br6432_Ant_IF,4,2,0,0,0,6
GGGAGTAATGGCTGGC-1_Br6432_Ant_IF,2,2,1,0,5,10
CATGAACCGACATTTG-1_Br6432_Ant_IF,1,0,2,0,2,5
TCTGTCATACAAGAGC-1_Br6432_Ant_IF,0,0,2,0,3,5
GTCGTCAATTATAAGG-1_Br6432_Ant_IF,4,0,0,0,1,5
TAAAGAGCCCGAAACC-1_Br6432_Ant_IF,3,0,0,0,1,4
GTACTGAGGTCGTAAC-1_Br6432_Ant_IF,1,0,0,0,0,1
AAAGACCCAAGTCGCG-1_Br6432_Ant_IF,2,0,0,0,0,2
CGTCAGTGCGCACAAG-1_Br6432_Ant_IF,1,0,0,0,0,1
TGTATCCTTATTCCAT-1_Br6432_Ant_IF,0,0,0,0,0,0
ATTCTCGTCTCTTTAG-1_Br6432_Ant_IF,1,0,0,0,0,1
AAAGTCACTGATGTAA-1_Br6432_Ant_IF,1,0,0,0,0,1
TGTCTACAGTTTCTGT-1_Br6432_Ant_IF,1,0,0,0,1,2
TTAACGTCGCAAGACC-1_Br6432_Ant_IF,0,0,0,0,0,0
CTATGTCTATTGAAAC-1_Br6432_Ant_IF,2,0,0,0,0,2
TCGGGTGAAACTGCTA-1_Br6432_Ant_IF,4,0,0,0,0,4
TGTCCCGACATAGCAC-1_Br6432_Ant_IF,1,0,0,0,1,2
ACAGCATAGAGCCAGT-1_Br6432_Ant_IF,3,0,0,0,0,3
ATATTCCCACAGGTCA-1_Br6432_Ant_IF,2,1,1,0,0,4
TTGGATCGACTTCTGG-1_Br6432_Ant_IF,5,1,1,0,1,8
CACCATCGGAGGAGAC-1_Br6432_Ant_IF,1,0,0,0,1,2
TCGTTCGTTATTATGT-1_Br6432_Ant_IF,0,2,0,0,0,2
CTTAACTTCGAAGTAC-1_Br6432_Ant_IF,3,0,0,0,1,4
GCACAAGTGTCGGAAG-1_Br6432_Ant_IF,2,1,0,0,2,5
TACCAGCTAGGTTTAA-1_Br6432_Ant_IF,3,1,1,0,1,6
ACGTACAGATTTCTCT-1_Br6432_Ant_IF,1,0,1,0,0,2
AATTTGGTTCCAAAGA-1_Br6432_Ant_IF,0,0,0,0,0,0
GTAAGGATTTGTCGGA-1_Br6432_Ant_IF,5,0,1,0,0,6
CATCATCTACCCGGAC-1_Br6432_Ant_IF,4,0,4,0,1,9
ACGATGGATCCGATGC-1_Br6432_Ant_IF,4,0,1,0,0,5
CACTCAGCTCTTGAGG-1_Br6432_Ant_IF,3,0,1,0,0,4
TAGATCCGAAGTCGCA-1_Br6432_Ant_IF,3,0,1,0,1,5
TGAAACTTATGCAAGC-1_Br6432_Ant_IF,2,0,0,0,1,3
GCGATTCTGGAAGCAG-1_Br6432_Ant_IF,3,1,0,0,2,6
CAAACTATTGAGCTTC-1_Br6432_Ant_IF,0,1,0,0,0,1
TAGAATTAAGGGCAAC-1_Br6432_Ant_IF,1,0,0,0,0,1
CGAAACATAGATGGCA-1_Br6432_Ant_IF,3,0,0,0,0,3
GATGGTGCCCTAGGCA-1_Br6432_Ant_IF,2,0,2,0,0,4
CCCGCAGGGCCCAAAG-1_Br6432_Ant_IF,2,0,1,0,0,3
ACAGCGCACCCGCAGC-1_Br6432_Ant_IF,0,0,1,0,0,1
GGTAAATGTGCGTTAC-1_Br6432_Ant_IF,2,0,0,0,0,2
GTCCTTCTAGTGGGTT-1_Br6432_Ant_IF,0,0,1,0,0,1
GGAAGCTCGCTTACAG-1_Br6432_Ant_IF,3,0,1,0,1,5
CACCGATACACCGAGC-1_Br6432_Ant_IF,1,0,1,0,0,2
CAGCCGGGCCCTCTAT-1_Br6432_Ant_IF,0,0,0,0,0,0
CGGAGCTTATAACACC-1_Br6432_Ant_IF,2,0,0,0,1,3
ATTACAACTACCGGCC-1_Br6432_Ant_IF,3,1,0,0,0,4
TCCTCTGGCCCATTAG-1_Br6432_Ant_IF,1,0,0,0,1,2
CGGCACCGTTAGCGCC-1_Br6432_Ant_IF,1,0,1,1,1,4
TCGGTCCCTGACTCCA-1_Br6432_Ant_IF,1,1,4,0,1,7
TGGTTGGAGGATCCTG-1_Br6432_Ant_IF,0,0,1,0,0,1
CTGCGGTAGTCACGTG-1_Br6432_Ant_IF,1,0,1,0,0,2
GTGCCTCAGTGTACGG-1_Br6432_Ant_IF,3,1,1,0,1,6
ATCGTTCACTTTCGCC-1_Br6432_Ant_IF,0,0,1,0,0,1
ACTTACCGGGCGCGCA-1_Br6432_Ant_IF,1,1,1,0,0,3
CTAGACTGCATTTCGT-1_Br6432_Ant_IF,1,0,2,1,1,5
TTGCCGGTGATCCCTC-1_Br6432_Ant_IF,2,0,2,0,0,4
CTGTCACGCCAGGCGC-1_Br6432_Ant_IF,3,1,1,0,0,5
CGGTATAGGTATTAGC-1_Br6432_Ant_IF,2,1,0,1,0,4
CCAACGCTTGCCAGGG-1_Br6432_Ant_IF,1,2,3,0,0,6
CGTTGAGTAATTGCGT-1_Br6432_Ant_IF,1,0,1,0,0,2
TGTATTTACCTAATGC-1_Br6432_Ant_IF,2,1,2,0,0,5
TAAATGCCGTCTCATG-1_Br6432_Ant_IF,1,2,5,0,0,8
CGGTTTATGAAGGAAC-1_Br6432_Ant_IF,2,0,1,0,0,3
GCAAGATGTGTTCGCG-1_Br6432_Ant_IF,2,0,4,0,0,6
AAAGGTAAGCTGTACC-1_Br6432_Ant_IF,1,2,4,1,0,8
GTACGTCACGTATTAA-1_Br6432_Ant_IF,2,1,2,1,0,6
AGTACCTTCGAGTGCT-1_Br6432_Ant_IF,1,4,1,0,0,6
ATTGTGACTTCGCTGC-1_Br6432_Ant_IF,1,1,3,1,0,6
TGTATCAGACTGAAGC-1_Br6432_Ant_IF,2,4,0,0,0,6
GAGACCCTGCAACGCC-1_Br6432_Ant_IF,2,1,0,0,0,3
TGGGTGGGATGTCATT-1_Br6432_Ant_IF,3,5,0,0,0,8
GGCTAATGATTGAAAT-1_Br6432_Ant_IF,3,0,1,0,0,4
ATAACGTTACCTCCAC-1_Br6432_Ant_IF,1,0,0,0,0,1
TGCGAGATGGCGGCCA-1_Br6432_Ant_IF,1,1,0,0,0,2
CACACTTGTATTGCGA-1_Br6432_Ant_IF,0,2,0,0,0,2
GCTGGTGACTCGTAGT-1_Br6432_Ant_IF,1,0,0,0,0,1
CGACACCGCTTAAGGA-1_Br6432_Ant_IF,2,1,0,1,1,5
GTAACAACTGACCTTG-1_Br6432_Ant_IF,1,0,0,1,0,2
CAACTGAGGGTATGAC-1_Br6432_Ant_IF,1,0,1,0,1,3
CTAATTATGAAGCGTA-1_Br6432_Ant_IF,0,0,0,0,1,1
CCGATCTTAAGAGGCT-1_Br6432_Ant_IF,2,0,2,0,0,4
CGACTCGGTACACGGT-1_Br6432_Ant_IF,0,0,1,0,3,4
TGCTGCGTCAGAGTTA-1_Br6432_Ant_IF,0,1,1,0,0,2
AGAGTTGCAGGCCTCC-1_Br6432_Ant_IF,1,0,1,0,2,4
ACTGGCGAACCTGCGT-1_Br6432_Ant_IF,1,0,3,0,2,6
ACTAAGGACGCACACC-1_Br6432_Ant_IF,1,0,0,0,2,3
CATTGTGTGCTAGATC-1_Br6432_Ant_IF,1,0,1,0,1,3
CGCGGCAGTATTACGG-1_Br6432_Ant_IF,0,0,0,0,0,0
GAAATGGGATGTAAAC-1_Br6432_Ant_IF,6,0,0,0,1,7
CATTCCCTAAGTACAA-1_Br6432_Ant_IF,2,1,0,1,1,5
AGTTCTGCGTTGTATC-1_Br6432_Ant_IF,0,0,0,0,0,0
ACCCTATAGGACTGAG-1_Br6432_Ant_IF,0,0,0,0,0,0
TTAGATAGGTCGATAC-1_Br6432_Ant_IF,0,1,0,0,0,1
ATTGATAGCAACGAGA-1_Br6432_Ant_IF,0,0,0,0,0,0
TCTCGGCTCCAGGACT-1_Br6432_Ant_IF,0,0,0,1,0,1
CTTGAGGTTATCCCGA-1_Br6432_Ant_IF,2,1,0,0,0,3
AAGAAGGATCAGTTAG-1_Br6432_Ant_IF,1,1,0,2,0,4
GTACGACGGCGCTGCG-1_Br6432_Ant_IF,0,0,0,3,0,3
CTTATGTTGACTACCA-1_Br6432_Ant_IF,0,0,0,3,0,3
CGGCACTCAAGAAAGT-1_Br6432_Ant_IF,0,0,0,0,0,0
GTCAAAGTTTACATAG-1_Br6432_Ant_IF,0,0,0,1,0,1
CCGTACCCAAGCGCCA-1_Br6432_Ant_IF,3,5,0,2,0,10
CATACAAAGCCGAACC-1_Br6432_Ant_IF,2,0,0,1,0,3
GGTCGGTAATTAGACA-1_Br6432_Ant_IF,2,1,0,0,0,3
AGCGGGAAGGGTCCAT-1_Br6432_Ant_IF,3,1,0,2,0,6
GCCCACCAAGGCTGTC-1_Br6432_Ant_IF,4,1,0,2,0,7
GTAGACGTCGTTACAT-1_Br6432_Ant_IF,2,4,1,0,0,7
GAGCATCATCCCTGGG-1_Br6432_Ant_IF,1,6,0,0,1,8
AGGTAACCTCCTATTC-1_Br6432_Ant_IF,3,0,0,0,1,4
GGTTTGAGTGCTGGAA-1_Br6432_Ant_IF,3,0,1,0,0,4
GCACTAGTCGCGCTAT-1_Br6432_Ant_IF,1,0,0,0,1,2
GGTAACTATGTATCTG-1_Br6432_Ant_IF,3,0,1,0,1,5
GCGGTCCCTAGACGCA-1_Br6432_Ant_IF,1,2,0,0,2,5
CGAGCGTTGATCAGCC-1_Br6432_Ant_IF,0,1,1,1,2,5
AATCCAAGGGCCTGAG-1_Br6432_Ant_IF,2,0,0,0,0,2
CCGTGCCCATGACGGC-1_Br6432_Ant_IF,4,1,0,0,1,6
GAAATTCACATCGCTG-1_Br6432_Ant_IF,1,0,0,0,0,1
CTCTGCGAAGCAAGCA-1_Br6432_Ant_IF,3,0,0,0,0,3
AGTAGGTAACATACAT-1_Br6432_Ant_IF,3,0,2,0,1,6
ATTGGGAATATCTTGG-1_Br6432_Ant_IF,5,0,1,1,1,8
TAGAGCTACGAAGAAC-1_Br6432_Ant_IF,1,0,1,0,2,4
TGCGGCATAGTTCAAC-1_Br6432_Ant_IF,1,2,0,0,1,4
CCGCCGGTCAACACAC-1_Br6432_Ant_IF,0,0,0,0,1,1
TCGTATAGTGCAATTA-1_Br6432_Ant_IF,2,0,0,0,1,3
TAGTTTATTCTTGCTT-1_Br6432_Ant_IF,1,0,1,0,0,2
GATATCTCATGCAATA-1_Br6432_Ant_IF,2,4,2,0,2,10
CGTTTAAGCGGAGCAC-1_Br6432_Ant_IF,0,1,1,0,1,3
CATGCTGGCTCCAATT-1_Br6432_Ant_IF,1,1,1,1,0,4
GAAACAGCCATGCAGT-1_Br6432_Ant_IF,0,0,0,0,0,0
AGTTTCGCAGGTCGGA-1_Br6432_Ant_IF,1,0,0,0,1,2
CTCATGGCTCACAATC-1_Br6432_Ant_IF,2,0,0,0,0,2
AACCGTTGTGTTTGCT-1_Br6432_Ant_IF,0,0,0,0,0,0
ACCCTTCATCTGCGAA-1_Br6432_Ant_IF,1,0,1,0,0,2
TGCGGTGAAATTTCAT-1_Br6432_Ant_IF,0,0,0,0,0,0
CAAATTGTCAGCAAGC-1_Br6432_Ant_IF,1,0,0,0,0,1
GAGGTACATCCATCTT-1_Br6432_Ant_IF,1,0,0,0,0,1
AAATGGCATGTCTTGT-1_Br6432_Ant_IF,2,1,1,0,0,4
TCATCCCAGAGGGTGG-1_Br6432_Ant_IF,3,2,0,0,0,5
CGTAGCGAATTGTCAG-1_Br6432_Ant_IF,2,1,1,0,1,5
CCTAGTTAGTCGCATG-1_Br6432_Ant_IF,6,0,2,0,0,8
GAAACTCTAATGAAGG-1_Br6432_Ant_IF,3,0,0,0,0,3
TTGTATCACACAGAAT-1_Br6432_Ant_IF,2,0,2,0,0,4
TTCAAGCCGAGCTGAG-1_Br6432_Ant_IF,2,1,4,0,0,7
AGGTACGATATTGCCA-1_Br6432_Ant_IF,2,1,0,0,0,3
TTAAGCCGACAACTTC-1_Br6432_Ant_IF,1,2,1,0,1,5
GTCTTAGTACAGCCGG-1_Br6432_Ant_IF,1,0,0,0,0,1
TGGGTAAGGTTCCCGC-1_Br6432_Ant_IF,1,0,1,0,0,2
CTACGCCATTTCCGAT-1_Br6432_Ant_IF,1,1,1,0,1,4
GACCGTCAGGTCGTGA-1_Br6432_Ant_IF,1,0,1,0,0,2
TAGTTAAGATAGGATA-1_Br6432_Ant_IF,0,0,1,0,0,1
GAATATTCGGAGTCCC-1_Br6432_Ant_IF,0,0,0,0,2,2
CAAACTACGATAGAGA-1_Br6432_Ant_IF,1,0,1,0,2,4
CAGGAAGACTTTATAT-1_Br6432_Ant_IF,1,2,0,0,0,3
TTCGTAATCCCAGCGG-1_Br6432_Ant_IF,2,0,0,0,0,2
GTGAGGAGCGGTTGAG-1_Br6432_Ant_IF,0,0,1,0,0,1
CAATCCCTATACCAGC-1_Br6432_Ant_IF,1,1,1,0,0,3
AGGGAAACGAGGTACT-1_Br6432_Ant_IF,2,0,0,1,1,4
TCCTGCCAACTGGAGA-1_Br6432_Ant_IF,1,0,0,0,1,2
AATTTGGGACATAGTA-1_Br6432_Ant_IF,1,0,3,0,0,4
AACTCCTAATCCCATG-1_Br6432_Ant_IF,1,1,2,0,1,5
GCTCATTACTGCATGT-1_Br6432_Ant_IF,1,0,0,2,0,3
TCTCGAACGAGGTCAC-1_Br6432_Ant_IF,0,1,3,0,1,5
TCACTACGACCAATGC-1_Br6432_Ant_IF,1,0,0,0,0,1
GTGATGCACAACATCT-1_Br6432_Ant_IF,2,0,2,0,0,4
CCGACGTAAACACAAC-1_Br6432_Ant_IF,1,1,5,1,0,8
TGGGATGCACTCATTC-1_Br6432_Ant_IF,3,0,0,0,0,3
TTCCATCATGCGGTGA-1_Br6432_Ant_IF,1,0,0,1,0,2
TGCACAGTGAAGTTAT-1_Br6432_Ant_IF,0,2,2,0,0,4
CTATTGTGTTTGGTCA-1_Br6432_Ant_IF,2,2,2,1,0,7
TGCGAGCCCTTCCGCG-1_Br6432_Ant_IF,0,0,4,0,0,4
TTGAAAGGTGTAAAGG-1_Br6432_Ant_IF,1,2,0,1,0,4
GGTGCAGAGCCTATCG-1_Br6432_Ant_IF,1,0,5,1,0,7
ACTATATGCTGTGTTC-1_Br6432_Ant_IF,2,1,0,1,0,4
TCCTGGCGCTGCCTGG-1_Br6432_Ant_IF,2,2,2,1,0,7
GAGCCGAGCGTTTATT-1_Br6432_Ant_IF,2,1,4,0,0,7
AGAATGCGGGTTCGGA-1_Br6432_Ant_IF,2,2,1,0,0,5
ATGCGACAATTGGTCC-1_Br6432_Ant_IF,4,0,1,0,0,5
TTCCGGCTCGACTTCT-1_Br6432_Ant_IF,0,1,0,3,0,4
TGATTATGGCACGCAG-1_Br6432_Ant_IF,2,0,0,2,0,4
GGTTTGACAAGAAGCT-1_Br6432_Ant_IF,0,1,1,0,0,2
GCAGCTATGGACAGGT-1_Br6432_Ant_IF,1,2,1,3,0,7
CACCATGATCGCAAAG-1_Br6432_Ant_IF,1,0,1,0,0,2
GTCGGAAGGATACCAG-1_Br6432_Ant_IF,0,0,2,0,0,2
GGCCCAGTTATCAGCA-1_Br6432_Ant_IF,2,1,0,1,0,4
GGGCCTATTTAAGTAT-1_Br6432_Ant_IF,0,2,1,2,0,5
GTTGTTACATTGCGCT-1_Br6432_Ant_IF,1,0,2,0,1,4
CAACTCCGTAACTTGC-1_Br6432_Ant_IF,2,2,1,0,0,5
GATCTTTGCTCAAAGA-1_Br6432_Ant_IF,1,2,1,0,0,4
TCGCTTAATTACGAAG-1_Br6432_Ant_IF,2,0,0,0,0,2
CGATCATTAGAGGCAC-1_Br6432_Ant_IF,0,3,1,1,0,5
TGTTCTCTACTCCCTA-1_Br6432_Ant_IF,1,1,0,0,1,3
GCTTAGGGAAGCGGTA-1_Br6432_Ant_IF,4,0,0,0,2,6
CAGGTTTAGTACTACA-1_Br6432_Ant_IF,2,0,3,0,0,5
AAGCGGAGTGCGCGCA-1_Br6432_Ant_IF,0,2,0,0,0,2
TCAGATGGAGACGTAG-1_Br6432_Ant_IF,2,2,1,0,0,5
GGCGGTTTGCCGGTGC-1_Br6432_Ant_IF,0,0,0,0,0,0
TAGTCCGTATGCATAA-1_Br6432_Ant_IF,1,0,0,0,0,1
CACTTCGTCTTATCTC-1_Br6432_Ant_IF,0,0,0,0,0,0
CATCCGCAGGCCCGAA-1_Br6432_Ant_IF,1,0,0,0,3,4
CCCTGATGTAACTCGT-1_Br6432_Ant_IF,2,2,0,0,0,4
CCATAGTCAGTAACCC-1_Br6432_Ant_IF,3,0,0,0,2,5
CGGGCCATAGCCGCAC-1_Br6432_Ant_IF,2,0,0,0,2,4
CTCCGGCTTGTAGACA-1_Br6432_Ant_IF,2,0,0,0,0,2
AACTTGCGTTCTCGCG-1_Br6432_Ant_IF,0,1,0,0,0,1
AATGAGTTCGCATATG-1_Br6432_Ant_IF,1,4,0,1,0,6
CGAGGCCAGGCATTGG-1_Br6432_Ant_IF,1,2,0,0,0,3
TCTGCGTCCGGTTTCT-1_Br6432_Ant_IF,0,0,0,0,0,0
CAATCCTGCCGTGGAG-1_Br6432_Ant_IF,1,0,0,0,0,1
CTGAGCAAGTAACAAG-1_Br6432_Ant_IF,1,0,0,0,0,1
GGGTACCCACGGTCCT-1_Br6432_Ant_IF,2,1,1,0,0,4
ACGGAATTTAGCAAAT-1_Br6432_Ant_IF,1,0,2,2,1,6
GGGCGGTCCTATTGTC-1_Br6432_Ant_IF,1,0,1,3,0,5
ATGTTACGAGCAATAC-1_Br6432_Ant_IF,3,0,0,1,0,4
AACCATGGGATCGCTA-1_Br6432_Ant_IF,0,0,0,0,0,0
TCGCATCCCTAAGTGT-1_Br6432_Ant_IF,0,0,0,1,0,1
CGCTATACCGCCCACT-1_Br6432_Ant_IF,3,0,0,1,0,4
CAGTGTCCGCAGAATG-1_Br6432_Ant_IF,1,0,0,4,0,5
CCATCCATACCAAGTC-1_Br6432_Ant_IF,3,7,1,1,0,12
AACCCAGAGACGGAGA-1_Br6432_Ant_IF,2,0,2,4,1,9
GAAGAACGGTGCAGGT-1_Br6432_Ant_IF,1,1,0,0,0,2
GATAAATCGGTGGATG-1_Br6432_Ant_IF,1,0,0,0,0,1
CAGCTCGTGCTTGTGT-1_Br6432_Ant_IF,1,2,0,1,0,4
GAGTACGGGTATACAA-1_Br6432_Ant_IF,5,1,0,0,0,6
CATCGCCCGCGGCCAA-1_Br6432_Ant_IF,4,0,0,0,0,4
TCTTACAGAGGTACCG-1_Br6432_Ant_IF,1,0,2,0,0,3
TGGAAGACGAACACCA-1_Br6432_Ant_IF,2,0,0,1,1,4
GTTGTCGTGTTAGTTG-1_Br6432_Ant_IF,5,3,0,0,1,9
CCAAGGAACAGAGAGG-1_Br6432_Ant_IF,0,3,0,1,0,4
CTGCACCTGGAACCGC-1_Br6432_Ant_IF,0,0,0,0,2,2
CGCTTTCATACCGGTG-1_Br6432_Ant_IF,6,0,0,0,0,6
GTTCTTCCCTCGATGT-1_Br6432_Ant_IF,3,0,0,0,0,3
ATTTAACTCGTATTAC-1_Br6432_Ant_IF,1,0,0,0,5,6
AACGATAGAAGGGCCG-1_Br6432_Ant_IF,0,0,1,4,1,6
TATCCTGCATGGGAAT-1_Br6432_Ant_IF,2,0,0,0,1,3
AGGCCCATTGTACAGG-1_Br6432_Ant_IF,3,0,0,0,1,4
CCGGCGCATATTGGAT-1_Br6432_Ant_IF,1,0,0,0,0,1
ATCTGTAATTGTACCC-1_Br6432_Ant_IF,2,0,0,0,0,2
GAGCGAGGGAGTACCG-1_Br6432_Ant_IF,1,0,1,0,1,3
TTATTAGGGAAGCATC-1_Br6432_Ant_IF,1,0,1,0,1,3
CTTCTTACGTCGTATA-1_Br6432_Ant_IF,1,0,0,0,0,1
GAAGTGCTGGATAGCT-1_Br6432_Ant_IF,3,0,1,0,0,4
GTGCAACAAATGTGGC-1_Br6432_Ant_IF,1,0,1,0,0,2
CATGCGTTAGACAGAA-1_Br6432_Ant_IF,2,1,2,0,2,7
ACACACTTTCTACACG-1_Br6432_Ant_IF,1,1,0,0,0,2
AGCCCTAAGCGAAGTT-1_Br6432_Ant_IF,5,0,0,0,0,5
ATTAATTCGGTCACTC-1_Br6432_Ant_IF,1,0,0,0,0,1
AACAGGAAATCGAATA-1_Br6432_Ant_IF,1,2,0,0,0,3
ACGTTTAGTTGTGATC-1_Br6432_Ant_IF,2,1,0,0,0,3
TCCTTCAGTGGTCGAA-1_Br6432_Ant_IF,0,0,0,0,0,0
CGAACGCCCAGTGCCG-1_Br6432_Ant_IF,1,0,0,0,0,1
CCTCGAAGTGGACGGG-1_Br6432_Ant_IF,3,0,1,0,0,4
CTCTGTTTGAGGATTC-1_Br6432_Ant_IF,3,0,0,0,0,3
TGGGCACGTTCTATGG-1_Br6432_Ant_IF,4,0,3,0,0,7
ACTATTCGTCCGTGGT-1_Br6432_Ant_IF,1,1,0,0,1,3
CCTCTGGCCTAGACGG-1_Br6432_Ant_IF,2,0,0,0,2,4
CCATAAACAACCCGAC-1_Br6432_Ant_IF,1,0,0,0,4,5
CATAGTACATTGAGAG-1_Br6432_Ant_IF,5,1,0,0,0,6
ATTTCATTATTTCGCG-1_Br6432_Ant_IF,4,0,0,0,1,5
CAACTATATCGAATGC-1_Br6432_Ant_IF,2,0,2,0,0,4
CTAGTATTCGGAATTA-1_Br6432_Ant_IF,2,2,3,0,0,7
GTGGAACCTACATGCG-1_Br6432_Ant_IF,4,0,1,0,0,5
CCTAAAGGCTGACGCT-1_Br6432_Ant_IF,1,0,0,0,1,2
CGTGACATTGGGTCGT-1_Br6432_Ant_IF,0,0,0,0,0,0
CCAATCGGTAGATCGA-1_Br6432_Ant_IF,0,1,2,0,0,3
ATTGTCGCAATACCTT-1_Br6432_Ant_IF,5,0,1,0,0,6
AAATTACACGACTCTG-1_Br6432_Ant_IF,0,0,1,0,1,2
CACTCCTCTCGGTCGG-1_Br6432_Ant_IF,1,0,0,0,1,2
AAATAACCATACGGGA-1_Br6432_Ant_IF,2,1,0,0,0,3
AGTTACTCTATCGTGG-1_Br6432_Ant_IF,0,0,2,0,1,3
CGTTAGCTCACAACTG-1_Br6432_Ant_IF,3,1,0,0,1,5
GAATGTATGGCAGGTC-1_Br6432_Ant_IF,0,0,0,0,1,1
GCAACCACCAGACCGG-1_Br6432_Ant_IF,0,0,0,0,0,0
TCACTCGTGCAACGGC-1_Br6432_Ant_IF,1,0,0,0,0,1
AAACAGAGCGACTCCT-1_Br6432_Ant_IF,0,0,1,1,1,3
CAGCCTCTCCTCAAGA-1_Br6432_Ant_IF,1,1,1,0,0,3
TTGCGTGAACGCTTAG-1_Br6432_Ant_IF,1,0,0,1,0,2
CCGCCTGCGAATTGGT-1_Br6432_Ant_IF,0,1,2,0,0,3
AGATGAGGGTTGCGAT-1_Br6432_Ant_IF,1,1,1,0,0,3
CGGTGGGCTCCAGCCT-1_Br6432_Ant_IF,3,0,2,0,1,6
GGCAGCGGTAATCCTA-1_Br6432_Ant_IF,2,0,4,1,0,7
GCTAGCAGGGAGTGGG-1_Br6432_Ant_IF,0,2,3,0,0,5
CTCAAGACATTAGCGC-1_Br6432_Ant_IF,1,0,0,0,0,1
CACGGCGCGCCAAAGG-1_Br6432_Ant_IF,0,0,3,0,0,3
TGCAATTTGGGCACGG-1_Br6432_Ant_IF,1,0,1,0,0,2
ATGCCAATCGCTCTGC-1_Br6432_Ant_IF,1,1,2,0,0,4
GCTGGACCCAAAGTGG-1_Br6432_Ant_IF,0,2,0,0,0,2
ATTCCTAAGACGTGGA-1_Br6432_Ant_IF,1,1,4,1,0,7
TCCGGAGGAAGGGCTG-1_Br6432_Ant_IF,2,1,1,0,0,4
TCGGTGACCGCTCCGG-1_Br6432_Ant_IF,2,2,0,0,0,4
TCCGAAGTAGTCACCA-1_Br6432_Ant_IF,5,3,0,0,0,8
CATGTAGGAGCGCCAA-1_Br6432_Ant_IF,0,2,2,0,0,4
CACAAGAAAGATATTA-1_Br6432_Ant_IF,0,1,1,1,0,3
AGGGTCAGTAACCCTA-1_Br6432_Ant_IF,0,4,4,0,0,8
TAAGCCCTTACGACCA-1_Br6432_Ant_IF,0,3,4,0,0,7
ATACCGTCATCCATAA-1_Br6432_Ant_IF,1,3,2,2,0,8
GGACGTCCATAGTTGG-1_Br6432_Ant_IF,2,0,3,0,0,5
CATCAAACTGGCGCCC-1_Br6432_Ant_IF,2,2,1,2,0,7
AAACGTGTTCGCCCTA-1_Br6432_Ant_IF,3,0,4,0,0,7
AAATTGGTGAGAAGCA-1_Br6432_Ant_IF,1,1,0,0,0,2
GGTCATTGTAGTCATA-1_Br6432_Ant_IF,1,1,3,0,0,5
TGCAGTGAGGCTCGGG-1_Br6432_Ant_IF,2,1,2,1,1,7
GAACATTAGTATGTTA-1_Br6432_Ant_IF,2,0,2,0,3,7
GGTTTGCGAACACGTA-1_Br6432_Ant_IF,0,1,2,0,0,3
ACACAAATATTCCTAG-1_Br6432_Ant_IF,1,2,2,0,2,7
TTGGGTTTATTCAGCG-1_Br6432_Ant_IF,0,0,2,0,3,5
ATTCGCAGAGGACACT-1_Br6432_Ant_IF,1,0,0,0,0,1
GATTTAGTGCGTACTG-1_Br6432_Ant_IF,1,0,0,2,0,3
GCTCAACCTCTTAGAG-1_Br6432_Ant_IF,1,0,0,0,1,2
ATAGCTGCTCTTGTTA-1_Br6432_Ant_IF,0,0,0,0,0,0
CGTCAGCTATTTACTC-1_Br6432_Ant_IF,1,0,2,0,1,4
ATCTGATAGTGTCTTA-1_Br6432_Ant_IF,1,0,0,0,3,4
TGCACTATGTGAGTGC-1_Br6432_Ant_IF,2,0,2,0,0,4
CCGACAAACACATGAG-1_Br6432_Ant_IF,5,1,0,0,1,7
GCCTTGTATATGCAGT-1_Br6432_Ant_IF,1,1,0,0,0,2
ATAATACCGTTAGCCG-1_Br6432_Ant_IF,4,0,0,0,0,4
ACACTCCAATGTCACT-1_Br6432_Ant_IF,0,0,0,0,2,2
AGTTGCTGACTGATAT-1_Br6432_Ant_IF,7,0,0,0,1,8
GGCGCTCCTCATCAAT-1_Br6432_Ant_IF,1,0,0,0,1,2
TGCCTGACATCGGTCA-1_Br6432_Ant_IF,1,0,0,0,2,3
TTGGCCATCTTGCGCT-1_Br6432_Ant_IF,4,0,0,0,0,4
CAGTGGTTGCACATGA-1_Br6432_Ant_IF,3,1,0,0,2,6
AGAATTGTTTGACATA-1_Br6432_Ant_IF,1,2,1,0,3,7
AAATGCTCGTTACGTT-1_Br6432_Ant_IF,4,1,2,0,1,8
CACCTAATAGAGTCGT-1_Br6432_Ant_IF,3,2,0,1,0,6
CATTTCTAGCAGACTA-1_Br6432_Ant_IF,1,0,1,0,0,2
CCGAAAGTGGTGAGCA-1_Br6432_Ant_IF,0,0,0,0,0,0
AGTCAGCCACCGCCTG-1_Br6432_Ant_IF,0,0,0,0,0,0
TCATCACTCGAGCTCG-1_Br6432_Ant_IF,1,0,0,0,0,1
CTCAGGACTCACCTGT-1_Br6432_Ant_IF,4,0,0,2,0,6
CGGTGTACTTGATCCC-1_Br6432_Ant_IF,0,0,0,6,0,6
CCTACGGCTCAGTCGA-1_Br6432_Ant_IF,0,0,1,5,0,6
GTACTTGGGCACTTCT-1_Br6432_Ant_IF,0,0,1,0,0,1
GGTGAGATGCAGATAA-1_Br6432_Ant_IF,1,2,0,0,0,3
AGGACATCGCACGTCG-1_Br6432_Ant_IF,0,0,0,5,0,5
GTGGACGTGCTGAGAC-1_Br6432_Ant_IF,0,0,0,2,0,2
TAAGGAACTTGTGGGA-1_Br6432_Ant_IF,2,0,1,0,0,3
TCGCTGTGCGTAAATC-1_Br6432_Ant_IF,0,4,0,2,0,6
GCATCCCTAACTTTGA-1_Br6432_Ant_IF,0,0,0,0,1,1
CACCCACACGTCACCC-1_Br6432_Ant_IF,0,0,0,0,0,0
CCCTCATTCTGGAATT-1_Br6432_Ant_IF,4,0,0,0,0,4
AGGGCGTGATCGGCTA-1_Br6432_Ant_IF,2,0,0,0,1,3
GGTGCGGATAAGTGGC-1_Br6432_Ant_IF,6,0,0,0,0,6
TAATATTGAAATTCGC-1_Br6432_Ant_IF,6,1,0,0,0,7
CTTACACTGGGAAATA-1_Br6432_Ant_IF,2,1,0,0,3,6
ACCAAGAACGCGTGTC-1_Br6432_Ant_IF,5,2,0,0,1,8
GCCTTCAGCCCTACCG-1_Br6432_Ant_IF,3,1,0,0,2,6
GATGCTACAAGCGCCT-1_Br6432_Ant_IF,0,1,0,0,2,3
CCGGGACCCGCAGAGA-1_Br6432_Ant_IF,2,0,0,2,0,4
GTTCCAGTCTGACCAT-1_Br6432_Ant_IF,0,2,0,0,0,2
ATGATCGGGAATAGAC-1_Br6432_Ant_IF,0,0,0,0,0,0
TTGGATTGGGTACCAC-1_Br6432_Ant_IF,1,1,2,0,1,5
TACCTCACGCTTGTAC-1_Br6432_Ant_IF,2,0,1,0,1,4
CATGGCAGGAAGATCG-1_Br6432_Ant_IF,0,0,1,0,0,1
ATGACGCCGGCTCTAA-1_Br6432_Ant_IF,5,0,0,0,0,5
AGCGACATCCCATTCA-1_Br6432_Ant_IF,3,1,2,0,1,7
AGTAATGTCTTGCCGC-1_Br6432_Ant_IF,2,0,1,1,1,5
TTCTTAGTGGCTCAGA-1_Br6432_Ant_IF,4,0,0,0,1,5
CGTCTGGAAGGGCCCG-1_Br6432_Ant_IF,0,0,0,1,0,1
ACGTGCGCCTCGTGCA-1_Br6432_Ant_IF,1,0,3,0,0,4
AGAGCGGGCTAATCAT-1_Br6432_Ant_IF,1,0,1,0,1,3
GCGTCGAAATGTCGGT-1_Br6432_Ant_IF,0,0,0,0,0,0
AACTGATATTAGGCCT-1_Br6432_Ant_IF,3,0,2,0,1,6
CGAGCTGGGCTTTAGG-1_Br6432_Ant_IF,3,1,0,0,0,4
GGGTGTTTCAGCTATG-1_Br6432_Ant_IF,5,0,0,0,0,5
TTAATTTCAGACGCGG-1_Br6432_Ant_IF,2,1,1,0,1,5
ACTGCCGTCGTAACTC-1_Br6432_Ant_IF,3,0,1,0,0,4
GTGCACGAAAGTGACT-1_Br6432_Ant_IF,2,1,1,0,1,5
ATCTCCCTGCAATCTA-1_Br6432_Ant_IF,0,1,0,0,1,2
ACGCCAGATGATTTCT-1_Br6432_Ant_IF,1,0,0,0,1,2
AGCTATTTAATCCAAC-1_Br6432_Ant_IF,1,1,1,0,2,5
CCACGAGAAGAGAATC-1_Br6432_Ant_IF,2,0,0,0,2,4
GATTCCGCGTTTCCGT-1_Br6432_Ant_IF,2,0,0,0,1,3
GTCGGATGTAGCGCGC-1_Br6432_Ant_IF,4,0,0,0,0,4
TATTTATACCGAGTAG-1_Br6432_Ant_IF,0,0,0,0,0,0
GTAGGTGATCCGTGTA-1_Br6432_Ant_IF,1,1,0,0,2,4
AGTTAAGCGGTCCCGG-1_Br6432_Ant_IF,2,1,0,0,2,5
CTGGCGACATAAGTCC-1_Br6432_Ant_IF,2,0,0,0,1,3
TTGGCCTAGAATTTCG-1_Br6432_Ant_IF,0,0,0,0,1,1
GGCATATCGGTTCTGC-1_Br6432_Ant_IF,0,1,0,0,0,1
GGGCGTCCACTGGCTC-1_Br6432_Ant_IF,1,1,1,0,1,4
TTACCCATTGCCGGGT-1_Br6432_Ant_IF,2,0,0,0,0,2
TTAGACACGATCGTTG-1_Br6432_Ant_IF,0,0,2,0,1,3
GCGCTGATCCAGACTC-1_Br6432_Ant_IF,1,0,1,0,0,2
TTCGGCAACCCGCTGA-1_Br6432_Ant_IF,2,1,1,0,1,5
GATATTTCCTACATGG-1_Br6432_Ant_IF,2,0,3,0,0,5
CTGCGTTACGATATAA-1_Br6432_Ant_IF,2,0,1,0,0,3
TAATAAACAAGGAGAT-1_Br6432_Ant_IF,4,1,1,0,2,8
AACCTTTACGACGTCT-1_Br6432_Ant_IF,2,0,1,0,1,4
AGTCCCGCCTTTAATT-1_Br6432_Ant_IF,2,3,1,0,0,6
TGAGATTAGGCCCTAA-1_Br6432_Ant_IF,0,2,0,0,0,2
AGTGTATTGCGCATTG-1_Br6432_Ant_IF,0,0,0,0,1,1
GTTGGATTCAGTGGCT-1_Br6432_Ant_IF,0,2,2,0,3,7
TAAAGCTGCAATAGGG-1_Br6432_Ant_IF,2,2,0,0,1,5
AGTAGGAAGGAAGTTG-1_Br6432_Ant_IF,2,1,0,1,0,4
TATCACTTCGAGTAAC-1_Br6432_Ant_IF,2,2,0,0,1,5
TGATCTACGCTGATCT-1_Br6432_Ant_IF,2,1,0,0,0,3
GGATCATCCCGTACGC-1_Br6432_Ant_IF,2,3,0,0,0,5
TGACACTTCTCTTTGC-1_Br6432_Ant_IF,1,1,0,1,0,3
AGCCCTTCTAATCCGA-1_Br6432_Ant_IF,0,4,0,2,1,7
CACCGCGTCCACTCTA-1_Br6432_Ant_IF,1,1,3,0,0,5
TAATTGGAATCGGGAA-1_Br6432_Ant_IF,0,2,0,2,0,4
TCGTAAGCTCCGAGGA-1_Br6432_Ant_IF,1,1,1,1,0,4
TATATTACAAATGTCG-1_Br6432_Ant_IF,1,2,0,2,0,5
CGCGAGAGGGACTTGT-1_Br6432_Ant_IF,1,2,0,0,0,3
GGACCTACGGTAACGT-1_Br6432_Ant_IF,1,2,0,0,0,3
GAAATATGCTTGAATG-1_Br6432_Ant_IF,1,0,1,2,0,4
CCGTATTAGCGCAGTT-1_Br6432_Ant_IF,0,4,0,2,0,6
AGGCGTCTATGGACGG-1_Br6432_Ant_IF,0,5,2,1,0,8
AACATCGATACGTCTA-1_Br6432_Ant_IF,1,1,0,1,0,3
TGAATATGCTATAAAC-1_Br6432_Ant_IF,1,1,2,1,0,5
ACCAAACACCCAGCGA-1_Br6432_Ant_IF,1,1,0,0,0,2
TGGCTTGTACAAGCTT-1_Br6432_Ant_IF,2,2,1,0,1,6
GAATGAAGGTCTTCAG-1_Br6432_Ant_IF,2,2,0,1,0,5
AGATACCAGCACTTCA-1_Br6432_Ant_IF,3,0,1,0,0,4
GCGGTCCCGGTGAAGG-1_Br6432_Ant_IF,0,0,1,0,0,1
GAGGCATTTGCAGCAG-1_Br6432_Ant_IF,4,1,0,0,0,5
GGCAAGCCAGGGATAG-1_Br6432_Ant_IF,1,1,2,0,0,4
TCTACGGGCTCAGTTG-1_Br6432_Ant_IF,1,1,1,0,1,4
TCTGCGAATCGTTCGC-1_Br6432_Ant_IF,0,1,0,0,1,2
AGCTCGTTGATGGAAA-1_Br6432_Ant_IF,2,0,0,0,1,3
TGAATGAGATACAGCA-1_Br6432_Ant_IF,1,0,0,0,0,1
ACCCTTGCCTGGGTCG-1_Br6432_Ant_IF,2,0,1,0,0,3
GGCGAACCGTTCTGAT-1_Br6432_Ant_IF,3,0,1,0,2,6
GCTGAGCAACGGTTCT-1_Br6432_Ant_IF,0,1,0,0,0,1
TCACTCTTCGTCTGTC-1_Br6432_Ant_IF,1,1,0,0,2,4
GATCTTCATTGTCCTC-1_Br6432_Ant_IF,0,0,0,0,0,0
ACTCGATGTATTTCAT-1_Br6432_Ant_IF,2,1,1,0,2,6
TGAAGAGCGGTCCTAG-1_Br6432_Ant_IF,4,1,3,0,1,9
TAAACGTCGTCAATGA-1_Br6432_Ant_IF,2,1,0,1,1,5
ACGTTATTGGTCACTC-1_Br6432_Ant_IF,4,0,0,0,0,4
ATAGCCTCAGTACCCA-1_Br6432_Ant_IF,2,0,1,0,0,3
CGGGAGTATACCGCCG-1_Br6432_Ant_IF,1,0,0,0,0,1
GTCCTACAGGCGGCTC-1_Br6432_Ant_IF,4,0,0,0,1,5
CGGATAAGCGGACATG-1_Br6432_Ant_IF,2,0,0,0,0,2
AACTTCTGCGTCTATC-1_Br6432_Ant_IF,2,0,0,0,1,3
GGGTTCAGACGAACAA-1_Br6432_Ant_IF,0,1,0,0,0,1
AGTCTGGACATCCTTG-1_Br6432_Ant_IF,2,1,0,0,0,3
TTGAACGAATCCTTTG-1_Br6432_Ant_IF,3,0,1,0,3,7
GAAATACTAAACGTTT-1_Br6432_Ant_IF,3,2,5,0,0,10
CCCGCGCAATGCACCC-1_Br6432_Ant_IF,1,1,1,0,2,5
TTCGGCTAGAGATGGT-1_Br6432_Ant_IF,4,1,0,0,2,7
GACACGAGTTAGAGGA-1_Br6432_Ant_IF,4,0,1,0,5,10
GAGGTCCCAAAGATCT-1_Br6432_Ant_IF,4,1,0,1,0,6
TAACTCCATGGAGGCT-1_Br6432_Ant_IF,2,0,0,0,1,3
CTTGTTTATGTAGCCA-1_Br6432_Ant_IF,4,0,0,0,0,4
GATGGCGCACACATTA-1_Br6432_Ant_IF,1,0,0,0,0,1
ATAATAGTGTAGGGAC-1_Br6432_Ant_IF,2,0,1,2,0,5
CGCTATTCAATGTATG-1_Br6432_Ant_IF,1,0,0,1,0,2
ATATTGCTGTCAAAGT-1_Br6432_Ant_IF,0,0,1,7,0,8
GGATTCAGTACGGTGG-1_Br6432_Ant_IF,0,0,0,3,0,3
TTCTTAGTGAACGGTG-1_Br6432_Ant_IF,0,0,0,0,0,0
TCTATCATGCAGTTAC-1_Br6432_Ant_IF,0,0,0,0,0,0
CCCGCCATGCTCCCGT-1_Br6432_Ant_IF,0,0,0,1,0,1
CGCTTCCACTGAAATC-1_Br6432_Ant_IF,2,1,0,0,0,3
CACTGTCCAAGTGAGA-1_Br6432_Ant_IF,0,0,0,1,0,1
ATTACTAGCCTCTTGC-1_Br6432_Ant_IF,2,0,0,1,0,3
CATAGTAGCATAGTAG-1_Br6432_Ant_IF,1,0,0,0,0,1
CAACTCCTTGATCCCG-1_Br6432_Ant_IF,0,2,0,0,0,2
AAGTAGAAGACCGGGT-1_Br6432_Ant_IF,2,1,1,0,0,4
GCGGGAACCAGGCCCT-1_Br6432_Ant_IF,6,1,0,0,0,7
ATTAGATTGATAGCGG-1_Br6432_Ant_IF,4,0,0,0,0,4
CTCGGTCCGTAGCCTG-1_Br6432_Ant_IF,7,0,0,0,0,7
TGGCTTTGGGTAGACA-1_Br6432_Ant_IF,4,1,1,0,2,8
TATCCATATCATGCGA-1_Br6432_Ant_IF,2,0,0,0,0,2
GGAGTGCCGCCCTGGA-1_Br6432_Ant_IF,2,0,0,0,1,3
TGAGAATGCTTTACCG-1_Br6432_Ant_IF,4,0,1,0,1,6
TTAACCAACCCTCCCT-1_Br6432_Ant_IF,1,1,1,0,0,3
TGTTTCGGTACTTCTC-1_Br6432_Ant_IF,1,0,1,0,0,2
TTGCTGAAGGAACCAC-1_Br6432_Ant_IF,0,0,0,0,0,0
TATTTAGTCTAGATCG-1_Br6432_Ant_IF,0,0,1,0,1,2
CTCCGGCCTAATATGC-1_Br6432_Ant_IF,0,0,0,1,0,1
TTGTGGCCCTGACAGT-1_Br6432_Ant_IF,5,0,0,0,0,5
TCGCCGGTCGATCCGT-1_Br6432_Ant_IF,5,0,0,0,0,5
CCATAGGTTGGCGTGG-1_Br6432_Ant_IF,0,0,0,0,0,0
GAACGACCGAATGATA-1_Br6432_Ant_IF,4,0,0,0,0,4
TCCGATAATTGCCATA-1_Br6432_Ant_IF,2,0,0,0,1,3
CATTACGTCGGCCCGT-1_Br6432_Ant_IF,2,0,1,0,0,3
CAAGCACCAAATGCCT-1_Br6432_Ant_IF,2,0,2,0,2,6
TGCATGGATCGGATCT-1_Br6432_Ant_IF,3,2,0,0,0,5
GAAATCGCGCGCAACT-1_Br6432_Ant_IF,2,1,1,0,1,5
CTGAAAGAGATCCGAC-1_Br6432_Ant_IF,2,0,0,0,0,2
CACCTCGATGGTGGAC-1_Br6432_Ant_IF,3,2,0,0,0,5
ATTTGTTCCAGGGCTC-1_Br6432_Ant_IF,1,0,0,0,2,3
TGGGCCACAAGAGCGC-1_Br6432_Ant_IF,0,0,1,0,1,2
CCTTCTTGATCCAGTG-1_Br6432_Ant_IF,5,0,2,0,1,8
CCTCGCCAGCAAATTA-1_Br6432_Ant_IF,0,0,0,0,0,0
TTCATGGCGCAACAGG-1_Br6432_Ant_IF,3,0,1,0,1,5
TTAATCAGTACGTCAG-1_Br6432_Ant_IF,2,0,1,0,1,4
CCTATCTATATCGGAA-1_Br6432_Ant_IF,4,0,1,0,1,6
ATTATACTTTGCTCGT-1_Br6432_Ant_IF,3,1,2,0,3,9
ATGGATCCGGCGTCCG-1_Br6432_Ant_IF,3,0,2,0,1,6
CGCCCGCTTCCGTACA-1_Br6432_Ant_IF,2,0,0,0,2,4
GGATTCCGCTATACCC-1_Br6432_Ant_IF,1,0,1,0,0,2
CGGTCTATCAACCCGT-1_Br6432_Ant_IF,1,1,2,0,1,5
ATGCCGGTTGATGGGA-1_Br6432_Ant_IF,1,0,0,0,0,1
TCATGCAGGTTCTCAT-1_Br6432_Ant_IF,2,2,1,3,0,8
TGAGCTTTAATGACGC-1_Br6432_Ant_IF,0,0,0,0,0,0
TCCCTTAGATTACTCG-1_Br6432_Ant_IF,3,0,2,0,0,5
ATATCTCCCTCGTTAA-1_Br6432_Ant_IF,3,0,1,0,1,5
AGCTCTTCCCAGTGCA-1_Br6432_Ant_IF,2,0,0,0,0,2
TCGCTAAACCGCTATC-1_Br6432_Ant_IF,1,0,0,0,0,1
CACATTCTTTCGATGG-1_Br6432_Ant_IF,4,1,1,0,3,9
GATATGCGGTAGCCAA-1_Br6432_Ant_IF,1,3,0,0,0,4
CGTTTCACTTCGGGCG-1_Br6432_Ant_IF,2,0,2,0,0,4
CCAATTACGGGTCGAG-1_Br6432_Ant_IF,0,2,0,0,1,3
GCAGGTAGAGTATGGT-1_Br6432_Ant_IF,2,0,0,0,1,3
GTCGTATTGGCGTACA-1_Br6432_Ant_IF,2,0,0,0,2,4
GAAATTAGCACGGATA-1_Br6432_Ant_IF,0,1,1,0,1,3
AATGCACCAAGCAATG-1_Br6432_Ant_IF,1,0,0,0,0,1
AGGACGCTCGATGTTG-1_Br6432_Ant_IF,1,1,0,0,0,2
GGCTAAAGGGCGGGTC-1_Br6432_Ant_IF,2,2,0,0,1,5
CATCTATCCCGTGTCT-1_Br6432_Ant_IF,1,0,1,0,0,2
CAGTAACTATTTATTG-1_Br6432_Ant_IF,1,3,0,1,1,6
CATATACTACTGATAA-1_Br6432_Ant_IF,2,2,0,2,0,6
GCGTTCGGAGACCGGG-1_Br6432_Ant_IF,1,4,0,0,0,5
AAGTTCAGTCTGCGTA-1_Br6432_Ant_IF,1,5,0,1,0,7
CGAAGCTATAAATTCA-1_Br6432_Ant_IF,0,5,0,0,0,5
CGCGGTCACAAACCAA-1_Br6432_Ant_IF,3,0,0,1,0,4
GGGAATGAGCCCTCAC-1_Br6432_Ant_IF,3,4,0,2,1,10
ACGGAGCGCAAATTAC-1_Br6432_Ant_IF,0,1,1,3,0,5
CGTTCTTCGCACACCT-1_Br6432_Ant_IF,0,2,0,0,0,2
GAATAGCCCTGCGGTC-1_Br6432_Ant_IF,1,3,0,0,1,5
AATAGCTACCGCGTGC-1_Br6432_Ant_IF,0,3,0,1,0,4
CCGAGCTGTGCTTGTC-1_Br6432_Ant_IF,1,2,0,2,0,5
GATGACGATGATCGCG-1_Br6432_Ant_IF,1,5,0,0,0,6
GCCTATGCTGGGCCTT-1_Br6432_Ant_IF,0,1,0,0,0,1
TTACTGTCTAGAGCTC-1_Br6432_Ant_IF,1,2,0,1,0,4
AGCGGTTGCCGCTCTG-1_Br6432_Ant_IF,1,0,0,1,0,2
GCTTGCAGCACAATTG-1_Br6432_Ant_IF,0,6,2,0,0,8
CCGGAGGTCTTATGGT-1_Br6432_Ant_IF,2,3,1,0,1,7
ACAGTATACCGTGGGA-1_Br6432_Ant_IF,1,4,1,1,0,7
GGGATCCCAATACAAA-1_Br6432_Ant_IF,1,1,0,1,0,3
ATTACGACTCCACAGT-1_Br6432_Ant_IF,1,4,3,1,0,9
CTCACACGCAAGCCTA-1_Br6432_Ant_IF,0,2,1,0,0,3
CCAGATGTAAATGGGT-1_Br6432_Ant_IF,2,1,1,0,0,4
GAACTTGTGCACGGGA-1_Br6432_Ant_IF,2,1,1,0,1,5
AAGCCGCTTTACCTTG-1_Br6432_Ant_IF,2,3,0,0,0,5
TCCATTCCCACTAGAG-1_Br6432_Ant_IF,3,1,1,0,0,5
AGAGCGCTTGTAACGG-1_Br6432_Ant_IF,0,1,0,0,0,1
GGGATACGGTAATAAT-1_Br6432_Ant_IF,2,0,0,0,0,2
AGTTCACCGGTTGGAC-1_Br6432_Ant_IF,3,1,0,0,2,6
GACATACTGTCGCAGA-1_Br6432_Ant_IF,1,0,0,0,0,1
TGGACACCGTTGCTTG-1_Br6432_Ant_IF,2,4,0,0,1,7
TGCGATGCTAATGGCT-1_Br6432_Ant_IF,2,0,0,0,1,3
TTCTGTTTCCTGTCGC-1_Br6432_Ant_IF,2,2,1,0,0,5
CGTTGTAAACGTCAGG-1_Br6432_Ant_IF,0,0,1,0,0,1
GATCGGCGATAAGTCG-1_Br6432_Ant_IF,3,0,0,0,0,3
AGCCTTAAAGCGGAAG-1_Br6432_Ant_IF,0,2,1,0,0,3
TCCGTAACCACAATCC-1_Br6432_Ant_IF,4,2,0,0,0,6
GAATGCCGAAATGACC-1_Br6432_Ant_IF,0,0,2,0,1,3
TATACTCATGCGGCAA-1_Br6432_Ant_IF,1,0,0,0,0,1
TAGTGTCAGAAACGGC-1_Br6432_Ant_IF,0,0,1,0,1,2
CGTCATACCATATCCA-1_Br6432_Ant_IF,1,1,1,0,0,3
TAGTACCTTAGTGGTC-1_Br6432_Ant_IF,0,0,2,0,2,4
CTGGCGGGAATAAGTA-1_Br6432_Ant_IF,2,1,1,0,0,4
AGTGTGGTCTATTGTG-1_Br6432_Ant_IF,3,0,0,0,1,4
GCTATCGCGGCGCAAC-1_Br6432_Ant_IF,2,1,0,0,1,4
CAGTAATCCCTCCCAG-1_Br6432_Ant_IF,2,0,0,0,1,3
GTATTAAGGCGTCTAA-1_Br6432_Ant_IF,1,1,0,0,1,3
CTAATTTCAACAACAC-1_Br6432_Ant_IF,3,0,0,0,0,3
TTAGCAACATGGATGT-1_Br6432_Ant_IF,4,0,0,0,1,5
ATGCTCAGTGTTGCAT-1_Br6432_Ant_IF,3,1,0,1,0,5
GATGTTTGTGCGAGAT-1_Br6432_Ant_IF,1,1,0,1,0,3
CACTTCGCCACAGGCT-1_Br6432_Ant_IF,1,0,1,0,0,2
CTGTATGGTGTAGAAA-1_Br6432_Ant_IF,2,0,0,0,0,2
TACGTGCACTATGCTG-1_Br6432_Ant_IF,0,0,0,0,1,1
GTATCAGCTTGGGTTC-1_Br6432_Ant_IF,0,0,0,0,0,0
TAACAAAGGGAGAAGC-1_Br6432_Ant_IF,1,0,1,3,0,5
TTACATCGTGGCCTGG-1_Br6432_Ant_IF,0,0,0,0,0,0
TCTGAACCGGTCGGCT-1_Br6432_Ant_IF,0,0,0,0,0,0
GCCTAGCGATCTGACC-1_Br6432_Ant_IF,0,0,0,0,0,0
CCATGCTCTGCAGGAA-1_Br6432_Ant_IF,0,0,0,0,0,0
TATAAATCCACAAGCT-1_Br6432_Ant_IF,1,0,0,2,0,3
CGCTCGACATAATGAT-1_Br6432_Ant_IF,0,0,0,1,0,1
CCAATTGAATGTTAAT-1_Br6432_Ant_IF,0,0,0,0,0,0
GCTAATACCGAATGCC-1_Br6432_Ant_IF,3,0,0,0,0,3
TTCAACGACCCGACCG-1_Br6432_Ant_IF,3,0,2,0,0,5
TTCCTCGAGGGTGTCT-1_Br6432_Ant_IF,2,1,0,0,0,3
CAACGACCCGTTTACA-1_Br6432_Ant_IF,2,0,0,0,0,2
CTTGTACTTGTTGACT-1_Br6432_Ant_IF,3,1,0,0,0,4
TCTCTAATAGCTGGTA-1_Br6432_Ant_IF,3,0,0,0,0,3
ATTATGCCATAGGGAG-1_Br6432_Ant_IF,4,1,0,2,0,7
GACAACGCAGCTTACG-1_Br6432_Ant_IF,3,0,0,0,0,3
AGATGACTCGCCCACG-1_Br6432_Ant_IF,3,0,0,0,1,4
GTGCGGGTCTCCAAAT-1_Br6432_Ant_IF,1,1,0,0,4,6
GTACGAGATTGCGACA-1_Br6432_Ant_IF,2,0,0,0,0,2
GTATAGGACTCAGTAG-1_Br6432_Ant_IF,3,0,0,0,0,3
TTGCACGGAGCAGCAC-1_Br6432_Ant_IF,2,0,0,0,1,3
CACAGCTAGGGAGTGA-1_Br6432_Ant_IF,0,0,0,0,3,3
ATACTAGCATGACCCT-1_Br6432_Ant_IF,1,0,0,0,1,2
CCAAGACTTCTGCGAA-1_Br6432_Ant_IF,2,0,0,0,0,2
ACATAATAAGGCGGTG-1_Br6432_Ant_IF,4,0,0,0,2,6
TAATACACAGTAGTAT-1_Br6432_Ant_IF,0,0,1,0,0,1
TCTTGGTAACACCAAA-1_Br6432_Ant_IF,1,0,0,0,0,1
AACTGGGTCCCGACGT-1_Br6432_Ant_IF,0,0,0,0,0,0
ATCACTTCATCCTCGC-1_Br6432_Ant_IF,2,0,0,0,0,2
TGGAAGGATAAAGATG-1_Br6432_Ant_IF,1,0,0,0,0,1
CATGATGCACAATTCT-1_Br6432_Ant_IF,3,0,1,0,1,5
TGCCTGATCAAACGAT-1_Br6432_Ant_IF,1,0,0,0,0,1
ATAGGGATATCCTTGA-1_Br6432_Ant_IF,1,0,1,0,1,3
CACCTAATCAGTTTAC-1_Br6432_Ant_IF,4,0,1,0,2,7
TGTGACTACGCCAGTC-1_Br6432_Ant_IF,1,0,2,0,0,3
CCCGACCATAGTCCGC-1_Br6432_Ant_IF,2,0,0,0,0,2
CGCGCCCGACTTAATA-1_Br6432_Ant_IF,2,0,1,0,0,3
TGCCACCTGGCGAAAC-1_Br6432_Ant_IF,1,1,2,0,1,5
CTGCCAAGGTTGGAAG-1_Br6432_Ant_IF,4,1,3,0,0,8
TCTCCAACGTAGGTTA-1_Br6432_Ant_IF,4,1,1,0,1,7
TTCTTGGAGTAATGAG-1_Br6432_Ant_IF,0,1,1,0,1,3
GTCTCGATCTGCTTTC-1_Br6432_Ant_IF,1,0,0,0,0,1
TACTCTCCGAACAAAT-1_Br6432_Ant_IF,0,2,1,0,1,4
ATCACATTAGAATATC-1_Br6432_Ant_IF,1,0,1,0,1,3
TACGGGATGCTAGCAG-1_Br6432_Ant_IF,1,2,3,4,2,12
AGCTGAAGTAAACCAA-1_Br6432_Ant_IF,2,0,0,0,3,5
CATGGGTCGGGTGTGG-1_Br6432_Ant_IF,2,2,2,0,1,7
CACCCACGAGGCAATT-1_Br6432_Ant_IF,2,0,2,0,0,4
TGCCATTACTAAAGAA-1_Br6432_Ant_IF,1,0,2,0,0,3
CCGTTACGTTAGAACA-1_Br6432_Ant_IF,0,0,1,0,1,2
GCCAGGAGTAACCGAT-1_Br6432_Ant_IF,2,0,0,0,3,5
GGAAAGTGCCCATGCC-1_Br6432_Ant_IF,3,0,0,0,0,3
TCTTACCGGAACTCGT-1_Br6432_Ant_IF,2,0,0,0,0,2
TATGTCAAGACCGACT-1_Br6432_Ant_IF,1,1,0,0,0,2
CCTAACTAAGGCTCTA-1_Br6432_Ant_IF,0,0,0,0,1,1
GCGGTGAACTGCGCTC-1_Br6432_Ant_IF,4,3,0,0,0,7
CCTCGCGCGATATAGG-1_Br6432_Ant_IF,0,1,0,0,0,1
ATCGGCAAGCAGTCCA-1_Br6432_Ant_IF,2,0,0,0,0,2
AGATCGTGCATAAGAT-1_Br6432_Ant_IF,0,2,0,0,2,4
ATTCAGGACCTATTTC-1_Br6432_Ant_IF,3,0,0,0,0,3
AGCTAGAAGCAGAAGT-1_Br6432_Ant_IF,0,0,0,1,0,1
TTCGCTATCTGACGTG-1_Br6432_Ant_IF,1,1,2,0,4,8
TTCCGCAGAGAAATAT-1_Br6432_Ant_IF,5,0,1,0,1,7
CAGTACATTCTCTAAA-1_Br6432_Ant_IF,2,0,0,0,1,3
GTGAAGATTTCAAGTG-1_Br6432_Ant_IF,0,4,1,0,0,5
AACGCATGATCTGGGT-1_Br6432_Ant_IF,5,1,0,0,0,6
CCCAGAGGAGGGCGTA-1_Br6432_Ant_IF,3,1,0,1,0,5
GGAAACCTTGTTGAAT-1_Br6432_Ant_IF,1,1,0,0,1,3
GTGAAGCCGTATAGTC-1_Br6432_Ant_IF,3,3,0,0,1,7
GAGCTGTCGTCTCGGA-1_Br6432_Ant_IF,3,1,0,1,0,5
TGTCATTTGTTGGGAA-1_Br6432_Ant_IF,2,1,0,0,0,3
ACCAACACCACACACT-1_Br6432_Ant_IF,1,2,0,0,0,3
AAATGATTCGATCAGC-1_Br6432_Ant_IF,0,5,0,2,0,7
CTGCTTTATGTCCGCG-1_Br6432_Ant_IF,0,4,0,0,0,4
GCGAGAGGCCATGTAA-1_Br6432_Ant_IF,0,3,0,2,0,5
ATTGACCGGCGATGAC-1_Br6432_Ant_IF,0,6,0,0,0,6
ACCCTGGTAACGCCCT-1_Br6432_Ant_IF,0,3,2,0,0,5
GTTGGACCGCATCAGG-1_Br6432_Ant_IF,1,1,1,0,0,3
CGTTTACAAGGCAGCT-1_Br6432_Ant_IF,0,2,3,0,0,5
CGGTCCATGAGACTCC-1_Br6432_Ant_IF,0,3,0,2,0,5
GTTCGTCTGGGTCCCT-1_Br6432_Ant_IF,1,2,0,0,0,3
TGTACTACTCTCACGG-1_Br6432_Ant_IF,2,2,2,0,0,6
AGTGAAGATGGTGTCC-1_Br6432_Ant_IF,2,0,1,0,0,3
GAGGGCCATAATATTA-1_Br6432_Ant_IF,0,3,0,1,0,4
ACTCCCGTAGACTAGG-1_Br6432_Ant_IF,1,0,1,0,0,2
CGTCAAATGGTCGCAG-1_Br6432_Ant_IF,1,0,0,1,0,2
AAGTCTAGTAGCTGCC-1_Br6432_Ant_IF,0,2,2,0,0,4
AAGAAATCACCAGATT-1_Br6432_Ant_IF,3,1,0,0,0,4
GAGTGCACGGACAACA-1_Br6432_Ant_IF,2,3,1,0,1,7
TATATGCTGGGTTGCC-1_Br6432_Ant_IF,2,0,1,0,2,5
GTTTATGGGATTTAGA-1_Br6432_Ant_IF,1,1,0,0,0,2
GGAACCCGAACAAGAA-1_Br6432_Ant_IF,0,1,0,0,1,2
AACGTTATCAGCACCT-1_Br6432_Ant_IF,1,0,0,0,1,2
CATCGTCCGGTTACTA-1_Br6432_Ant_IF,1,0,0,0,2,3
AGACAGCTCAGAATCC-1_Br6432_Ant_IF,2,0,0,0,2,4
GCAGATCCTCGCAAAT-1_Br6432_Ant_IF,0,3,1,0,2,6
GGGTCATGCGTACCAT-1_Br6432_Ant_IF,2,1,1,0,1,5
CTGGTCATTCCAATCC-1_Br6432_Ant_IF,3,1,0,0,0,4
TCAGGGCGCAAACTCG-1_Br6432_Ant_IF,4,1,0,0,2,7
GATGCCAGCAGAAGGC-1_Br6432_Ant_IF,1,1,0,0,1,3
GTTATTAACGTGGGAG-1_Br6432_Ant_IF,1,0,0,0,0,1
AATACAATGTTTCAGG-1_Br6432_Ant_IF,1,1,0,0,2,4
TTGCTGCACCTATCCA-1_Br6432_Ant_IF,1,1,0,0,0,2
CCAGAGACAAAGCCGG-1_Br6432_Ant_IF,3,0,0,0,1,4
CCGAAGTATATTGTTC-1_Br6432_Ant_IF,2,0,0,0,1,3
GCTAAACCTGAGGTGA-1_Br6432_Ant_IF,1,0,0,0,1,2
TCATACTTACAGATCC-1_Br6432_Ant_IF,2,0,1,0,3,6
CGAGCACTTCAAGTTT-1_Br6432_Ant_IF,0,0,2,0,1,3
TAGCAACCTGTCACAA-1_Br6432_Ant_IF,0,0,0,0,0,0
TGGGAAATGCCTTTCC-1_Br6432_Ant_IF,1,0,0,0,2,3
AGACCATGGGATACAA-1_Br6432_Ant_IF,5,1,0,0,0,6
TAAATGAATCCGTTTC-1_Br6432_Ant_IF,4,0,0,0,0,4
ACAACGGTCCCTGCGA-1_Br6432_Ant_IF,2,0,0,0,0,2
GTCACTCTCCAAATCT-1_Br6432_Ant_IF,2,0,1,0,1,4
TTCTACTTGCGAGGGC-1_Br6432_Ant_IF,2,0,1,0,0,3
CGCAATTACTTTCGGT-1_Br6432_Ant_IF,3,1,0,0,0,4
CTGTTCATCTCACGGG-1_Br6432_Ant_IF,3,1,1,0,0,5
TTCTTGTAACCTAATG-1_Br6432_Ant_IF,2,1,0,0,0,3
GCTTGATGATAATCAG-1_Br6432_Ant_IF,0,0,0,4,0,4
TTGGCTCGCATGAGAC-1_Br6432_Ant_IF,7,0,0,3,0,10
GCCCAGTTGGTATGCC-1_Br6432_Ant_IF,0,0,0,0,0,0
ATTCCTCCGCCAGTGC-1_Br6432_Ant_IF,0,0,0,2,0,2
TTCTAGGCCAATTGTG-1_Br6432_Ant_IF,0,0,0,0,0,0
TCACGGTCATCGCACA-1_Br6432_Ant_IF,0,0,0,0,0,0
ATGAAGCCAAGGAGCC-1_Br6432_Ant_IF,0,0,0,3,0,3
AATGACTGTCAGCCGG-1_Br6432_Ant_IF,0,0,1,2,0,3
CCAAACAGAACCCTCG-1_Br6432_Ant_IF,2,0,0,1,0,3
TATCGATGATTAAACG-1_Br6432_Ant_IF,3,0,0,1,0,4
GAACACACATCAACCA-1_Br6432_Ant_IF,3,1,0,0,0,4
CCCGTCAGCGTCTGAC-1_Br6432_Ant_IF,1,0,0,0,0,1
AGCATCGTCGATAATT-1_Br6432_Ant_IF,0,0,0,0,0,0
GACTAAGATCATGCAC-1_Br6432_Ant_IF,1,0,1,0,0,2
TAGGGTGTTTCAAGAG-1_Br6432_Ant_IF,0,1,1,0,0,2
TGGTTCGTAGCAAAGG-1_Br6432_Ant_IF,2,0,0,0,0,2
CTGTTCACTGCCTGTG-1_Br6432_Ant_IF,1,0,0,0,0,1
ATGTGCATCCGACGCA-1_Br6432_Ant_IF,3,1,0,0,1,5
TTGTCGTTCAGTTACC-1_Br6432_Ant_IF,2,0,0,0,0,2
CGGGATCAATGTAAGA-1_Br6432_Ant_IF,4,0,0,0,1,5
TTATCTGTATCATAAC-1_Br6432_Ant_IF,3,0,0,0,0,3
ATCGACTCTTTCCGTT-1_Br6432_Ant_IF,1,1,0,0,1,3
CTCATTTGATGGGCGG-1_Br6432_Ant_IF,1,0,0,0,0,1
GTAAGCGGGCAGTCAG-1_Br6432_Ant_IF,4,0,0,0,1,5
TCTATCGGTCGCAACA-1_Br6432_Ant_IF,5,0,0,0,1,6
AACGCGGTCTCCAGCC-1_Br6432_Ant_IF,6,1,1,0,0,8
ATTAATACTACGCGGG-1_Br6432_Ant_IF,1,1,0,0,1,3
CTTTAACTTTCAAAGG-1_Br6432_Ant_IF,0,0,0,0,0,0
CGTACCTGATAGGCCT-1_Br6432_Ant_IF,4,0,0,0,1,5
GAATGTTGGGTAATCT-1_Br6432_Ant_IF,0,0,0,0,1,1
TGCGGAGTAAAGGTGC-1_Br6432_Ant_IF,4,0,3,0,0,7
CCTGAATATTTACATA-1_Br6432_Ant_IF,2,0,0,0,0,2
TTGCTCCCATACCGGA-1_Br6432_Ant_IF,1,1,0,0,0,2
CCTCTAATCTGCCAAG-1_Br6432_Ant_IF,0,1,3,0,2,6
AGGTTGAGGCACGCTT-1_Br6432_Ant_IF,2,0,0,0,1,3
TCCCGTCAGTCCCGCA-1_Br6432_Ant_IF,0,0,1,0,1,2
TCCGATGACTGAGCTC-1_Br6432_Ant_IF,3,0,0,0,1,4
CAGCCTCCTGCAGAGG-1_Br6432_Ant_IF,2,0,0,0,0,2
CTTAGCCTTCCACATG-1_Br6432_Ant_IF,6,0,0,0,2,8
ATTAATGAACCAGTCG-1_Br6432_Ant_IF,2,0,0,0,1,3
ACGATACATAGAACTA-1_Br6432_Ant_IF,3,0,0,0,0,3
AGCCACTCCCGTGCTT-1_Br6432_Ant_IF,3,0,1,0,0,4
ATACGGGTTTCGATTG-1_Br6432_Ant_IF,0,0,0,0,1,1
CTGTCAAATGGCTCGG-1_Br6432_Ant_IF,2,0,1,0,1,4
GCTCGGAATTTAAAGC-1_Br6432_Ant_IF,2,0,0,0,0,2
TAGGCATGTTACGCCA-1_Br6432_Ant_IF,3,2,2,0,0,7
TGGCAACTCGCGCGCC-1_Br6432_Ant_IF,1,0,0,0,2,3
ATCAGTAGGCAGGGAT-1_Br6432_Ant_IF,1,0,0,0,0,1
TATCGATCTATGCATA-1_Br6432_Ant_IF,1,0,2,0,4,7
CGACTCAGGATGTTAT-1_Br6432_Ant_IF,2,2,1,0,1,6
GCCATATTGCACACAG-1_Br6432_Ant_IF,2,1,0,0,0,3
AATTCATAAGGGATCT-1_Br6432_Ant_IF,0,0,0,0,0,0
CGGTAGAGGTGCAGGT-1_Br6432_Ant_IF,0,0,0,0,1,1
AATGATGATACGCTAT-1_Br6432_Ant_IF,3,1,0,0,1,5
CTTGTGCTCACCGATT-1_Br6432_Ant_IF,2,0,0,0,1,3
TTCCAATCAGAGCTAG-1_Br6432_Ant_IF,0,3,0,0,0,3
CGATGGACCCTACGCC-1_Br6432_Ant_IF,0,2,0,0,3,5
GGTCGGATAAACGGCG-1_Br6432_Ant_IF,3,0,0,0,1,4
TTAGCTAATACGATCT-1_Br6432_Ant_IF,1,1,0,1,0,3
CTCGATATTTGCGAGC-1_Br6432_Ant_IF,2,0,0,2,0,4
ATTACTTACTGGGCAT-1_Br6432_Ant_IF,0,0,0,0,0,0
CTAGCCGATGTTATGA-1_Br6432_Ant_IF,1,1,0,0,0,2
TACTGCAATCAATTAC-1_Br6432_Ant_IF,1,0,1,0,1,3
TAGTCTGTGACGTTGC-1_Br6432_Ant_IF,2,0,0,0,2,4
CTCGTTTCTAATGTTT-1_Br6432_Ant_IF,0,0,0,0,0,0
TTCGTTCAACGAAGTT-1_Br6432_Ant_IF,2,1,0,1,1,5
CTGAATTTATTGCCAG-1_Br6432_Ant_IF,2,2,0,1,0,5
TGGAATATCCTTGACC-1_Br6432_Ant_IF,1,1,0,0,0,2
CAGATCATTTAAAGTC-1_Br6432_Ant_IF,1,2,0,1,0,4
CTCCTTTACGCAAGTC-1_Br6432_Ant_IF,0,0,0,1,0,1
TCCCAAACAGACAACG-1_Br6432_Ant_IF,1,1,1,2,1,6
ATCGCTGCGTGCAGCA-1_Br6432_Ant_IF,2,2,0,0,1,5
TTAGTTCAAGTGTTCG-1_Br6432_Ant_IF,1,3,0,0,0,4
AAACTCGTGATATAAG-1_Br6432_Ant_IF,3,3,0,0,0,6
TTAACGAACAAGCAGT-1_Br6432_Ant_IF,1,4,0,1,0,6
GTTATATCAGGAGCCA-1_Br6432_Ant_IF,1,2,0,0,0,3
CAAATTGGATTATGCC-1_Br6432_Ant_IF,1,2,5,0,0,8
CGAGGAGCTTCCATAT-1_Br6432_Ant_IF,2,1,0,0,0,3
GGAGACCAATGTGCTT-1_Br6432_Ant_IF,0,5,1,0,0,6
CATTGATGAACACGCC-1_Br6432_Ant_IF,0,4,0,0,0,4
GTCAATGCTATAATTT-1_Br6432_Ant_IF,0,3,0,0,0,3
ACCACCCTCTCTTCTA-1_Br6432_Ant_IF,2,1,2,1,0,6
TGGAGGGAAACACCTC-1_Br6432_Ant_IF,0,6,1,0,0,7
CACGGACGTGGATGGC-1_Br6432_Ant_IF,2,3,1,0,0,6
AACTTTCTCGATCATG-1_Br6432_Ant_IF,1,1,1,1,0,4
CGTATTGTTTCCTAAT-1_Br6432_Ant_IF,1,1,0,1,0,3
CCTACTGCGGCGGCCA-1_Br6432_Ant_IF,3,1,1,0,0,5
CTTAGGTCCCAATCGT-1_Br6432_Ant_IF,2,3,1,0,0,6
CTCTCGCTGTACTATG-1_Br6432_Ant_IF,0,0,0,0,0,0
AATAGTCGCGAGTCGG-1_Br6432_Ant_IF,0,0,0,0,0,0
AGTTACCCTTAAGACT-1_Br6432_Ant_IF,0,0,1,0,2,3
CTTAAATAAGACCCAT-1_Br6432_Ant_IF,4,2,0,0,1,7
GGTTGTGCTCTTGTCC-1_Br6432_Ant_IF,0,0,0,0,2,2
GTGAGTCTAAGACGGA-1_Br6432_Ant_IF,2,2,0,0,2,6
CGCGACACTGCGCAGC-1_Br6432_Ant_IF,6,4,0,0,0,10
GCTCGCGGTTCCGCTC-1_Br6432_Ant_IF,1,0,0,0,2,3
TTAACTCACGCGTGGA-1_Br6432_Ant_IF,0,0,1,0,0,1
GGAACGGCCTGCAGCC-1_Br6432_Ant_IF,0,1,2,0,3,6
GTAGAAACGGGTGGAG-1_Br6432_Ant_IF,5,1,2,0,2,10
TAATGAAAGACCCTTG-1_Br6432_Ant_IF,0,1,0,0,1,2
AGGCTTGCTAGACACC-1_Br6432_Ant_IF,1,1,1,0,1,4
TTGCGTAGTTTGAGGA-1_Br6432_Ant_IF,1,0,1,0,0,2
CGCCCTTGAAGGCTGA-1_Br6432_Ant_IF,1,0,0,0,0,1
CCCGGTGGAAGAACCT-1_Br6432_Ant_IF,0,0,0,0,1,1
TTAACACCTCGAACAT-1_Br6432_Ant_IF,1,2,0,0,1,4
GATTCCTATACGGCGC-1_Br6432_Ant_IF,1,1,0,0,3,5
TTACCCTAACAGTCCT-1_Br6432_Ant_IF,2,0,2,0,1,5
ACCCACCTACATGCTC-1_Br6432_Ant_IF,2,0,0,0,0,2
AAAGGGCAGCTTGAAT-1_Br6432_Ant_IF,2,0,0,0,2,4
CACACAGGGATAGATT-1_Br6432_Ant_IF,1,0,0,0,1,2
AGAGCGTACAAGCTCG-1_Br6432_Ant_IF,3,0,0,0,0,3
TCTTACGGCATCCGAC-1_Br6432_Ant_IF,3,0,0,0,0,3
GCCTATTCCGATATAG-1_Br6432_Ant_IF,1,0,2,0,0,3
GAAAGTGACTAACTGC-1_Br6432_Ant_IF,3,2,0,0,0,5
CCGGAATGGTTTCAGT-1_Br6432_Ant_IF,1,2,0,0,1,4
AGTATAATACTAGGCA-1_Br6432_Ant_IF,3,1,0,0,0,4
TAACTATCGAAGGTCC-1_Br6432_Ant_IF,1,0,1,0,0,2
ATGAGGAGTGTTAATC-1_Br6432_Ant_IF,2,0,0,0,0,2
TGTGTCGCGAGTTGCA-1_Br6432_Ant_IF,2,0,0,0,0,2
ATCCAACGCAGTCATA-1_Br6432_Ant_IF,1,0,0,0,0,1
AAGGCGCGTAAAGCTT-1_Br6432_Ant_IF,0,0,0,2,0,2
AGTCGGCCCAAACGAC-1_Br6432_Ant_IF,4,0,0,1,0,5
AACGTCAGACTAGTGG-1_Br6432_Ant_IF,2,0,0,3,0,5
ACTACCAGCTCTCTGG-1_Br6432_Ant_IF,0,0,1,3,0,4
GCAAGTGCACAGAGAA-1_Br6432_Ant_IF,1,1,0,0,0,2
ACACCTTAAGTAGGGC-1_Br6432_Ant_IF,2,0,0,0,0,2
TTCGACGGGAAGGGCG-1_Br6432_Ant_IF,0,0,0,0,0,0
TTCGCACTCGCGTGCT-1_Br6432_Ant_IF,0,0,0,0,0,0
TATTTGTTACCCTTTA-1_Br6432_Ant_IF,0,0,0,0,0,0
CGCTGTGACGCCGCAC-1_Br6432_Ant_IF,0,0,0,0,0,0
GTTGCACGGAGTTTCG-1_Br6432_Ant_IF,0,0,0,1,0,1
GTTTCCTGGAGGGTGA-1_Br6432_Ant_IF,0,0,0,1,0,1
ACACCCAGCATGCAGC-1_Br6432_Ant_IF,3,1,0,0,0,4
TCAACCATGTTCGGGC-1_Br6432_Ant_IF,1,0,0,1,0,2
TTACAACTACGCATCC-1_Br6432_Ant_IF,0,0,1,0,0,1
TCCGATGGTGCGACAT-1_Br6432_Ant_IF,1,0,0,0,0,1
GGGCGTACATTTATAT-1_Br6432_Ant_IF,1,0,0,1,0,2
AGCGACCAACGATATT-1_Br6432_Ant_IF,1,0,1,1,0,3
ACACAAAGACGGGTGG-1_Br6432_Ant_IF,4,0,0,1,0,5
ATCGCACGCCGGGAGA-1_Br6432_Ant_IF,2,0,0,0,0,2
GCTCTAAACCCTGACG-1_Br6432_Ant_IF,0,0,0,0,0,0
AATGCAACCGGGTACC-1_Br6432_Ant_IF,3,0,1,0,2,6
TCAAACAACCGCGTCG-1_Br6432_Ant_IF,4,0,0,1,0,5
TATGCTCCCTACTTAC-1_Br6432_Ant_IF,1,0,0,0,4,5
AAAGGGATGTAGCAAG-1_Br6432_Ant_IF,2,3,0,0,1,6
ACGATCATACATAGAG-1_Br6432_Ant_IF,1,1,0,0,0,2
TTGTTCAGTGTGCTAC-1_Br6432_Ant_IF,1,0,0,0,1,2
ATGCATGATCCAGGAT-1_Br6432_Ant_IF,2,0,0,0,0,2
AGTCTTCTCCTCAAAT-1_Br6432_Ant_IF,1,0,1,0,1,3
GATTCCCTTGTCGCAG-1_Br6432_Ant_IF,2,0,0,1,0,3
CTCGCACCTATATAGT-1_Br6432_Ant_IF,2,0,1,0,0,3
ACTCAATAAAGGCACG-1_Br6432_Ant_IF,1,0,3,0,1,5
AACCGAGCTTGGTCAT-1_Br6432_Ant_IF,3,0,0,0,2,5
TAAGGCAACATAAGAT-1_Br6432_Ant_IF,1,1,0,0,0,2
CACGCACAGCGCAGCT-1_Br6432_Ant_IF,2,1,0,0,1,4
GGTTTACAATCTCAAT-1_Br6432_Ant_IF,0,0,0,0,1,1
TGCAGGATCGGCAAAG-1_Br6432_Ant_IF,5,0,1,0,0,6
ATAACGGAGTCCAACG-1_Br6432_Ant_IF,1,0,0,0,2,3
AACGATATGTCAACTG-1_Br6432_Ant_IF,1,0,0,0,1,2
GACAACGACCATTGAA-1_Br6432_Ant_IF,3,0,0,0,0,3
TTGACCATGTTCTCCG-1_Br6432_Ant_IF,2,0,0,0,1,3
AGTACGGGCACCTGGC-1_Br6432_Ant_IF,3,2,1,0,0,6
CGCCATCCGATTATGA-1_Br6432_Ant_IF,1,1,0,0,0,2
AAGGTATCCTAATATA-1_Br6432_Ant_IF,2,0,0,0,0,2
TGTTGTCAAGAAGTCT-1_Br6432_Ant_IF,4,1,3,0,0,8
CAGTGAATAAATGACT-1_Br6432_Ant_IF,5,1,2,0,1,9
CACCTTGCGAAACTCG-1_Br6432_Ant_IF,3,0,2,0,1,6
CATTTAGCGGACCATG-1_Br6432_Ant_IF,1,0,0,0,1,2
CCAGTCTAGACGGCGC-1_Br6432_Ant_IF,2,2,0,0,0,4
TCGCTTTAAACGTTTG-1_Br6432_Ant_IF,2,1,3,0,2,8
GTGAAACGGCGCCACC-1_Br6432_Ant_IF,1,0,0,0,1,2
GGGCTCATCGAACCCA-1_Br6432_Ant_IF,1,0,0,0,2,3
TTGATGTGTAGTCCCG-1_Br6432_Ant_IF,0,0,0,1,0,1
CAGTAGCCCACGCGGT-1_Br6432_Ant_IF,1,2,0,0,1,4
AGCGCGGGTGCCAATG-1_Br6432_Ant_IF,1,1,1,0,0,3
TAATCGATCCGTACGT-1_Br6432_Ant_IF,4,0,0,0,0,4
AGTGGCGGCAATTTGA-1_Br6432_Ant_IF,3,1,0,0,1,5
CCTTTCAATGAAGAAA-1_Br6432_Ant_IF,2,1,0,1,0,4
CTCAGTCACGACAAAT-1_Br6432_Ant_IF,0,0,0,0,0,0
ATAGGCTAGCTTCGCA-1_Br6432_Ant_IF,1,2,0,0,0,3
CGGTTCAAGTAGGTGT-1_Br6432_Ant_IF,1,0,0,0,1,2
CAGTCGAGGATGCAAT-1_Br6432_Ant_IF,3,2,0,0,0,5
TATCACCCAACCGACC-1_Br6432_Ant_IF,4,0,2,0,1,7
AATGATGCGACTCCTG-1_Br6432_Ant_IF,2,0,0,0,0,2
TGGAACCACTGACACA-1_Br6432_Ant_IF,2,0,0,1,3,6
GCCAATAGGGCATCTC-1_Br6432_Ant_IF,0,0,1,0,0,1
TTCTTTGGTCGCGACG-1_Br6432_Ant_IF,1,1,0,0,0,2
ATTAGATTCCTCAGCA-1_Br6432_Ant_IF,2,1,0,0,1,4
CCGTGGAACGATCCAA-1_Br6432_Ant_IF,2,0,0,1,0,3
GGGTCGTGGCAAGTGT-1_Br6432_Ant_IF,3,0,1,0,0,4
TCGCTCGGCACCAGCG-1_Br6432_Ant_IF,2,2,0,2,0,6
ACGCAATCACTACAGC-1_Br6432_Ant_IF,3,0,0,2,1,6
CTCTAATGCATTGATC-1_Br6432_Ant_IF,3,2,0,2,1,8
GTCTCGACTAAGTTTG-1_Br6432_Ant_IF,2,3,0,0,0,5
TGGTTTAAACGTGGGT-1_Br6432_Ant_IF,1,2,0,0,0,3
CGCAGATCTTCACCCG-1_Br6432_Ant_IF,1,3,0,1,0,5
TCCAGATGTACGCCAA-1_Br6432_Ant_IF,0,2,0,0,8,10
CATTGCGGGTCAATTC-1_Br6432_Ant_IF,0,2,0,2,2,6
GACGTTCGTAAATACA-1_Br6432_Ant_IF,0,6,0,0,0,6
TACACCGTCGTTAGTC-1_Br6432_Ant_IF,0,5,0,2,0,7
ACGGGCGTATGCGACA-1_Br6432_Ant_IF,0,6,0,1,0,7
GAAGGCTACCATTGTT-1_Br6432_Ant_IF,0,5,0,3,0,8
TAAATCTTTACACCTC-1_Br6432_Ant_IF,1,3,0,2,0,6
AGTTTATGTAAAGACA-1_Br6432_Ant_IF,0,3,0,1,0,4
AGGAGACATCCACAGT-1_Br6432_Ant_IF,1,3,0,0,2,6
CAACCTGAACCTGCCA-1_Br6432_Ant_IF,0,1,0,1,0,2
AGTCCCTCGCAGAAAG-1_Br6432_Ant_IF,2,2,3,0,0,7
TGTATACGGATGATGA-1_Br6432_Ant_IF,1,5,1,0,0,7
TTGTGGTATAGGTATG-1_Br6432_Ant_IF,0,1,1,0,0,2
TCTGCACCATTAGTAA-1_Br6432_Ant_IF,3,0,0,0,0,3
GGACTAAGTCAGGAGT-1_Br6432_Ant_IF,0,0,0,0,0,0
TATCAAAGGTCTGTAA-1_Br6432_Ant_IF,0,0,0,0,0,0
TTCAGTTTGTGGCAGC-1_Br6432_Ant_IF,2,0,0,0,0,2
TGTTCATAAATGTGCT-1_Br6432_Ant_IF,1,1,0,0,3,5
CTTAGCCCGGATAGTG-1_Br6432_Ant_IF,4,1,0,0,1,6
GATGCGAATGGTATTA-1_Br6432_Ant_IF,3,0,2,0,0,5
TCTAACTGTATGTAAA-1_Br6432_Ant_IF,4,1,0,0,1,6
TTAAACCTGGTTCCTT-1_Br6432_Ant_IF,5,1,0,0,0,6
GCTAAGTAAAGGCGAT-1_Br6432_Ant_IF,1,0,2,0,2,5
AGTTACCGCACATGGT-1_Br6432_Ant_IF,2,0,1,0,0,3
GACTGCGGCACGTGTA-1_Br6432_Ant_IF,1,0,1,0,1,3
TGGTGATCGTATTTGT-1_Br6432_Ant_IF,2,3,2,0,1,8
TTATCGCCTGCGAAGC-1_Br6432_Ant_IF,1,0,0,0,1,2
TGGAATTAGACGCTTT-1_Br6432_Ant_IF,1,0,1,0,1,3
TCGTCACACTGTTAGC-1_Br6432_Ant_IF,0,0,0,0,0,0
TTATGTTTGCGATAGA-1_Br6432_Ant_IF,0,0,0,0,0,0
GGTGCTGATCACAAAG-1_Br6432_Ant_IF,0,0,2,0,0,2
CATAGCCGCCCGGGAT-1_Br6432_Ant_IF,1,0,0,0,0,1
GGTTAGTTACGGCGCC-1_Br6432_Ant_IF,2,0,1,0,0,3
ATTCCCACATAAACAA-1_Br6432_Ant_IF,0,3,1,0,0,4
ATTCAGTAGCAGGGTC-1_Br6432_Ant_IF,1,0,0,0,1,2
CAGTTCCGCGGGTCGA-1_Br6432_Ant_IF,1,0,1,0,0,2
AAGAGATGAATCGGTA-1_Br6432_Ant_IF,3,1,3,0,1,8
CGCAATTCTACAATAA-1_Br6432_Ant_IF,4,0,0,0,2,6
TAACGCTTTGAGAGCG-1_Br6432_Ant_IF,2,0,0,0,1,3
AGGCTATGGTTAGCTT-1_Br6432_Ant_IF,2,0,0,0,1,3
GAGGAATGGAGAGGTT-1_Br6432_Ant_IF,5,0,1,0,0,6
TCCTCTACGAGATGGC-1_Br6432_Ant_IF,3,0,2,0,0,5
TTGATTATGCAGATGA-1_Br6432_Ant_IF,2,0,1,0,0,3
TCAGTACTGACCCGCG-1_Br6432_Ant_IF,0,1,0,1,0,2
TTATGACAAACTGGAT-1_Br6432_Ant_IF,4,0,0,0,0,4
GTAAGTAGGGTATACC-1_Br6432_Ant_IF,3,0,0,2,0,5
CGCAAACACGAGTTAC-1_Br6432_Ant_IF,2,2,0,0,0,4
TGGCCGTATATTGACC-1_Br6432_Ant_IF,5,2,2,0,1,10
ACTGTAGCACTTTGGA-1_Br6432_Ant_IF,5,2,0,0,0,7
GCTCTATGTTACGTGC-1_Br6432_Ant_IF,2,3,0,0,0,5
TGCGCGATTAACGGAG-1_Br6432_Ant_IF,3,1,1,0,0,5
GAATCGACATGGTCAC-1_Br6432_Ant_IF,1,0,0,4,0,5
GACTAAGTAGGCTCAC-1_Br6432_Ant_IF,3,0,0,0,0,3
ATCTTGACCTGCAACG-1_Br6432_Ant_IF,0,0,0,0,0,0
ATGCACTACCGCATTG-1_Br6432_Ant_IF,1,0,0,0,0,1
CAGATACTAACATAGT-1_Br6432_Ant_IF,0,12,0,0,0,12
GATCGACACTATCTGA-1_Br6432_Ant_IF,2,5,0,0,0,7
ATAGAGTACTGGGACA-1_Br6432_Ant_IF,1,2,0,0,0,3
CCTACTGCTTACACTT-1_Br6432_Ant_IF,0,0,0,0,0,0
CCTGCTATTTGAGAAG-1_Br6432_Ant_IF,1,3,0,3,0,7
CGCGTTCATGAAATAC-1_Br6432_Ant_IF,0,0,0,1,0,1
CATTATGCTTGTTGTG-1_Br6432_Ant_IF,1,0,0,0,0,1
CCAGGGACGTGGCCTC-1_Br6432_Ant_IF,2,0,0,0,0,2
TATGGATGTGCTACGC-1_Br6432_Ant_IF,1,0,0,0,0,1
GTACTAAGATTTGGAG-1_Br6432_Ant_IF,0,0,0,1,0,1
AGACCCGCCCTCCTCG-1_Br6432_Ant_IF,6,0,1,0,2,9
CGCATTAGCTAATAGG-1_Br6432_Ant_IF,0,0,0,0,1,1
GCTCTCGGGTACCGAA-1_Br6432_Ant_IF,1,0,0,0,0,1
CACCGCCAGAAGGTTT-1_Br6432_Ant_IF,5,0,0,0,0,5
TCCCAAAGACGAAGGA-1_Br6432_Ant_IF,3,0,0,1,2,6
ATGGATTGACCAAACG-1_Br6432_Ant_IF,2,0,0,0,1,3
GTCATGGACATGACTA-1_Br6432_Ant_IF,1,0,0,0,1,2
CTACTGCCACCTGACC-1_Br6432_Ant_IF,1,1,0,0,2,4
TTATATTTGGCAATCC-1_Br6432_Ant_IF,3,0,0,0,0,3
AGCACCAGTACTCACG-1_Br6432_Ant_IF,1,0,1,0,0,2
CATGGTCTAGATACCG-1_Br6432_Ant_IF,1,0,0,0,0,1
TCTACCGTCCACAAGC-1_Br6432_Ant_IF,4,0,0,0,1,5
CTAGTTGGGCCCGGTA-1_Br6432_Ant_IF,0,0,0,0,0,0
TCCCGCGTACTCCTGG-1_Br6432_Ant_IF,4,0,0,0,1,5
CAGAGCATGAGCTTGC-1_Br6432_Ant_IF,2,0,0,0,1,3
ACACGGGAACTTAGGG-1_Br6432_Ant_IF,1,0,0,0,0,1
GGCTCTGCTCCAACGC-1_Br6432_Ant_IF,3,0,1,3,0,7
AGAACGTGGTACATTC-1_Br6432_Ant_IF,2,0,0,0,0,2
CAATAAACCTTGGCCC-1_Br6432_Ant_IF,2,1,0,0,0,3
ACTTCGCCATACGCAC-1_Br6432_Ant_IF,1,1,0,0,2,4
ATCTGGTTAAGACTGT-1_Br6432_Ant_IF,4,1,0,0,1,6
TCGTAAGACGACATTG-1_Br6432_Ant_IF,2,0,0,0,1,3
GTGTACCTTGGCTACG-1_Br6432_Ant_IF,3,1,0,0,1,5
GCCCGTAATACCTTCT-1_Br6432_Ant_IF,4,1,1,0,1,7
CGGTCAAGTGGGAACC-1_Br6432_Ant_IF,1,0,0,0,0,1
TTGTAAGGCCAGTTGG-1_Br6432_Ant_IF,4,0,0,0,0,4
GGAGCACCAAGAACTA-1_Br6432_Ant_IF,4,0,1,0,0,5
TAATAGTGACGACCAG-1_Br6432_Ant_IF,1,0,0,0,0,1
CTAAATCCTATTCCGG-1_Br6432_Ant_IF,2,0,3,0,2,7
CGAGTTCTGTCCCACC-1_Br6432_Ant_IF,4,0,0,0,0,4
AGGCAGATGCGTAAAC-1_Br6432_Ant_IF,3,0,0,0,0,3
AAGGATGAGGGACCTC-1_Br6432_Ant_IF,2,0,0,0,1,3
AGAGAACCGTCTAGGA-1_Br6432_Ant_IF,2,0,1,0,1,4
GAGGGCGCAGCTCTGC-1_Br6432_Ant_IF,4,0,0,1,0,5
AAGATTGGCGGAACGT-1_Br6432_Ant_IF,1,0,0,0,4,5
CCAGTAGTCTGATCCA-1_Br6432_Ant_IF,1,1,0,0,1,3
AAGGGACAGATTCTGT-1_Br6432_Ant_IF,4,0,0,0,0,4
ATAGAGTTATCAACTT-1_Br6432_Ant_IF,2,0,1,0,0,3
AAATTACCTATCGATG-1_Br6432_Ant_IF,5,0,1,0,0,6
GATCCTAAATCGGGAC-1_Br6432_Ant_IF,1,0,0,0,1,2
TTACAGACCTAAATGA-1_Br6432_Ant_IF,3,1,0,1,1,6
CCTCACCTTAGCATCG-1_Br6432_Ant_IF,0,1,0,0,1,2
CATGCGACCAGTTTAA-1_Br6432_Ant_IF,2,0,0,0,2,4
AACATATCAACTGGTG-1_Br6432_Ant_IF,6,1,0,0,0,7
CTATAAGAGCCAATCG-1_Br6432_Ant_IF,1,0,0,0,2,3
AATATCGAGGGTTCTC-1_Br6432_Ant_IF,1,0,1,0,1,3
GTACTCCTGGGTATGC-1_Br6432_Ant_IF,2,0,0,1,2,5
ATAAGTAGGATTCAGA-1_Br6432_Ant_IF,1,0,0,0,1,2
AGGTCGCGGAGTTACT-1_Br6432_Ant_IF,0,1,0,0,1,2
CTAATTCTCAGATATT-1_Br6432_Ant_IF,4,0,0,0,1,5
GCCAACCATTTCCGGA-1_Br6432_Ant_IF,2,2,0,0,1,5
TGATCCCAGCATTAGT-1_Br6432_Ant_IF,3,0,0,1,0,4
CGTTGTAAGATTGATT-1_Br6432_Ant_IF,3,0,2,0,0,5
GAAACCATGGTGCGCT-1_Br6432_Ant_IF,2,0,0,1,0,3
AATCTATGCCGGAGCC-1_Br6432_Ant_IF,3,1,0,0,0,4
GACTCCCAGAATAAGG-1_Br6432_Ant_IF,1,4,0,0,1,6
TATGATCCGGCACGCC-1_Br6432_Ant_IF,1,2,0,1,0,4
CCGCTTGCTGACATGG-1_Br6432_Ant_IF,1,2,1,0,0,4
TGGTTAAGGGCGCTGG-1_Br6432_Ant_IF,0,0,0,1,0,1
TTGATAGTCAATACAT-1_Br6432_Ant_IF,0,1,1,1,0,3
GGTTTAATTGAGCAGG-1_Br6432_Ant_IF,0,5,0,0,1,6
CATTACATAGATTGTG-1_Br6432_Ant_IF,3,2,1,0,0,6
GGTACACCAGATTTAT-1_Br6432_Ant_IF,0,2,0,0,0,2
GGCCCGTATACCATGC-1_Br6432_Ant_IF,1,3,0,1,0,5
ATCTTTCGTATAACCA-1_Br6432_Ant_IF,0,5,2,0,0,7
GAGATGACAATCCTTA-1_Br6432_Ant_IF,2,2,1,0,0,5
AAAGCTTGCCTACATA-1_Br6432_Ant_IF,3,1,0,0,0,4
GAACGATAAGTTAAAG-1_Br6432_Ant_IF,1,3,1,0,0,5
TAATAGCTAAATGATG-1_Br6432_Ant_IF,0,0,2,0,0,2
TATGGCTAGGCTAATT-1_Br6432_Ant_IF,1,2,0,0,0,3
AGGAGAGTCTGGCTAC-1_Br6432_Ant_IF,1,1,0,0,0,2
TGCTCTGCCGGTTCAC-1_Br6432_Ant_IF,2,4,0,0,0,6
ACGCGTTTCTTAAGAG-1_Br6432_Ant_IF,0,0,0,0,0,0
GAGAGCGCAGTCCCTG-1_Br6432_Ant_IF,2,0,0,0,0,2
GTCCTATTGTTGTGGT-1_Br6432_Ant_IF,3,1,0,0,0,4
CATCTGCAGGATCATT-1_Br6432_Ant_IF,1,0,1,0,1,3
GAGTCGACAGACCCTC-1_Br6432_Ant_IF,4,0,1,0,0,5
AAGTGCAAAGGTAGAC-1_Br6432_Ant_IF,3,0,0,0,0,3
AGGGTGGATAGTGCAT-1_Br6432_Ant_IF,5,2,0,0,0,7
TGATAGCGGGATTCTA-1_Br6432_Ant_IF,0,0,0,0,0,0
GTCAGTTTGGTAGTCG-1_Br6432_Ant_IF,5,1,1,0,1,8
GCATTCGAAATGAACA-1_Br6432_Ant_IF,1,0,0,0,2,3
AAAGACTGGGCGCTTT-1_Br6432_Ant_IF,0,0,0,0,0,0
TAACAATATTTGTTGC-1_Br6432_Ant_IF,2,0,2,0,0,4
CCAGCTTCCGCCCGCA-1_Br6432_Ant_IF,0,0,0,0,0,0
GATATGGATTACGCGG-1_Br6432_Ant_IF,0,0,0,0,0,0
AGAGCAGTTATGAGAC-1_Br6432_Ant_IF,0,1,0,0,0,1
TCACATCTTATCTGAT-1_Br6432_Ant_IF,2,0,1,0,2,5
TATGAAGACAGGTGCG-1_Br6432_Ant_IF,1,0,0,0,2,3
TACCTGCTGCACTGTG-1_Br6432_Ant_IF,0,0,1,0,0,1
TAGGTCCAAGTAAGGA-1_Br6432_Ant_IF,1,0,0,0,0,1
GAAACTCGTGCGATGC-1_Br6432_Ant_IF,2,0,1,0,0,3
AACAATTACTCTACGC-1_Br6432_Ant_IF,1,0,0,0,0,1
CCGCACGTGACCTCGG-1_Br6432_Ant_IF,2,0,0,0,1,3
AACTTGCCCGTATGCA-1_Br6432_Ant_IF,0,0,0,0,1,1
GGGTATGTATGCACTT-1_Br6432_Ant_IF,1,0,0,0,0,1
TTCGTACTCCAGAACG-1_Br6432_Ant_IF,1,0,0,0,1,2
GAATTTCTCGCTGCAG-1_Br6432_Ant_IF,3,0,0,0,1,4
AACAGGATGGGCCGCG-1_Br6432_Ant_IF,3,0,1,0,0,4
GACGTGTAGGGATTAT-1_Br6432_Ant_IF,4,1,0,0,0,5
TAGGTGAGCCCTACTC-1_Br6432_Ant_IF,2,1,0,0,1,4
CTAATTCGCACGCGCT-1_Br6432_Ant_IF,1,0,0,0,0,1
GAAGCTTGCTGACCGC-1_Br6432_Ant_IF,0,8,0,0,3,11
GGTTAGGCTTGGAGAA-1_Br6432_Ant_IF,0,2,0,0,1,3
ACAAGGACAAGAGGTT-1_Br6432_Ant_IF,0,9,1,1,0,11
AGGCCACCCGTTATGA-1_Br6432_Ant_IF,1,6,0,0,0,7
GTGGGCTTAGACACAC-1_Br6432_Ant_IF,3,2,0,0,0,5
CGTGTCCCATTCGCGA-1_Br6432_Ant_IF,2,0,1,0,0,3
TGGAGTGATGCGATGA-1_Br6432_Ant_IF,3,0,0,0,0,3
AACAACTGGTAGTTGC-1_Br6432_Ant_IF,2,0,0,0,0,2
CCTGGCTAGACCCGCC-1_Br6432_Ant_IF,1,0,1,0,0,2
CGCAATTAGGGTAATA-1_Br6432_Ant_IF,2,0,0,0,0,2
TCGAAATTTAGGACCA-1_Br6432_Ant_IF,2,0,0,1,0,3
AGACTAGCCTTCCAGA-1_Br6432_Ant_IF,2,0,0,1,0,3
TTGATCTAACTTTGTC-1_Br6432_Ant_IF,3,0,2,1,0,6
AAGGAGCGGTTGGTGC-1_Br6432_Ant_IF,0,0,0,0,0,0
ACTTGGGACCCGGTGG-1_Br6432_Ant_IF,0,0,0,0,0,0
TGATCTCCGGCGCCAG-1_Br6432_Ant_IF,3,0,0,0,0,3
CAGTTCAAATTGACAC-1_Br6432_Ant_IF,2,0,0,1,0,3
GTCCGGCTGAATTGCG-1_Br6432_Ant_IF,1,0,0,1,0,2
CTGGAAATGGATGCTT-1_Br6432_Ant_IF,3,0,0,0,0,3
TGATCGGTTTGACCCT-1_Br6432_Ant_IF,0,0,0,1,0,1
TAGAGTCTAAGCGAAC-1_Br6432_Ant_IF,2,0,1,0,0,3
GAGACTGATGGGTAGA-1_Br6432_Ant_IF,4,0,1,0,0,5
TAGCTAAGTCCGGGAG-1_Br6432_Ant_IF,0,2,0,0,0,2
GGGCGATATGTGTGAA-1_Br6432_Ant_IF,3,1,0,0,0,4
CTCGAGGTCGAACAGT-1_Br6432_Ant_IF,1,0,0,0,0,1
GATCCCTTTATACTGC-1_Br6432_Ant_IF,0,0,0,0,1,1
GTCATGCACCTCCGTT-1_Br6432_Ant_IF,6,0,0,1,1,8
ACTTTCCTATAGCTTC-1_Br6432_Ant_IF,3,0,0,0,1,4
TCGCTCGATATATTCC-1_Br6432_Ant_IF,3,0,0,0,2,5
ATAGGTTGGGCAGATG-1_Br6432_Ant_IF,4,1,0,0,1,6
CAATTAAGGGTGATGA-1_Br6432_Ant_IF,1,1,2,0,1,5
ACCGACTGAGTCCCAC-1_Br6432_Ant_IF,2,0,0,0,2,4
CCTGTCACCCGGGCTC-1_Br6432_Ant_IF,8,0,0,0,1,9
GATCGGTGGCCATAAC-1_Br6432_Ant_IF,0,0,0,0,1,1
CCTATGGGTTACCGTC-1_Br6432_Ant_IF,2,1,2,0,0,5
TTGGGACACTGCCCGC-1_Br6432_Ant_IF,3,0,0,0,0,3
CGAGGCTAAATATGGC-1_Br6432_Ant_IF,2,0,1,0,2,5
TCAGGGTGTAACGTAA-1_Br6432_Ant_IF,3,1,0,0,1,5
CGAGAGATGTGAACCT-1_Br6432_Ant_IF,2,1,1,0,2,6
TCGCTGGGCGGATTGT-1_Br6432_Ant_IF,3,0,0,0,0,3
AGATCTCAGGTGTGAT-1_Br6432_Ant_IF,2,0,1,0,1,4
TGGCCAAACTGAAGTA-1_Br6432_Ant_IF,1,0,0,0,1,2
GCTTCCGTCCCTAGAC-1_Br6432_Ant_IF,3,0,1,0,1,5
CAGCAGCCCGTTCCTT-1_Br6432_Ant_IF,4,1,1,0,1,7
TGTATAACAGATCCTG-1_Br6432_Ant_IF,2,0,0,0,0,2
CGCGGGAATTAGGCAG-1_Br6432_Ant_IF,2,0,0,0,0,2
TGCATGTGGTAATCTA-1_Br6432_Ant_IF,1,0,0,0,0,1
ACAATTTGAGCAGTGG-1_Br6432_Ant_IF,1,0,1,0,0,2
GAGCTAAGGGCATATC-1_Br6432_Ant_IF,2,0,0,0,0,2
CCAGATAGTTGAGTGA-1_Br6432_Ant_IF,4,0,1,0,1,6
CCACAATGTACGTCTT-1_Br6432_Ant_IF,1,2,1,0,0,4
CAATGGATCTCTACCA-1_Br6432_Ant_IF,1,0,0,0,0,1
TGTGGCAAAGCGTATG-1_Br6432_Ant_IF,3,0,0,0,1,4
TAAAGCGTTAGGAGAA-1_Br6432_Ant_IF,1,0,0,0,1,2
TCCGTTTAGCCTTGAA-1_Br6432_Ant_IF,1,0,0,0,0,1
CAGCTCGACAAGTTAA-1_Br6432_Ant_IF,3,1,2,0,2,8
GCCTATAGTGTCAGGG-1_Br6432_Ant_IF,3,0,0,0,1,4
ATAGACAACGGGACCT-1_Br6432_Ant_IF,2,0,0,0,1,3
CTACTATCTTTCAGAG-1_Br6432_Ant_IF,2,0,0,0,2,4
GCGCTGCTTTGCATTT-1_Br6432_Ant_IF,5,0,0,0,0,5
GCGCATCCAGTCAGCA-1_Br6432_Ant_IF,1,0,3,0,2,6
GACTCGCGGGAATGAC-1_Br6432_Ant_IF,3,0,0,0,0,3
CTGGTAACGAGCTCTT-1_Br6432_Ant_IF,1,0,1,0,1,3
TCCGGCCTAGCGTACA-1_Br6432_Ant_IF,2,1,0,0,0,3
TCTAGGTGGCGACGCT-1_Br6432_Ant_IF,3,0,0,0,0,3
ACGCTAGTGATACACT-1_Br6432_Ant_IF,2,1,0,0,0,3
ATCTGCACCTCTGCGA-1_Br6432_Ant_IF,2,0,1,0,2,5
CCTCACCTGAGGGAGC-1_Br6432_Ant_IF,4,1,0,0,0,5
AGTGAGCCTCGCCGCC-1_Br6432_Ant_IF,0,1,0,0,0,1
ACGAGTACGGATGCCC-1_Br6432_Ant_IF,0,1,0,0,1,2
GGTACCATTAAGACGG-1_Br6432_Ant_IF,2,1,2,0,2,7
TTCTGCTAGACTCCAA-1_Br6432_Ant_IF,0,0,0,1,0,1
TAACTATTACGCCAAA-1_Br6432_Ant_IF,1,1,1,0,0,3
GCATTCAAGGCAACGC-1_Br6432_Ant_IF,3,0,0,1,0,4
AGTACATCATTTATCA-1_Br6432_Ant_IF,1,0,0,0,1,2
GTCGTGTCTGGTCATC-1_Br6432_Ant_IF,1,0,1,2,0,4
AGTCTAAAGTATACTC-1_Br6432_Ant_IF,2,2,2,0,1,7
CGGCCCAACCTGTAGT-1_Br6432_Ant_IF,1,1,1,0,0,3
AGGGAGACATACTTCG-1_Br6432_Ant_IF,0,1,2,1,0,4
TCCCTAGATCAATAGG-1_Br6432_Ant_IF,1,1,1,2,0,5
TCCCGTCGCGTCATAG-1_Br6432_Ant_IF,2,2,1,2,0,7
CGCATCCATCAGCCAG-1_Br6432_Ant_IF,4,1,1,1,0,7
CTGCACCTAGTCCACA-1_Br6432_Ant_IF,0,3,1,0,1,5
CGAGGATCGGGAACGA-1_Br6432_Ant_IF,1,5,0,1,0,7
CAATGAGGTTCGACTA-1_Br6432_Ant_IF,4,2,0,0,0,6
TCTGACGGGCTAACCC-1_Br6432_Ant_IF,0,2,2,0,0,4
TTCTATGCCTTTCGCA-1_Br6432_Ant_IF,0,0,2,0,0,2
AGAGTATAGTGTTACG-1_Br6432_Ant_IF,0,1,1,5,0,7
CCATTGTTTCCTCCAT-1_Br6432_Ant_IF,3,0,0,0,0,3
CTCATCACTTAGTGAT-1_Br6432_Ant_IF,3,1,0,0,0,4
CCGAAGGGCGTACCGC-1_Br6432_Ant_IF,5,2,0,0,0,7
TCAAGCTGCCTTGAAA-1_Br6432_Ant_IF,2,2,0,2,0,6
CTCATTAACGTTGCCC-1_Br6432_Ant_IF,3,3,2,0,0,8
TATATCATTGATCAGT-1_Br6432_Ant_IF,0,0,0,0,0,0
AACTTTACGGGAGCTT-1_Br6432_Ant_IF,0,0,0,0,0,0
TTCTTGTGTCCATCAG-1_Br6432_Ant_IF,6,1,0,0,0,7
ACAATTTAGGAGGCTC-1_Br6432_Ant_IF,2,1,2,0,0,5
ATACTTGTTCTCGAGC-1_Br6432_Ant_IF,5,1,0,0,1,7
CACGGGATTGAGGGTT-1_Br6432_Ant_IF,1,1,0,0,0,2
GTTAATGTCTATCTTA-1_Br6432_Ant_IF,4,1,0,0,0,5
GCGTTATATTTGGAAC-1_Br6432_Ant_IF,0,0,0,0,0,0
CGTCAAGGCTATAAAT-1_Br6432_Ant_IF,0,0,0,0,0,0
TTAGCTCTGTAATCCG-1_Br6432_Ant_IF,0,0,0,0,0,0
AATGGTCCACCGTTCA-1_Br6432_Ant_IF,0,0,0,0,0,0
GTCATTGCATTGACCC-1_Br6432_Ant_IF,3,0,0,0,1,4
TGTCCGTGGCGCCTTT-1_Br6432_Ant_IF,2,1,2,0,0,5
TCAACTAACGTATAAC-1_Br6432_Ant_IF,2,0,1,0,1,4
TCCTCTCCAGTTGTCC-1_Br6432_Ant_IF,0,0,1,0,0,1
TGTGTTCGTATCCAAG-1_Br6432_Ant_IF,2,0,0,0,1,3
CCGCGTAGGTAAGGGC-1_Br6432_Ant_IF,4,1,0,0,0,5
CTGCGGGTGAAATGTT-1_Br6432_Ant_IF,2,1,0,0,1,4
TATCTACAGAGGTAAT-1_Br6432_Ant_IF,1,0,0,0,4,5
CTACTCTAGGCCCGGC-1_Br6432_Ant_IF,2,0,0,0,0,2
ACAAGCAGTGCCTAGC-1_Br6432_Ant_IF,1,1,0,0,1,3
TACAAGTCTCGTGCAT-1_Br6432_Ant_IF,2,0,1,0,1,4
TCGGAATGCGCTCTGA-1_Br6432_Ant_IF,0,1,0,0,2,3
TCGCGTCCAGAAGGTC-1_Br6432_Ant_IF,1,1,0,0,1,3
TATGGCCCGGCCTCGC-1_Br6432_Ant_IF,3,2,0,0,0,5
GCTGGCATATTCACCT-1_Br6432_Ant_IF,5,1,0,0,0,6
GTCAGAATAGTCTATG-1_Br6432_Ant_IF,2,3,1,0,3,9
GGCGTCCTATCCGCTG-1_Br6432_Ant_IF,0,2,1,1,2,6
CGGAGTTTGAGAGACA-1_Br6432_Ant_IF,0,1,1,0,4,6
AGCACTTAAGGACGCC-1_Br6432_Ant_IF,0,3,1,1,2,7
TCCACAATGGTTTACG-1_Br6432_Ant_IF,0,5,0,0,3,8
CCAACGATGCACTGAT-1_Br6432_Ant_IF,4,0,0,0,0,4
ATTTACAGTTTACTGG-1_Br6432_Ant_IF,3,0,0,1,2,6
CCCTGAAATGAGTTGA-1_Br6432_Ant_IF,2,0,0,0,1,3
CAAACGGTCGCACTTT-1_Br6432_Ant_IF,2,1,0,0,1,4
TGATTCGTCTATCACT-1_Br6432_Ant_IF,1,1,1,1,1,5
TCAGGTTCTTTGAGAA-1_Br6432_Ant_IF,1,0,0,0,0,1
CACGCAGCGAGGCTTT-1_Br6432_Ant_IF,6,0,1,0,0,7
TTAAGCGCCTGACCCA-1_Br6432_Ant_IF,1,0,0,0,0,1
CTTACACGGTATTCCA-1_Br6432_Ant_IF,0,0,0,0,0,0
AAGGCTGTGCTCATCG-1_Br6432_Ant_IF,3,0,0,1,0,4
GACCAGAGCCCTGTAG-1_Br6432_Ant_IF,2,1,1,0,0,4
TCCCAGGCTTAGCTAA-1_Br6432_Ant_IF,2,0,0,0,0,2
ATTGAAGATCTTAGTG-1_Br6432_Ant_IF,4,4,0,1,0,9
AGTTCCTACAGAATTA-1_Br6432_Ant_IF,1,0,0,1,0,2
GGGCTGGTTAGTCGCG-1_Br6432_Ant_IF,1,0,0,2,0,3
GAAATGGCGGTGTTAG-1_Br6432_Ant_IF,4,0,0,0,0,4
TACGAACACGACTTCA-1_Br6432_Ant_IF,2,0,0,0,0,2
ACCACAAGTTTCTATC-1_Br6432_Ant_IF,0,0,0,3,0,3
ATATTTAACCCTCAAG-1_Br6432_Ant_IF,0,0,0,1,0,1
GATCATTCCAAACATT-1_Br6432_Ant_IF,3,2,1,1,0,7
TCCAGGCGAGTACGGT-1_Br6432_Ant_IF,3,0,0,0,0,3
GTTTGACCAAATCCTA-1_Br6432_Ant_IF,2,2,0,0,1,5
CACAGCACCCACGGCA-1_Br6432_Ant_IF,3,0,0,1,0,4
TGCAAGAATGACGTAA-1_Br6432_Ant_IF,1,0,0,0,0,1
GCGAAGCCATACCCGT-1_Br6432_Ant_IF,2,0,0,1,0,3
TCCTTTCTTACGCTTA-1_Br6432_Ant_IF,4,2,0,0,2,8
GCTGCTCTCCGGACAC-1_Br6432_Ant_IF,2,0,0,1,1,4
ACTGTCTTCTTTAGAA-1_Br6432_Ant_IF,2,0,0,0,0,2
TCAAACTTAGATTGTT-1_Br6432_Ant_IF,4,0,1,0,1,6
CTATGTCACTAGCCCA-1_Br6432_Ant_IF,0,0,0,0,0,0
TGCGCAAAGCATTTGG-1_Br6432_Ant_IF,0,0,0,0,2,2
TTAATGTAGACCAGGT-1_Br6432_Ant_IF,5,0,0,0,0,5
GGCGGTAGGATCATTG-1_Br6432_Ant_IF,8,0,0,0,0,8
GGCAATAGTCAATGAG-1_Br6432_Ant_IF,2,0,2,0,0,4
ACACGAGACTCCTTCT-1_Br6432_Ant_IF,2,0,0,0,0,2
GACACAAGGGAAGAAA-1_Br6432_Ant_IF,2,0,0,0,1,3
TCAGCAAATGCATCTC-1_Br6432_Ant_IF,2,0,1,0,0,3
GAGATCTGTCACTCCG-1_Br6432_Ant_IF,2,1,0,0,1,4
ATGCCGGTCTTGCATA-1_Br6432_Ant_IF,1,0,1,0,0,2
TTGGGCGGCGGTTGCC-1_Br6432_Ant_IF,1,2,1,0,0,4
TTGTTGTGTGTCAAGA-1_Br6432_Ant_IF,3,1,1,0,1,6
ACTGTACGATACACAT-1_Br6432_Ant_IF,0,0,0,0,0,0
TCCACTTTATCTAGGT-1_Br6432_Ant_IF,0,1,0,0,0,1
GGTCTGAGAATCTGGA-1_Br6432_Ant_IF,2,2,1,0,2,7
TAGAAAGGTGGCGCTA-1_Br6432_Ant_IF,4,0,0,0,1,5
TATGTCTCATTGTGCC-1_Br6432_Ant_IF,1,0,0,0,2,3
GGATTTCACTTCTATA-1_Br6432_Ant_IF,2,0,1,0,1,4
TGAGTGGTCCGTGACG-1_Br6432_Ant_IF,1,0,0,0,0,1
CGCTTTCTTGCATTCG-1_Br6432_Ant_IF,1,0,1,0,1,3
ACCCAACGCCCGTGGC-1_Br6432_Ant_IF,1,0,2,1,0,4
GAACGTCTCATGGTCG-1_Br6432_Ant_IF,1,1,0,0,0,2
AGGGTTCCCTTTGGTT-1_Br6432_Ant_IF,1,2,4,0,0,7
GTAGCTTCCTCTTGTT-1_Br6432_Ant_IF,0,1,1,0,0,2
GCATGAGGGACGCGGC-1_Br6432_Ant_IF,3,0,1,0,1,5
CTACCCTAAGGTCATA-1_Br6432_Ant_IF,3,0,0,0,1,4
TCACCGCTCGGCACTC-1_Br6432_Ant_IF,4,2,0,0,3,9
GGCTCGCGTTGAGGTA-1_Br6432_Ant_IF,1,0,1,0,0,2
CTAACGAAACTTGCTG-1_Br6432_Ant_IF,2,1,0,0,0,3
TTAAACTCGAATTCAT-1_Br6432_Ant_IF,1,0,1,0,3,5
TACTTTACTGAGCCGG-1_Br6432_Ant_IF,1,4,2,0,2,9
GCTTGGATCGATTAGG-1_Br6432_Ant_IF,3,0,2,0,0,5
CGGTTATCCAACAGTG-1_Br6432_Ant_IF,2,0,0,0,0,2
CAGACCTGTAAGTGTT-1_Br6432_Ant_IF,3,1,1,0,1,6
GACGGTCAATAGAAGC-1_Br6432_Ant_IF,3,0,0,0,0,3
CTGACTGCGCAGCTCG-1_Br6432_Ant_IF,0,0,0,0,0,0
CCATACCTTTACTTGT-1_Br6432_Ant_IF,0,0,0,0,0,0
GTAATAAAGGGCTCCC-1_Br6432_Ant_IF,0,0,2,0,2,4
GTGAACTCCCATTCGA-1_Br6432_Ant_IF,0,1,1,0,1,3
GTGGTTACTTCTTTCG-1_Br6432_Ant_IF,3,0,1,0,0,4
TCAGAACCTCCACAGG-1_Br6432_Ant_IF,0,0,0,0,1,1
TCCCACTCTCTTCCGG-1_Br6432_Ant_IF,0,1,2,0,1,4
ATCTTGACTTGTCCAA-1_Br6432_Ant_IF,1,1,0,0,0,2
TCGGGAACGTGCCTAG-1_Br6432_Ant_IF,2,1,0,0,0,3
GTTAGCCGTAAATCAA-1_Br6432_Ant_IF,5,0,5,0,0,10
ATTTACTAAGTCCATT-1_Br6432_Ant_IF,4,0,0,2,1,7
GGGTGCATATGAAAGC-1_Br6432_Ant_IF,0,0,2,0,0,2
TCCGAATGGTCCTGAG-1_Br6432_Ant_IF,0,0,3,0,1,4
TGATGGCTGTTTCTGA-1_Br6432_Ant_IF,1,4,0,2,0,7
AAATAAGGTAGTGCCC-1_Br6432_Ant_IF,1,5,0,2,0,8
CCACTATCCGGGTCAC-1_Br6432_Ant_IF,2,0,0,3,0,5
ACACCACATAATTAGC-1_Br6432_Ant_IF,1,0,1,1,0,3
CGCGGTAAGTCTAGCT-1_Br6432_Ant_IF,1,2,0,2,0,5
GCGGGCATTACGATGC-1_Br6432_Ant_IF,3,1,1,0,0,5
AGGATTGCTTACGACA-1_Br6432_Ant_IF,0,1,0,1,0,2
CTCGGGATAACACCTA-1_Br6432_Ant_IF,0,1,0,1,0,2
GTCGTCTGGTTGGCTA-1_Br6432_Ant_IF,1,1,0,0,0,2
GCAATTAGTCGCACCG-1_Br6432_Ant_IF,0,0,0,1,0,1
GTGACCTAAAGAATAA-1_Br6432_Ant_IF,1,1,0,2,0,4
CTGAGCGAGACTTATT-1_Br6432_Ant_IF,1,6,1,3,0,11
CAAGACTCAGAAGCGC-1_Br6432_Ant_IF,2,2,0,1,0,5
ACTTCGCTAGCGAGTG-1_Br6432_Ant_IF,1,2,2,0,0,5
ATGGCAGCCGAGAAAC-1_Br6432_Ant_IF,0,0,0,0,0,0
CCTCGGATGCTACCTG-1_Br6432_Ant_IF,0,0,0,0,0,0
ATACGGTGAAGATGCA-1_Br6432_Ant_IF,0,0,0,0,0,0
ACATCAGCTGGGACGC-1_Br6432_Ant_IF,0,0,0,0,0,0
GGTTGTGTAGCCTGGC-1_Br6432_Ant_IF,0,0,0,0,0,0
CCTGCGTTCTACGCTT-1_Br6432_Ant_IF,0,0,0,0,0,0
GAACGTTAGGAAGACG-1_Br6432_Ant_IF,3,1,2,0,1,7
CTGATAGTGTATCTCA-1_Br6432_Ant_IF,2,0,0,0,0,2
TTCTGCGAGCGCCCTT-1_Br6432_Ant_IF,2,0,0,0,0,2
CTTTGGCGCTTTATAC-1_Br6432_Ant_IF,2,0,0,0,1,3
TCCGAACTTGGCTTAC-1_Br6432_Ant_IF,3,0,3,0,0,6
TAGATTCCTGGTTATT-1_Br6432_Ant_IF,2,0,0,0,0,2
CCGACAAAGGGAGTGC-1_Br6432_Ant_IF,4,0,2,0,0,6
CCATGGCCCTTGTACC-1_Br6432_Ant_IF,1,1,0,0,3,5
GAAATATCACCATCAG-1_Br6432_Ant_IF,3,1,0,0,1,5
ACGAAATGGGCGGCAC-1_Br6432_Ant_IF,6,0,0,0,1,7
GTGAGCGTGCTGCACT-1_Br6432_Ant_IF,3,1,0,0,1,5
CCGCGGGTACGAAGAA-1_Br6432_Ant_IF,4,0,0,0,0,4
TCCCTGGCTCGCTGGA-1_Br6432_Ant_IF,3,1,1,0,0,5
CAGCTTAGTAGGTAGC-1_Br6432_Ant_IF,4,0,1,0,1,6
CACGAAAGTTAGTCCC-1_Br6432_Ant_IF,3,0,1,0,2,6
ACCTAATCGACTTCCT-1_Br6432_Ant_IF,2,0,0,0,0,2
AAGTAGTGACGCGAGG-1_Br6432_Ant_IF,1,3,1,0,2,7
TCCGATTACATTGCCG-1_Br6432_Ant_IF,0,5,1,0,1,7
CCTCCGACAATTCAAG-1_Br6432_Ant_IF,0,3,0,0,2,5
GTTCACAGGAGTCTAG-1_Br6432_Ant_IF,0,1,0,0,1,2
CGAAGTTGCTCTGTGT-1_Br6432_Ant_IF,1,1,1,0,0,3
GTCGGATATCTCAGAC-1_Br6432_Ant_IF,0,0,0,0,1,1
CGCTCTCCGTAGATTA-1_Br6432_Ant_IF,2,0,0,0,2,4
CAAGCAACGTCGGAGT-1_Br6432_Ant_IF,1,0,3,0,2,6
CCATTCCCTGCCCACA-1_Br6432_Ant_IF,0,0,0,0,0,0
CTTTGGCTTTAGTAAA-1_Br6432_Ant_IF,1,0,1,1,3,6
GGCTATTAAGTTGTAT-1_Br6432_Ant_IF,2,0,0,0,1,3
CCATTAGCGATAATCC-1_Br6432_Ant_IF,3,0,0,0,1,4
TGTTCTTCCATTGACT-1_Br6432_Ant_IF,6,1,0,0,1,8
AGATAACTTCAGGGCC-1_Br6432_Ant_IF,2,0,0,0,0,2
ATAGACGAAGAGAAAG-1_Br6432_Ant_IF,8,0,0,0,1,9
GGCGGAGTAATATTAG-1_Br6432_Ant_IF,3,0,0,0,0,3
TGACCCACGTTAGACA-1_Br6432_Ant_IF,1,0,0,0,0,1
TCACAGGTTATTGGGC-1_Br6432_Ant_IF,0,0,0,0,0,0
TCACGCATTGTAGATC-1_Br6432_Ant_IF,0,0,0,1,0,1
TTGAAGAATTCCCAGG-1_Br6432_Ant_IF,2,0,0,0,0,2
AAATGGTCAATGTGCC-1_Br6432_Ant_IF,3,0,0,0,0,3
TAGTGCCCTCCAGAGT-1_Br6432_Ant_IF,0,0,0,2,0,2
GGTATTGCCGAGTTTA-1_Br6432_Ant_IF,0,0,0,5,0,5
CGTATTAAGAGATCTA-1_Br6432_Ant_IF,3,6,0,1,0,10
ACTGTCCAGGATTATA-1_Br6432_Ant_IF,8,0,0,0,0,8
CGGGCAGCTAAACCGC-1_Br6432_Ant_IF,1,0,0,4,0,5
TTGCTGATCATGTTCG-1_Br6432_Ant_IF,0,0,0,0,0,0
TATGGGTACGTATCGT-1_Br6432_Ant_IF,0,0,1,0,0,1
CAGCTCACTGAGACAT-1_Br6432_Ant_IF,1,0,0,0,0,1
GGGACTGCATAGATAG-1_Br6432_Ant_IF,2,0,0,0,0,2
ACGCATTCGTGAGTAC-1_Br6432_Ant_IF,1,1,0,0,0,2
CTCTGGACGCCTGGTG-1_Br6432_Ant_IF,3,0,1,0,0,4
AGGGTTTAGTTCGGGA-1_Br6432_Ant_IF,0,0,0,0,0,0
GGGAGAACTCACAGTA-1_Br6432_Ant_IF,4,0,0,0,0,4
ATCAATCTGGGCTGCA-1_Br6432_Ant_IF,1,0,0,0,0,1
TCTTCGATACCAATAA-1_Br6432_Ant_IF,4,0,0,2,0,6
ACGTAGATTGCTGATG-1_Br6432_Ant_IF,3,6,0,0,2,11
TCTTGATGCGTAGCGA-1_Br6432_Ant_IF,2,0,0,0,1,3
GGGCTGCCTAGGGCGA-1_Br6432_Ant_IF,4,0,0,0,0,4
CTCTCACAATCGATGA-1_Br6432_Ant_IF,2,0,0,0,0,2
CCAAGCGTAACTCGTA-1_Br6432_Ant_IF,4,1,0,0,0,5
ACAACAGCATGAGCTA-1_Br6432_Ant_IF,3,0,0,0,0,3
GTCCCAACGTAAAGTA-1_Br6432_Ant_IF,1,1,1,0,1,4
TCGGAGTACATGAGTA-1_Br6432_Ant_IF,0,0,0,0,0,0
GGGAGTTAATGAGGCG-1_Br6432_Ant_IF,1,2,0,0,0,3
CCGGGCGGTCTCGTCA-1_Br6432_Ant_IF,2,0,0,0,1,3
CCGTAAGTTGGTCCCA-1_Br6432_Ant_IF,3,0,0,0,0,3
GGAGGGCTTGGTTGGC-1_Br6432_Ant_IF,3,1,2,0,1,7
TCGGACGCCCAGCCCA-1_Br6432_Ant_IF,1,0,0,0,0,1
TCTGTGCCATCATAGT-1_Br6432_Ant_IF,3,0,0,0,0,3
GTACTGGAGTTAGACC-1_Br6432_Ant_IF,3,1,0,0,0,4
GGAATGCGCTAGCGTG-1_Br6432_Ant_IF,0,0,1,0,2,3
GTGTGAATAACTTAGG-1_Br6432_Ant_IF,2,0,3,0,2,7
GGTCGGCCAGGAGCTT-1_Br6432_Ant_IF,1,0,0,0,2,3
TAGCCGGCGGTCAGCG-1_Br6432_Ant_IF,0,1,1,0,3,5
CGGGTGTACCCATTTA-1_Br6432_Ant_IF,5,0,1,0,1,7
AGTGATTCAAGCAGGA-1_Br6432_Ant_IF,1,0,0,0,3,4
GTTGGATTGAGAACAC-1_Br6432_Ant_IF,3,0,0,0,0,3
CACACGCGCTGTCTTA-1_Br6432_Ant_IF,1,1,1,0,0,3
TAGACGCCCGTACCGG-1_Br6432_Ant_IF,0,0,0,0,0,0
GGTTTCAATCGGTCAG-1_Br6432_Ant_IF,0,0,1,0,1,2
AATCTGCGTTGGGACG-1_Br6432_Ant_IF,4,0,1,0,2,7
TTACGGATGGTTCGAG-1_Br6432_Ant_IF,2,0,1,0,1,4
CGGCAGGGTCGGGTTG-1_Br6432_Ant_IF,1,1,0,0,1,3
GCTTTCAGAGGAGGTG-1_Br6432_Ant_IF,1,2,2,0,0,5
TCTTCCCATGGGCACA-1_Br6432_Ant_IF,1,1,2,0,0,4
TACCGCGGACTTGCAG-1_Br6432_Ant_IF,1,1,0,0,1,3
AGAATTATGGATTCGA-1_Br6432_Ant_IF,1,1,1,0,0,3
ATTGATGAGTCCTAAC-1_Br6432_Ant_IF,2,0,0,0,1,3
TAGGTCGCCGGAACTG-1_Br6432_Ant_IF,4,0,1,0,0,5
TAACCTACCGTCCGAG-1_Br6432_Ant_IF,1,1,0,0,1,3
CTTAGTAGGCCTACAG-1_Br6432_Ant_IF,3,0,0,0,0,3
CTAGATGTGAGTGTAA-1_Br6432_Ant_IF,0,0,0,0,0,0
ACTCCCGAATTCGTTT-1_Br6432_Ant_IF,3,2,2,0,0,7
GTTCATCGTTTGGCTG-1_Br6432_Ant_IF,0,0,0,0,1,1
ACTTTACCCTCATGAA-1_Br6432_Ant_IF,4,0,0,1,1,6
GCGAGAGTTGCGTCCA-1_Br6432_Ant_IF,2,0,0,0,0,2
GTTCGGGCGTACCATT-1_Br6432_Ant_IF,2,0,0,0,0,2
CGACTTTGTATAGCCT-1_Br6432_Ant_IF,1,1,0,0,3,5
GCCATCGATGCTGCAT-1_Br6432_Ant_IF,2,1,0,0,0,3
GCATTTCCAAGGCTCC-1_Br6432_Ant_IF,1,0,1,0,2,4
ATGTAAGGCTGCTCTT-1_Br6432_Ant_IF,1,0,0,0,1,2
ACGTTCGCAATCAATT-1_Br6432_Ant_IF,1,2,1,0,1,5
GTGACGAGGGTGACCC-1_Br6432_Ant_IF,0,1,0,0,0,1
ATTATAGCTACTTTAC-1_Br6432_Ant_IF,0,0,0,0,1,1
CGTGTGTTAAACCCTG-1_Br6432_Ant_IF,0,0,2,0,0,2
TTGGTATGGCTTGTGT-1_Br6432_Ant_IF,3,1,4,2,0,10
CATTCCCATTCCGTCG-1_Br6432_Ant_IF,0,1,0,0,0,1
TGCCGAAAGCGTATTC-1_Br6432_Ant_IF,2,1,0,0,0,3
CAACACATCTCCTGCC-1_Br6432_Ant_IF,2,3,1,1,0,7
CTGCCTCATATGCAAC-1_Br6432_Ant_IF,2,1,1,2,0,6
TCCCGCCTATGTGCGT-1_Br6432_Ant_IF,0,0,1,2,0,3
GGTTACCCGACACTTT-1_Br6432_Ant_IF,0,2,0,0,0,2
CCAGCGGGATCACCAG-1_Br6432_Ant_IF,1,1,1,1,0,4
ATGTTTCGGCCCGGAG-1_Br6432_Ant_IF,0,0,0,4,0,4
GCGTCTAACCTCCTAA-1_Br6432_Ant_IF,1,0,0,1,1,3
ATCAGGTAGCTGACAG-1_Br6432_Ant_IF,1,2,1,3,0,7
GCACACGCCCATGGTC-1_Br6432_Ant_IF,0,0,0,0,0,0
TATCTAGCCTAAAGGA-1_Br6432_Ant_IF,2,0,0,0,1,3
TTCCTCTGCCCGAATA-1_Br6432_Ant_IF,0,0,0,0,0,0
TTACTATCGGCTTCTC-1_Br6432_Ant_IF,5,0,1,0,0,6
GCCGCATTAGTCCGGC-1_Br6432_Ant_IF,4,0,0,0,0,4
TAAGGGCTGGGAGAGG-1_Br6432_Ant_IF,5,0,1,0,0,6
TAAGCAGGCGACACGC-1_Br6432_Ant_IF,5,0,0,0,0,5
AGCACTACCGGCCTGT-1_Br6432_Ant_IF,2,0,1,0,2,5
GAAAGCCCTTTGGACC-1_Br6432_Ant_IF,3,0,0,0,1,4
GACCGACTGAAGCGTC-1_Br6432_Ant_IF,3,0,0,0,0,3
CGGTGAAGACTAAAGT-1_Br6432_Ant_IF,0,0,0,0,1,1
CCCTGCGCTACGCATA-1_Br6432_Ant_IF,1,0,1,0,0,2
TACTGGACAGCTCGGC-1_Br6432_Ant_IF,0,0,0,0,0,0
TTAGTAGGGCGGCGGG-1_Br6432_Ant_IF,2,0,0,0,1,3
GAGGCTATCAAAGTCG-1_Br6432_Ant_IF,1,0,1,0,1,3
TTACCATTGATTACCC-1_Br6432_Ant_IF,1,2,0,0,1,4
ATACCACGGGCAACTT-1_Br6432_Ant_IF,0,1,0,0,0,1
TGTCCTAAGTCACCGC-1_Br6432_Ant_IF,0,2,0,0,1,3
AGGTAGGTACAAAGCT-1_Br6432_Ant_IF,3,2,2,0,1,8
GGCATACAGGTAGCGG-1_Br6432_Ant_IF,0,2,1,0,2,5
TGTAGTGATCTATAAT-1_Br6432_Ant_IF,5,2,1,0,0,8
TCCCGGGTGTGCTGCT-1_Br6432_Ant_IF,2,2,0,0,1,5
TACGATGTTGATCATC-1_Br6432_Ant_IF,1,0,1,0,1,3
CCTCTCTCCCATCTAG-1_Br6432_Ant_IF,1,0,0,0,1,2
GCAGGACTATAGAATA-1_Br6432_Ant_IF,4,0,3,0,1,8
CTAGTGAAGGACAGGA-1_Br6432_Ant_IF,1,0,1,1,2,5
TACGAGAACTTCACGT-1_Br6432_Ant_IF,0,0,1,0,1,2
CGTTGTTTCAATTCCC-1_Br6432_Ant_IF,2,1,1,1,1,6
GCAAATATTACGCTTT-1_Br6432_Ant_IF,1,0,0,0,2,3
CCAATAGTGCCGTCGA-1_Br6432_Ant_IF,2,0,0,0,0,2
ATTGCTGCTCCTCCAT-1_Br6432_Ant_IF,5,2,0,0,0,7
GAGATCTGCTTGGCAT-1_Br6432_Ant_IF,4,0,1,0,2,7
GCCGAAATTCCTACGT-1_Br6432_Ant_IF,1,0,0,0,1,2
GGCACTCCACTGGGCA-1_Br6432_Ant_IF,2,0,1,0,0,3
GGGTCACCGTGACGGT-1_Br6432_Ant_IF,4,1,1,0,0,6
CACTTAATCAGACGGA-1_Br6432_Ant_IF,2,1,0,0,0,3
CGTTTCGCTCATTACA-1_Br6432_Ant_IF,1,1,0,0,1,3
ATAAAGGCTCGGTCGT-1_Br6432_Ant_IF,2,0,0,0,0,2
CACTAAAGTTGCCTAT-1_Br6432_Ant_IF,3,0,0,0,0,3
GTGCTCAAGTACTGTC-1_Br6432_Ant_IF,1,0,0,0,0,1
CCATGCCTGTTTAGTA-1_Br6432_Ant_IF,1,0,0,0,0,1
TCTAGTTATCAGAAGA-1_Br6432_Ant_IF,0,0,0,0,0,0
TTGTAATCCGTACTCG-1_Br6432_Ant_IF,2,1,0,2,0,5
TCCCAGCTTTAGTCTG-1_Br6432_Ant_IF,3,8,0,0,0,11
CTACGCACGGAGTACC-1_Br6432_Ant_IF,4,0,0,0,0,4
AAATTAACGGGTAGCT-1_Br6432_Ant_IF,0,0,0,2,0,2
CGGCCACGCACAAAGT-1_Br6432_Ant_IF,1,0,0,1,0,2
GAAGCGTGAGGAATTT-1_Br6432_Ant_IF,3,0,0,1,0,4
ATATCTTAGGGCCTTC-1_Br6432_Ant_IF,2,1,3,0,1,7
ACGCGGGCCAAGGACA-1_Br6432_Ant_IF,0,0,0,0,1,1
GCGAGTTCTGCAAAGA-1_Br6432_Ant_IF,1,7,0,1,0,9
TATTCGTGCCAGAATA-1_Br6432_Ant_IF,1,0,0,0,0,1
AGGGCTGCAGTTACAG-1_Br6432_Ant_IF,1,1,0,0,0,2
CTAGCATAGTATAATG-1_Br6432_Ant_IF,0,0,0,0,0,0
TAGGTTCGAGTTCGTC-1_Br6432_Ant_IF,1,2,0,0,0,3
GAATTATAGTGAAAGG-1_Br6432_Ant_IF,1,0,0,0,1,2
CTATCGGGTCTCAACA-1_Br6432_Ant_IF,3,0,0,0,1,4
GCGCTAATTGAATAGA-1_Br6432_Ant_IF,2,1,1,0,2,6
ATGCGACAGTCCCATT-1_Br6432_Ant_IF,1,0,0,0,1,2
GGTAGTGCTCGCACCA-1_Br6432_Ant_IF,1,0,0,0,1,2
AAGCTCGTGCCAAGTC-1_Br6432_Ant_IF,1,1,1,0,0,3
TATTCAATTCTAATCC-1_Br6432_Ant_IF,0,0,1,0,0,1
TTCAAAGTCTCTAGCC-1_Br6432_Ant_IF,1,0,0,0,1,2
TTGAATATGGACTTTC-1_Br6432_Ant_IF,4,0,0,0,1,5
AAGAGCTCTTTATCGG-1_Br6432_Ant_IF,3,0,0,0,1,4
TTACTCCGGCCGGGAA-1_Br6432_Ant_IF,1,0,0,0,0,1
AAACGAGACGGTTGAT-1_Br6432_Ant_IF,1,0,1,0,2,4
GCTAAGTAGTTTCTCT-1_Br6432_Ant_IF,1,0,0,0,0,1
ATAACGCCGGAGGGTC-1_Br6432_Ant_IF,1,1,1,0,0,3
GGATCCGGAATATACT-1_Br6432_Ant_IF,0,1,0,0,1,2
TGAAAGGACCTGACTC-1_Br6432_Ant_IF,4,0,1,0,1,6
TCCGCGGCAGCATCTG-1_Br6432_Ant_IF,1,0,1,0,1,3
TGCATATGTCTGTCAC-1_Br6432_Ant_IF,7,0,0,0,1,8
TGTAGGAGAAATTTCC-1_Br6432_Ant_IF,4,0,2,0,0,6
AGTGAGACTTCCAGTA-1_Br6432_Ant_IF,2,0,0,0,0,2
CCCAAACATGCTGCTC-1_Br6432_Ant_IF,3,1,1,0,1,6
GCTTATGAAGCAGGAA-1_Br6432_Ant_IF,5,0,0,0,1,6
TTCTAACCGAAGCTTA-1_Br6432_Ant_IF,4,1,0,0,0,5
GGATGTCCTTACCGCA-1_Br6432_Ant_IF,2,1,1,0,1,5
AGGGTGCTCTCGAGGG-1_Br6432_Ant_IF,5,0,2,0,1,8
AACTCTCAATAGAGCG-1_Br6432_Ant_IF,2,1,1,0,1,5
TCTGAATTCCGTACAA-1_Br6432_Ant_IF,0,0,0,0,1,1
GCGTGGTACTGGGTTA-1_Br6432_Ant_IF,4,1,2,0,1,8
CGTCGGATAGTGTTGA-1_Br6432_Ant_IF,1,0,2,0,4,7
ATATGTCTCCCTAGCC-1_Br6432_Ant_IF,4,1,0,0,1,6
TCTTTAAGACTATGAA-1_Br6432_Ant_IF,0,2,1,0,1,4
TCATTTAAGTCTCCGA-1_Br6432_Ant_IF,0,0,0,0,1,1
GATATTGAGATTGGCG-1_Br6432_Ant_IF,0,0,1,0,0,1
TGACATCGAGCGGACC-1_Br6432_Ant_IF,0,0,1,0,0,1
GCGTAAATGGCCATAA-1_Br6432_Ant_IF,0,0,2,0,2,4
ATTGTACAACTCGGCT-1_Br6432_Ant_IF,0,1,1,0,0,2
TACGCTATAGAAACCT-1_Br6432_Ant_IF,2,0,0,0,0,2
CACCCAAATCTTATGT-1_Br6432_Ant_IF,3,0,0,0,0,3
AGATGATGGAGTCTGG-1_Br6432_Ant_IF,1,0,0,0,0,1
CCACGGTGCCCGGTAG-1_Br6432_Ant_IF,0,2,0,1,0,3
TCAAGAAATACTAGCT-1_Br6432_Ant_IF,6,0,0,1,0,7
AGGTATAATTGATAGT-1_Br6432_Ant_IF,4,0,0,0,1,5
CAAGGTCCTATAGGCT-1_Br6432_Ant_IF,2,0,1,0,2,5
CCGGCACGACCGTTTC-1_Br6432_Ant_IF,1,0,0,0,0,1
ACCTCCGTTATTCACC-1_Br6432_Ant_IF,1,2,2,0,3,8
GCAGCCTATATCACAT-1_Br6432_Ant_IF,1,1,1,0,1,4
GGTATAGTGACACATA-1_Br6432_Ant_IF,0,2,0,0,0,2
AAATTCCAGGTCCAAA-1_Br6432_Ant_IF,1,1,2,0,3,7
TCTTTAGCAGGCGAAC-1_Br6432_Ant_IF,0,1,3,0,0,4
TATTGACATTTCTGCC-1_Br6432_Ant_IF,0,1,4,2,0,7
TCTGATCGGGTGCTAG-1_Br6432_Ant_IF,0,0,3,1,0,4
GGCCCGGAGCATGTCT-1_Br6432_Ant_IF,1,2,1,0,0,4
GGGCGCAGCGTTACTC-1_Br6432_Ant_IF,1,0,0,2,1,4
TTGGCGATCCGAATAT-1_Br6432_Ant_IF,0,1,0,3,0,4
CCACGTAAATTAGACT-1_Br6432_Ant_IF,1,2,2,1,1,7
TCTGATTGGAAATGGA-1_Br6432_Ant_IF,0,3,0,2,0,5
ATGGCGGAATAGTCGC-1_Br6432_Ant_IF,2,3,2,0,0,7
ATCGCTTTACGTCTCA-1_Br6432_Ant_IF,1,0,1,3,0,5
TACGTGCAAGGTTCCT-1_Br6432_Ant_IF,0,2,1,0,0,3
CAGGACAGCTGCCCTT-1_Br6432_Ant_IF,0,4,1,1,0,6
AGAATAAATCTTCAGG-1_Br6432_Ant_IF,1,2,0,0,0,3
TACTCGGCACGCCGGG-1_Br6432_Ant_IF,0,0,0,0,0,0
AGGTGTATCGCCATGA-1_Br6432_Ant_IF,0,0,0,0,1,1
TGTGCTTTACGTAAGA-1_Br6432_Ant_IF,2,0,0,0,4,6
AAACCTCATGAAGTTG-1_Br6432_Ant_IF,2,0,0,0,2,4
TATAGGGTACTCATGA-1_Br6432_Ant_IF,4,1,1,0,1,7
CCAGCTGATGGTACTT-1_Br6432_Ant_IF,3,2,0,1,1,7
AATATTGGAGTATTGA-1_Br6432_Ant_IF,4,0,1,0,0,5
GGCCCTCACCCACTTA-1_Br6432_Ant_IF,5,0,1,0,0,6
AACCAAGACTTCTCTG-1_Br6432_Ant_IF,4,0,1,0,0,5
TCGTATTACCCATTGC-1_Br6432_Ant_IF,5,2,2,0,0,9
ATTCGACGCCGGGCCT-1_Br6432_Ant_IF,7,0,1,0,0,8
GGCGCAGGACATCTTC-1_Br6432_Ant_IF,0,5,1,0,3,9
GTACTCCCTTATCGCT-1_Br6432_Ant_IF,0,5,3,0,4,12
TGGTCTGTTGGGCGTA-1_Br6432_Ant_IF,0,5,0,0,2,7
AATAACAACGCTCGGC-1_Br6432_Ant_IF,1,4,1,0,3,9
CATACCCGTACCCAGT-1_Br6432_Ant_IF,1,3,0,0,1,5
ACAATCCATTTAAACC-1_Br6432_Ant_IF,0,3,0,0,0,3
GTTACAATTGGTGACG-1_Br6432_Ant_IF,2,0,0,0,0,2
TTGCCCTGATCACGGG-1_Br6432_Ant_IF,0,0,2,0,1,3
CTAACCGCGCGCCCGT-1_Br6432_Ant_IF,3,0,1,0,0,4
CTAAAGAATGCCTACT-1_Br6432_Ant_IF,0,2,0,0,1,3
ACCCATCTTGAGGGTA-1_Br6432_Ant_IF,3,0,0,0,1,4
GATCTTTGCAGGGTAT-1_Br6432_Ant_IF,2,0,0,0,0,2
GGGTACTTCATGAACT-1_Br6432_Ant_IF,3,0,0,0,1,4
GCCGCTTGTGAGAAAC-1_Br6432_Ant_IF,1,0,0,0,0,1
CCTGTAAGACATGATA-1_Br6432_Ant_IF,1,0,0,0,1,2
CGACAGTTCGCGTTAT-1_Br6432_Ant_IF,2,0,0,0,1,3
ACGATGCATATGTTAT-1_Br6432_Ant_IF,3,0,0,0,0,3
TGTTCCGCTTCCATGA-1_Br6432_Ant_IF,2,1,0,0,0,3
GGATGACGCGAGTTTA-1_Br6432_Ant_IF,2,1,0,0,1,4
GAAGTTTCCACTCAAT-1_Br6432_Ant_IF,2,2,0,0,3,7
GCGAGGCCCGAGCAGA-1_Br6432_Ant_IF,2,0,1,0,2,5
CATACTATGTAATTGT-1_Br6432_Ant_IF,2,1,0,0,0,3
CCAATGTCACAGCAAG-1_Br6432_Ant_IF,3,0,0,0,1,4
GTTGGATTTGCGTTGG-1_Br6432_Ant_IF,4,1,0,0,0,5
GGGAGGATGCCCGAAA-1_Br6432_Ant_IF,3,0,0,0,0,3
GATCGCGGGCTCTCCA-1_Br6432_Ant_IF,1,0,0,0,1,2
GTTCGCCATAAGTGCC-1_Br6432_Ant_IF,5,0,1,0,0,6
AGATTATAGGACGTTT-1_Br6432_Ant_IF,3,0,0,0,0,3
TCGAGACCAACACCGT-1_Br6432_Ant_IF,7,1,0,0,0,8
TATGGGACCGAGCAGG-1_Br6432_Ant_IF,1,0,0,1,0,2
GATGCGTCCTGCATTC-1_Br6432_Ant_IF,2,0,0,1,0,3
TATGGTCTGAGTAACA-1_Br6432_Ant_IF,0,0,0,0,0,0
GCATAGAGCACTCAGG-1_Br6432_Ant_IF,3,0,0,0,0,3
CTTCATTGTCAGTGGA-1_Br6432_Ant_IF,1,0,1,2,0,4
GCAGATTAGGGATATC-1_Br6432_Ant_IF,4,1,1,2,0,8
CCTGTCGCCCGTAAAT-1_Br6432_Ant_IF,3,1,0,0,0,4
CAATTTCGTATAAGGG-1_Br6432_Ant_IF,2,0,0,0,0,2
GTACACTTACCTGAAG-1_Br6432_Ant_IF,2,0,1,0,0,3
CCAGCCTGGACCAATA-1_Br6432_Ant_IF,1,0,0,0,0,1
ATGGAGCAGGCCGTGA-1_Br6432_Ant_IF,0,1,2,0,0,3
GTCATTAGAGCGAACG-1_Br6432_Ant_IF,2,0,0,0,0,2
AAGACTGCAAGCTACT-1_Br6432_Ant_IF,2,0,1,0,0,3
CTAGTCACGTCTTAAG-1_Br6432_Ant_IF,5,1,1,0,0,7
ACTCTTGTATAGTAAC-1_Br6432_Ant_IF,3,0,2,0,0,5
ATTAGGCGATGCTTTC-1_Br6432_Ant_IF,0,0,0,1,0,1
TTCGGGACTAATCGCG-1_Br6432_Ant_IF,1,0,0,0,0,1
TGGACTGTTCGCTCAA-1_Br6432_Ant_IF,5,1,0,0,0,6
AACGTGCGAAAGTCTC-1_Br6432_Ant_IF,4,0,0,0,0,4
CCACCCAAGGAAAGTG-1_Br6432_Ant_IF,2,0,0,0,1,3
CCGCACAAAGACCAAC-1_Br6432_Ant_IF,4,1,0,0,1,6
GCGATTGTTAACGTTA-1_Br6432_Ant_IF,1,0,0,0,0,1
ACTCGTCAGTAATCCC-1_Br6432_Ant_IF,1,0,0,0,0,1
GGTGATAAGGAGCAGT-1_Br6432_Ant_IF,1,1,0,0,1,3
AAGAGGCATGGATCGC-1_Br6432_Ant_IF,1,0,0,0,1,2
CACGTTCGTGCTCTAG-1_Br6432_Ant_IF,3,0,0,0,0,3
CTATTTGGTTACGGAT-1_Br6432_Ant_IF,5,0,1,0,2,8
GTACAGAGGCAAGGGT-1_Br6432_Ant_IF,3,0,0,0,0,3
GGGCCGGCCGAAGTAC-1_Br6432_Ant_IF,2,0,1,0,2,5
CCTGAACGATATATTC-1_Br6432_Ant_IF,4,0,0,0,1,5
CCGGGCTGCTCCATAC-1_Br6432_Ant_IF,3,0,1,0,0,4
TACTTGTTAGTAGTCC-1_Br6432_Ant_IF,0,0,0,0,0,0
CCTAGGCGTAGCGATC-1_Br6432_Ant_IF,1,0,0,0,1,2
CTGGCGCACAGGTCTG-1_Br6432_Ant_IF,2,0,0,0,0,2
ACTTATACTTACCCGG-1_Br6432_Ant_IF,3,1,0,0,0,4
GAAGTCTCCCTAGCGA-1_Br6432_Ant_IF,1,0,0,0,0,1
ACCGATGGTAGCATCG-1_Br6432_Ant_IF,2,1,1,0,0,4
CGAGTTTATCGGACTG-1_Br6432_Ant_IF,4,1,1,0,1,7
CATAACGGACAGTCGT-1_Br6432_Ant_IF,4,2,0,0,0,6
TGACGATGCACTAGAA-1_Br6432_Ant_IF,3,0,0,0,0,3
TAGGGAGCTTGGGATG-1_Br6432_Ant_IF,2,2,2,0,2,8
AGGGTCGATGCGAACT-1_Br6432_Ant_IF,1,1,1,0,1,4
TATATCCCTGGGAGGA-1_Br6432_Ant_IF,3,0,0,0,2,5
CATCTTACACCACCTC-1_Br6432_Ant_IF,3,2,1,0,1,7
GTGCGACAGGGAGTGT-1_Br6432_Ant_IF,2,0,1,0,1,4
CCGATCTCAACCTTAT-1_Br6432_Ant_IF,1,0,2,0,1,4
ACGATCATCTTGTAAA-1_Br6432_Ant_IF,0,0,0,0,0,0
GAAAGAACAGCGTTAT-1_Br6432_Ant_IF,4,0,0,0,0,4
CTAGGTCTGAAGGAAT-1_Br6432_Ant_IF,1,1,0,0,0,2
ATATCAACCTACAGAG-1_Br6432_Ant_IF,3,1,0,0,0,4
AAATAGCTTAGACTTT-1_Br6432_Ant_IF,2,0,1,0,2,5
GCGACATGTAAACATC-1_Br6432_Ant_IF,0,1,1,0,1,3
ATAAGTAGGGCGACTC-1_Br6432_Ant_IF,1,1,0,0,0,2
GCGAGCGCATGCTCCC-1_Br6432_Ant_IF,1,1,0,0,0,2
AGGGACCGGCTGCGTT-1_Br6432_Ant_IF,1,1,0,0,0,2
CCTATGAAGTGGTGCC-1_Br6432_Ant_IF,4,0,2,0,1,7
GCTTACGTAGTTAGTA-1_Br6432_Ant_IF,2,1,0,1,1,5
CATACTTAGGCAATAC-1_Br6432_Ant_IF,1,1,2,1,0,5
CCTGTCCCTCACGTTA-1_Br6432_Ant_IF,0,0,0,2,1,3
CAATGTGCCAACCCTT-1_Br6432_Ant_IF,2,0,0,1,0,3
GTTAAGTTAGAGTGGG-1_Br6432_Ant_IF,2,1,0,0,0,3
CTGGGATACGCTACCC-1_Br6432_Ant_IF,0,1,0,0,0,1
AACCTGTCACGGAATT-1_Br6432_Ant_IF,2,2,0,4,0,8
ACTGCGGACACACCGT-1_Br6432_Ant_IF,1,10,0,3,0,14
CCGTGAGGCATTCATG-1_Br6432_Ant_IF,0,0,0,2,1,3
GCCCAGATGCTGGAGA-1_Br6432_Ant_IF,0,0,0,2,0,2
TCTGGCCGTTCAAGTT-1_Br6432_Ant_IF,0,1,0,4,1,6
ATACGAAGGCTTTCCA-1_Br6432_Ant_IF,1,0,2,2,1,6
GATCCGAATATAAGTG-1_Br6432_Ant_IF,0,2,0,0,0,2
GTGGAGCATGTCGGCC-1_Br6432_Ant_IF,1,6,0,0,0,7
ACTCTTCAGCTCCCGC-1_Br6432_Ant_IF,0,0,1,1,0,2
CCCGATAGCCTCGCCT-1_Br6432_Ant_IF,0,0,2,2,0,4
AATCTCTACTGTGGTT-1_Br6432_Ant_IF,0,0,0,0,1,1
CGCCAAGAAGCCGAGT-1_Br6432_Ant_IF,4,2,3,0,0,9
GGTACATCTGGGACGA-1_Br6432_Ant_IF,6,1,1,0,2,10
GGATGCTGGCGTTCCT-1_Br6432_Ant_IF,3,1,1,0,2,7
CCGATTCGAGGGACCC-1_Br6432_Ant_IF,3,0,0,0,2,5
CCACTGGTGGCTGGTT-1_Br6432_Ant_IF,2,0,0,0,0,2
GACAGGCACACACTAT-1_Br6432_Ant_IF,0,0,0,0,2,2
TCAACGCGACCGGCAG-1_Br6432_Ant_IF,3,0,2,0,1,6
CTACGACTAGCTATAA-1_Br6432_Ant_IF,0,0,0,0,2,2
CGGTTGACCTGGCATA-1_Br6432_Ant_IF,1,3,5,0,3,12
ATCCTGAATCGCTGCG-1_Br6432_Ant_IF,0,3,0,0,1,4
GTTTCATATCGTCGCT-1_Br6432_Ant_IF,0,12,0,0,4,16
ATAAATATTAGCAGCT-1_Br6432_Ant_IF,1,7,0,0,4,12
AAGAGGATGTACGCGA-1_Br6432_Ant_IF,2,0,0,0,0,2
TCCTGCGTTGATACTC-1_Br6432_Ant_IF,3,0,0,0,2,5
CGTGCATTGTCGACGC-1_Br6432_Ant_IF,1,0,1,0,1,3
CCGGGTTCGAGGTTAC-1_Br6432_Ant_IF,4,0,1,0,1,6
CCCAATTTCACAACTT-1_Br6432_Ant_IF,2,0,1,0,0,3
TGATTTATTAGCTGTG-1_Br6432_Ant_IF,2,2,0,0,0,4
TGGAAGAAGGGAACGT-1_Br6432_Ant_IF,4,0,1,0,0,5
GACGCTTGCTTCTAAA-1_Br6432_Ant_IF,0,0,0,0,1,1
GGGAACGGGAGGTTAG-1_Br6432_Ant_IF,1,1,0,0,0,2
GCGGCTCTGACGTACC-1_Br6432_Ant_IF,1,0,0,0,1,2
ACGTTAGATTTGCCCG-1_Br6432_Ant_IF,0,0,1,0,0,1
GAGAGGGCGCGAGGTT-1_Br6432_Ant_IF,2,0,1,0,1,4
GCGTCTCTGCATTGGG-1_Br6432_Ant_IF,2,0,0,0,0,2
GCAGCACACAGCCCAG-1_Br6432_Ant_IF,2,0,0,0,0,2
CAGGCCGTTTGGGTGT-1_Br6432_Ant_IF,1,0,1,0,0,2
AACTCAAGTTAATTGC-1_Br6432_Ant_IF,0,1,0,0,0,1
CTTCGTAGATAGGTGA-1_Br6432_Ant_IF,4,0,1,0,0,5
TGCAGAGTACCGAGCA-1_Br6432_Ant_IF,1,0,0,0,0,1
GAAGTGATTTATCGTG-1_Br6432_Ant_IF,2,0,1,0,1,4
CGCTACGGGACATTTA-1_Br6432_Ant_IF,2,0,0,0,1,3
CCACACTGAGATATTA-1_Br6432_Ant_IF,2,0,0,0,0,2
CGATCCGACCCAGTGC-1_Br6432_Ant_IF,3,0,0,0,0,3
CTGTACTTCTTAGCAT-1_Br6432_Ant_IF,3,1,0,0,0,4
ACTTATTAGGATCGGT-1_Br6432_Ant_IF,2,0,0,0,1,3
TAGTCCGCAGAGAATG-1_Br6432_Ant_IF,2,0,0,0,0,2
TTCACGAAAGGATCAC-1_Br6432_Ant_IF,6,0,0,0,0,6
TACATTTCTAACGTGC-1_Br6432_Ant_IF,0,0,1,0,0,1
ACCATATCCGCAATAA-1_Br6432_Ant_IF,3,0,1,0,0,4
CACTCAAGAGCTATGG-1_Br6432_Ant_IF,1,1,0,0,0,2
TGTACGAACAAATCCG-1_Br6432_Ant_IF,2,0,0,1,0,3
ATCATCCAATATTTGT-1_Br6432_Ant_IF,2,1,1,3,0,7
CGCTATTCTTAGGCTC-1_Br6432_Ant_IF,4,0,0,0,0,4
TGGCAGCAGTAATAGT-1_Br6432_Ant_IF,4,0,0,0,0,4
TCACGTGCCCGATTCA-1_Br6432_Ant_IF,4,0,1,0,0,5
CATACGGCGTCTGGGC-1_Br6432_Ant_IF,2,0,0,0,0,2
CACATGATTCAGCAAC-1_Br6432_Ant_IF,5,0,1,1,0,7
GCTAGTAGAGCTTGTA-1_Br6432_Ant_IF,2,0,0,0,0,2
TGCTGTTGAAGAACTC-1_Br6432_Ant_IF,1,0,1,0,0,2
CGGAGCATGGCGATCC-1_Br6432_Ant_IF,0,0,1,1,0,2
TAGCGTTGGGTCTTAC-1_Br6432_Ant_IF,1,0,0,0,0,1
GTAGCGGCTATACACT-1_Br6432_Ant_IF,7,0,0,1,0,8
TAACATACAATGTGGG-1_Br6432_Ant_IF,2,0,0,0,0,2
TCTTCGAATAGACGTT-1_Br6432_Ant_IF,2,0,0,0,0,2
GATCGTGACTGATATC-1_Br6432_Ant_IF,1,1,0,0,0,2
GATCCGGGAATTAACA-1_Br6432_Ant_IF,1,1,0,0,1,3
TTATATACGCTGTCAC-1_Br6432_Ant_IF,2,0,1,0,2,5
GTCGCGTAACCCGTTG-1_Br6432_Ant_IF,2,1,0,0,0,3
AGCTCTAGACGTTCCA-1_Br6432_Ant_IF,0,1,0,0,1,2
GTCAAGCGGACTCGGG-1_Br6432_Ant_IF,2,2,0,0,2,6
CGAGGGACTGCGGTCG-1_Br6432_Ant_IF,4,3,1,1,1,10
AATCGCCTCAGCGCCA-1_Br6432_Ant_IF,0,1,0,0,1,2
CTTGTTGCTGAGTCAA-1_Br6432_Ant_IF,1,0,0,0,0,1
GATATGAGACACTAAC-1_Br6432_Ant_IF,0,0,0,0,0,0
TTATGATCTTAACGAA-1_Br6432_Ant_IF,1,0,0,0,0,1
CGCCGCCCATGCCTGT-1_Br6432_Ant_IF,1,0,1,0,3,5
CTGGGATAAATAATGG-1_Br6432_Ant_IF,1,0,1,0,1,3
GTGCCCGTTCGGATTC-1_Br6432_Ant_IF,2,0,1,0,0,3
TTCAATACTCTGAATC-1_Br6432_Ant_IF,1,0,0,0,0,1
CGCACATGTCCACTAC-1_Br6432_Ant_IF,0,0,1,0,2,3
AGAAGAGCGCCGTTCC-1_Br6432_Ant_IF,2,0,1,0,0,3
GATAACTCGCACTGTG-1_Br6432_Ant_IF,2,0,1,0,0,3
AGTCGACGGTCTCAAG-1_Br6432_Ant_IF,0,1,1,0,0,2
GTGACCGCACACTACG-1_Br6432_Ant_IF,1,3,1,0,0,5
GTATGTGGGTCTAGTT-1_Br6432_Ant_IF,2,0,1,0,2,5
CTTGAGTTAGGGTAAT-1_Br6432_Ant_IF,3,0,0,0,0,3
TTAGCTGATTTGCCGT-1_Br6432_Ant_IF,0,0,0,0,0,0
GCTGTTGCTACCGAAC-1_Br6432_Ant_IF,0,0,0,0,0,0
TATTACCATCCTGCTT-1_Br6432_Ant_IF,2,3,0,0,0,5
TTGAATTCACGTGAGG-1_Br6432_Ant_IF,1,1,2,0,0,4
CCATCTCACCAGTGAA-1_Br6432_Ant_IF,3,0,0,0,1,4
CGCACGTGCGCTATCA-1_Br6432_Ant_IF,2,0,1,0,1,4
ACCCGGATGACGCATC-1_Br6432_Ant_IF,3,0,0,0,2,5
CGCTAGAGACCGCTGC-1_Br6432_Ant_IF,2,0,0,0,1,3
ATAGTTCCACCCACTC-1_Br6432_Ant_IF,1,0,1,0,0,2
GCAGACCCAGCACGTA-1_Br6432_Ant_IF,2,0,0,0,3,5
TAGACTACCTAGCGTT-1_Br6432_Ant_IF,0,0,0,0,0,0
GGTTCTACTCGTCTGA-1_Br6432_Ant_IF,2,1,0,0,0,3
GACTCACCCACGTGAG-1_Br6432_Ant_IF,1,1,0,0,0,2
AGCTCTTCGTAACCTT-1_Br6432_Ant_IF,6,3,0,0,0,9
ACTATCCAGGGCATGG-1_Br6432_Ant_IF,0,1,1,0,0,2
AAGGATCGATCGCTTG-1_Br6432_Ant_IF,2,1,0,0,1,4
ATATCGGTAGGGAGAT-1_Br6432_Ant_IF,3,1,0,0,1,5
TTCCAGACGAGATTTA-1_Br6432_Ant_IF,0,1,1,0,0,2
GACCGACGTGAAAGCA-1_Br6432_Ant_IF,1,0,0,0,0,1
CCTGGAAACGTTCTGC-1_Br6432_Ant_IF,0,1,1,0,1,3
CCGGTAATGGCTAGTC-1_Br6432_Ant_IF,2,1,0,0,1,4
GCCGTGGAAGAAATGT-1_Br6432_Ant_IF,3,0,0,0,1,4
GTCTTGAGGAGCAGTG-1_Br6432_Ant_IF,0,0,0,1,1,2
TCCCAAAGCCCTAAAT-1_Br6432_Ant_IF,0,0,1,2,0,3
TTGAGCGCCACGTGAT-1_Br6432_Ant_IF,0,0,1,2,1,4
TTGAGTCCCGCTGCTG-1_Br6432_Ant_IF,0,0,1,1,0,2
ATGGAACCTTTGCACA-1_Br6432_Ant_IF,1,2,3,1,0,7
GCTAGCACCTGGGCCA-1_Br6432_Ant_IF,0,0,0,2,0,2
CGCCGTCTACCCATCG-1_Br6432_Ant_IF,0,3,1,6,0,10
GATAGGTGTCCCGGGC-1_Br6432_Ant_IF,0,0,2,1,0,3
AGGTATGCGGACATTA-1_Br6432_Ant_IF,0,0,0,0,0,0
TTGGTTCGCTCAAAGG-1_Br6432_Ant_IF,0,0,7,1,1,9
TCTGGAGCGTAAGAGT-1_Br6432_Ant_IF,0,1,1,0,2,4
TGCCTAAATTTAATAG-1_Br6432_Ant_IF,0,0,0,0,0,0
TTCAGGCGTCAAAGCC-1_Br6432_Ant_IF,0,0,0,0,0,0
AGAGATCTCTAAAGCG-1_Br6432_Ant_IF,4,0,0,0,1,5
CCCTGCCCAATCCGCT-1_Br6432_Ant_IF,1,0,0,0,1,2
GTGGCGGTCCCAGCGT-1_Br6432_Ant_IF,1,2,0,0,0,3
GCATTGTAATTCATAT-1_Br6432_Ant_IF,6,1,0,0,2,9
CCGTTCCGAATCTCGG-1_Br6432_Ant_IF,0,1,0,0,1,2
AGCTTGATCTTAACTT-1_Br6432_Ant_IF,0,2,0,0,5,7
CCTGTACTCACGCCCA-1_Br6432_Ant_IF,3,3,0,0,3,9
AAGTGACGACCGAATT-1_Br6432_Ant_IF,0,4,1,0,4,9
CTCACTTGGCTGGTAA-1_Br6432_Ant_IF,2,8,1,0,5,16
CGCCTGGCCTACGTAA-1_Br6432_Ant_IF,1,0,0,0,3,4
CCCGTAAGTCTAGGCC-1_Br6432_Ant_IF,1,0,1,0,1,3
TTGGACATGTGGCTTA-1_Br6432_Ant_IF,4,0,0,0,0,4
ATTACGCGCTGGCAGG-1_Br6432_Ant_IF,2,1,1,0,0,4
ACGCGCTACACAGGGT-1_Br6432_Ant_IF,2,0,3,0,1,6
TACGTTTACCGGCAAT-1_Br6432_Ant_IF,4,1,0,1,1,7
CGAAACGCAATTCATG-1_Br6432_Ant_IF,1,0,0,0,0,1
TAGTCTAACAACGAGA-1_Br6432_Ant_IF,2,0,0,0,0,2
TTGCATGCTGATCACG-1_Br6432_Ant_IF,3,0,0,0,1,4
TCTGGGTAGCGCTCAT-1_Br6432_Ant_IF,2,1,0,0,0,3
ACATCGGTCAGCCGCG-1_Br6432_Ant_IF,1,0,1,0,0,2
AGATACCGGTGTTCAC-1_Br6432_Ant_IF,0,1,0,0,0,1
GATTACTGAATTTGGG-1_Br6432_Ant_IF,1,0,1,0,0,2
TCCAACTTTAAATTCT-1_Br6432_Ant_IF,2,0,0,0,1,3
TCCTAGCAAAGAAGCT-1_Br6432_Ant_IF,1,1,1,0,0,3
GTCTATCTGAGTTTCT-1_Br6432_Ant_IF,2,0,0,0,3,5
GATGTTCAATCCACGA-1_Br6432_Ant_IF,0,1,1,0,0,2
AGTTAAACACTTGCGA-1_Br6432_Ant_IF,1,0,0,0,1,2
AGCTCTTTACTCAGTT-1_Br6432_Ant_IF,1,1,0,0,2,4
ATCCAGGATTCGTGAA-1_Br6432_Ant_IF,2,0,1,1,1,5
AGTCAACACCACCATC-1_Br6432_Ant_IF,1,0,0,0,1,2
CGATACCTCGCGGACA-1_Br6432_Ant_IF,1,1,1,0,1,4
TACAACGCACAACTCA-1_Br6432_Ant_IF,2,1,1,0,2,6
AATTAAAGGTCGGCGT-1_Br6432_Ant_IF,1,0,0,0,3,4
TACGCAGTTCTTTCCT-1_Br6432_Ant_IF,2,0,1,0,1,4
GACCGTGCTGACGGTG-1_Br6432_Ant_IF,4,0,0,0,0,4
GGCAAATTACTTTACT-1_Br6432_Ant_IF,2,1,1,0,1,5
GGTACAAACATGCTAT-1_Br6432_Ant_IF,1,2,0,0,0,3
CGGGCCTTCTTTGTAA-1_Br6432_Ant_IF,2,0,1,0,0,3
CGTGAAGTTAATTCAC-1_Br6432_Ant_IF,0,0,1,0,0,1
ATAGTGAAGCGTTCTC-1_Br6432_Ant_IF,1,0,0,0,0,1
TACGCCATATTCTAAT-1_Br6432_Ant_IF,4,0,0,0,0,4
GCCGGGTTAGGGTCGC-1_Br6432_Ant_IF,5,1,0,0,0,6
TACATAGGCATACACC-1_Br6432_Ant_IF,3,0,0,0,0,3
GCCGATTGGCCAAGCT-1_Br6432_Ant_IF,1,0,0,1,0,2
CTGCCATGCATCACAT-1_Br6432_Ant_IF,1,0,0,0,0,1
TTATGAATGAAAGGGA-1_Br6432_Ant_IF,0,0,0,0,0,0
GCTGAGGCGTGAGTAT-1_Br6432_Ant_IF,3,0,0,1,0,4
GCGCCGTTCCACGATA-1_Br6432_Ant_IF,2,0,0,0,0,2
CGCATGGTGCGATGCT-1_Br6432_Ant_IF,4,1,0,0,0,5
AGGTTTCACACACCTT-1_Br6432_Ant_IF,1,1,0,1,0,3
CAAGGATCGCATGTTC-1_Br6432_Ant_IF,0,0,0,0,0,0
ACGTTAATGTCGAAGA-1_Br6432_Ant_IF,6,1,0,0,0,7
TCCAGAGCACCGGTTC-1_Br6432_Ant_IF,3,0,0,0,0,3
GATTCGACGGTTCACG-1_Br6432_Ant_IF,0,2,1,0,0,3
GTTTCTGCAGTCTCCC-1_Br6432_Ant_IF,5,2,0,0,0,7
GCTGCACGGTTTCTTA-1_Br6432_Ant_IF,3,0,1,0,0,4
CGTGCAGACTGGGACA-1_Br6432_Ant_IF,5,1,1,0,3,10
GTGTTACTATGCGTCC-1_Br6432_Ant_IF,5,0,0,0,1,6
TCCTCGGGCTGGGCTT-1_Br6432_Ant_IF,1,0,0,0,1,2
GTGAGGACACTTAAGG-1_Br6432_Ant_IF,5,0,1,0,0,6
ATACGCCGGCGAAACC-1_Br6432_Ant_IF,2,1,0,0,2,5
TCTGCCAGAAACTGCA-1_Br6432_Ant_IF,1,1,0,0,1,3
TTCTGCGGGTTAGCGG-1_Br6432_Ant_IF,2,0,1,0,1,4
CTCGGTACCACTGCTC-1_Br6432_Ant_IF,1,0,0,0,1,2
GTAAGTAACAGTCTGG-1_Br6432_Ant_IF,3,0,1,0,0,4
GTGCGTGTATATGAGC-1_Br6432_Ant_IF,0,0,1,0,0,1
ATTTGTCTTGGGAGCT-1_Br6432_Ant_IF,2,0,0,0,0,2
CCTCGGACCGGGATAG-1_Br6432_Ant_IF,2,0,0,0,0,2
TAGGTGCTCGCCTAGC-1_Br6432_Ant_IF,1,0,2,0,1,4
CTTTAGGAACACTGTT-1_Br6432_Ant_IF,3,0,0,0,0,3
TCGGGCCGTCGTGGTA-1_Br6432_Ant_IF,2,0,1,0,1,4
AGTGCTTGCACGAATA-1_Br6432_Ant_IF,1,2,1,0,0,4
TGCAGTTTCCTCCCAT-1_Br6432_Ant_IF,1,1,2,0,2,6
TGAGAGATTTACCACG-1_Br6432_Ant_IF,1,0,0,0,0,1
GAAACAGATGACCACC-1_Br6432_Ant_IF,2,0,0,0,1,3
AGCAACATATCTTATT-1_Br6432_Ant_IF,2,0,1,0,1,4
CAAGTGTGGTTGCAAA-1_Br6432_Ant_IF,0,0,0,0,0,0
GCCTCATCTGGAAATA-1_Br6432_Ant_IF,2,0,3,0,0,5
AACCCTACTGTCAATA-1_Br6432_Ant_IF,2,2,0,0,1,5
ACGTATTACTCCGATC-1_Br6432_Ant_IF,2,0,1,0,1,4
TCTGGGAACCTTTGAA-1_Br6432_Ant_IF,2,1,2,0,1,6
GCTCGCTCATGTCCAA-1_Br6432_Ant_IF,3,1,1,0,0,5
GCGCAAGAGCGCGCTG-1_Br6432_Ant_IF,1,0,1,0,0,2
TTGACGCTCCATGAGC-1_Br6432_Ant_IF,3,1,1,0,0,5
TATAGATGGTCGCAGT-1_Br6432_Ant_IF,2,0,0,0,1,3
TTACATGCCACAACTA-1_Br6432_Ant_IF,0,2,1,0,1,4
ACATGGCGCCAAAGTA-1_Br6432_Ant_IF,1,0,1,0,1,3
TATGGTTAGTGGGAGA-1_Br6432_Ant_IF,2,0,0,0,1,3
CATGACTTCGCTGAAT-1_Br6432_Ant_IF,5,1,0,0,0,6
ACCACCAATGTAACAA-1_Br6432_Ant_IF,1,0,0,0,0,1
TCTTAGAGCTCCAATT-1_Br6432_Ant_IF,2,2,1,0,1,6
CCACGAATTTAACCTC-1_Br6432_Ant_IF,0,0,3,0,1,4
TTCTTGCTAGCATCTC-1_Br6432_Ant_IF,1,0,0,0,0,1
ACACCTTACTACTTGC-1_Br6432_Ant_IF,4,0,2,0,0,6
AGTCGGTTGCGTGAGA-1_Br6432_Ant_IF,0,0,1,0,0,1
ACCTACAGTATGTGGT-1_Br6432_Ant_IF,1,1,0,0,0,2
GAGGATAAACAGTGCT-1_Br6432_Ant_IF,2,1,1,0,1,5
TTCCGGTATCTGTGTC-1_Br6432_Ant_IF,0,1,1,0,3,5
GGAGGCCGAAGTCGTC-1_Br6432_Ant_IF,1,1,0,0,1,3
TTCGCTAGGAAGTTGT-1_Br6432_Ant_IF,0,1,1,1,1,4
TAAAGACAACCCTTTA-1_Br6432_Ant_IF,0,1,1,0,1,3
GTTGCGCTAACATTAC-1_Br6432_Ant_IF,0,2,0,0,2,4
GCTGAACTCTCCAGGG-1_Br6432_Ant_IF,0,1,2,1,0,4
AGCCCTGTCGCACCGT-1_Br6432_Ant_IF,0,1,1,1,1,4
AGCGCTAGAGCGATGT-1_Br6432_Ant_IF,0,0,1,1,0,2
TGCGCCGTTAATAACG-1_Br6432_Ant_IF,0,3,1,1,0,5
TGACAACGCATGTCGC-1_Br6432_Ant_IF,0,1,2,1,0,4
CGTCTTGAGTGTGACG-1_Br6432_Ant_IF,0,3,0,0,1,4
GATAGGATTAATTACA-1_Br6432_Ant_IF,0,0,0,0,0,0
AAACAGCTTTCAGAAG-1_Br6432_Ant_IF,0,0,0,0,0,0
CTTATGCGCTCAGGGC-1_Br6432_Ant_IF,3,2,1,0,1,7
ACAATAGTCGTACGTT-1_Br6432_Ant_IF,1,0,0,0,0,1
CATGCCAACTCGCAAA-1_Br6432_Ant_IF,2,6,2,0,0,10
TGCAGAACTATATCGT-1_Br6432_Ant_IF,1,9,0,0,4,14
TCGTGTCACGCTGACA-1_Br6432_Ant_IF,0,8,0,0,3,11
TGATCAGGGAACTGCT-1_Br6432_Ant_IF,0,8,0,0,3,11
CTTGCAACCGCCTCCT-1_Br6432_Ant_IF,0,0,0,0,2,2
AGCCCATACATGTAAG-1_Br6432_Ant_IF,1,2,0,0,4,7
ATCCAATGGAGGGTCC-1_Br6432_Ant_IF,1,0,0,0,0,1
AAACCGGGTAGGTACC-1_Br6432_Ant_IF,4,0,1,0,0,5
GCAACCACGGCCGCGT-1_Br6432_Ant_IF,4,1,0,0,2,7
CGCTTATTCCCGGTCG-1_Br6432_Ant_IF,1,0,2,0,1,4
TTACTCTGGTACGTAC-1_Br6432_Ant_IF,2,0,0,0,0,2
GTGGTTTCCGCCTTTC-1_Br6432_Ant_IF,1,0,2,0,2,5
ATAGGCGGCTATAGAA-1_Br6432_Ant_IF,2,0,2,0,1,5
GTGCCATCACACGGTG-1_Br6432_Ant_IF,2,0,0,0,1,3
CCCAACATACGTCGCG-1_Br6432_Ant_IF,2,0,1,0,0,3
CGGTGCAGATAGAACG-1_Br6432_Ant_IF,3,0,0,0,0,3
GGGCGGGTTCCCTACG-1_Br6432_Ant_IF,0,1,0,0,0,1
TGAGCCATACAGTCTC-1_Br6432_Ant_IF,0,0,1,0,0,1
CTCCGCCCACATGAGG-1_Br6432_Ant_IF,3,0,0,0,0,3
GTTGAACCGGTTCCAT-1_Br6432_Ant_IF,4,2,0,0,0,6
TTGACTACCATATGGT-1_Br6432_Ant_IF,0,0,2,0,1,3
ACCATCGTATATGGTA-1_Br6432_Ant_IF,2,0,0,0,2,4
TGCGTAAGAACCTGAT-1_Br6432_Ant_IF,4,0,2,0,0,6
AGAAGGTTGCCGAATT-1_Br6432_Ant_IF,3,0,2,0,0,5
AGGACGACCCATTAGA-1_Br6432_Ant_IF,1,0,0,0,0,1
GGTGCTGGTACACATT-1_Br6432_Ant_IF,1,0,1,0,1,3
GCGCTATGCCGAGGCA-1_Br6432_Ant_IF,0,0,0,0,0,0
ACCCGGTTACACTTCC-1_Br6432_Ant_IF,0,1,0,0,1,2
TAACTCATCCGCGCGG-1_Br6432_Ant_IF,1,0,0,0,0,1
CACAATGAGCTGCTAT-1_Br6432_Ant_IF,1,0,0,0,1,2
GTTACTTTGGGCCTAG-1_Br6432_Ant_IF,0,0,1,0,2,3
GGGCCCGTCTTAAACA-1_Br6432_Ant_IF,2,0,0,0,2,4
GAAATTGTCTCTATAA-1_Br6432_Ant_IF,4,0,0,0,3,7
GGCGCATGAATTGATG-1_Br6432_Ant_IF,2,0,0,0,1,3
CATATAGGTACAGTCA-1_Br6432_Ant_IF,2,1,0,0,2,5
TCAACGAGGAGACAAA-1_Br6432_Ant_IF,2,1,0,0,0,3
TTGCACAATTCAGAAA-1_Br6432_Ant_IF,2,2,0,0,0,4
CATCGGACGGGTTAAT-1_Br6432_Ant_IF,4,0,0,0,1,5
ATTAAACATGCGGACC-1_Br6432_Ant_IF,1,2,1,0,0,4
TATCTACCACAGCGGG-1_Br6432_Ant_IF,5,1,0,0,1,7
CGAGACCCTAGAGTGT-1_Br6432_Ant_IF,2,0,0,0,0,2
ACATCGATCGTTTACC-1_Br6432_Ant_IF,0,1,0,0,0,1
ATCGACCCAATACAGA-1_Br6432_Ant_IF,4,1,0,0,0,5
GAATCTGAACATTCTC-1_Br6432_Ant_IF,2,1,0,0,0,3
AGTTCCTATTTATGTT-1_Br6432_Ant_IF,3,0,0,0,0,3
CAGTCTGTATACTGGG-1_Br6432_Ant_IF,0,0,0,3,0,3
GGAGACGACACCTTTG-1_Br6432_Ant_IF,0,0,0,1,0,1
CCTAAATTAACGGTTC-1_Br6432_Ant_IF,5,0,0,0,0,5
GCTACGACTTATTGGG-1_Br6432_Ant_IF,5,0,0,0,0,5
CTGTGCAGGGTAGGTC-1_Br6432_Ant_IF,2,2,0,0,0,4
ACGCCGCTAGACGACC-1_Br6432_Ant_IF,4,0,0,0,0,4
ACTTGACTCCCTCTTT-1_Br6432_Ant_IF,2,1,0,0,0,3
CGCCTCCCTCCTCTAT-1_Br6432_Ant_IF,1,0,1,3,0,5
CTAGATTTACGACGGC-1_Br6432_Ant_IF,1,0,2,0,0,3
GATGCTGTATTTCATC-1_Br6432_Ant_IF,3,1,1,0,0,5
TGCGTTTGTTGACACT-1_Br6432_Ant_IF,1,0,0,0,0,1
CGTGCCCTCCCGAAGA-1_Br6432_Ant_IF,5,1,2,0,0,8
ACTCTCTGACTTAGGT-1_Br6432_Ant_IF,4,2,0,0,1,7
CTGGGTAGGCAGTTAA-1_Br6432_Ant_IF,5,0,0,0,0,5
GTTTGGCCCAAGTTAT-1_Br6432_Ant_IF,2,1,0,0,0,3
GAATGTGGTCCGGATT-1_Br6432_Ant_IF,2,0,3,0,2,7
CCCAGTTAAGGCGCCG-1_Br6432_Ant_IF,2,0,0,0,0,2
CGGTACTAGAATCAAA-1_Br6432_Ant_IF,3,0,1,0,1,5
GCTTAATGTAACTAAC-1_Br6432_Ant_IF,1,1,0,0,0,2
AGGACAGTCGAATCCC-1_Br6432_Ant_IF,3,0,1,0,1,5
GACAGCCAGACCTGAC-1_Br6432_Ant_IF,2,0,0,0,3,5
GGCGAAATCTAACTTG-1_Br6432_Ant_IF,0,1,1,0,2,4
CTGGTAACACATAGAA-1_Br6432_Ant_IF,2,1,2,0,1,6
TAGCCATTTCAAAGTC-1_Br6432_Ant_IF,6,0,0,0,0,6
GGGATTTACCGCACCT-1_Br6432_Ant_IF,0,2,0,0,2,4
ATGCCATTTGCGACCA-1_Br6432_Ant_IF,0,0,0,0,0,0
GAATAGACGCGACCCA-1_Br6432_Ant_IF,0,0,3,0,1,4
TGTATGGCGCAGACAG-1_Br6432_Ant_IF,3,0,0,0,0,3
GGATGAAGATCGCTGA-1_Br6432_Ant_IF,1,0,0,0,0,1
CGACAATTTGATCTAA-1_Br6432_Ant_IF,4,1,0,0,0,5
AAAGTTGACTCCCGTA-1_Br6432_Ant_IF,0,0,0,0,1,1
CGCGGCTCAACTTGAA-1_Br6432_Ant_IF,3,0,0,0,1,4
CACGCGGAACTGTTGC-1_Br6432_Ant_IF,0,0,1,0,0,1
TCTTAGAGTGAACTCT-1_Br6432_Ant_IF,1,1,0,0,0,2
AGTCCATTGGCTGATG-1_Br6432_Ant_IF,4,0,1,0,1,6
TTAAGATAGGATTGAC-1_Br6432_Ant_IF,5,1,2,0,0,8
ACATCCTGGTAACTGT-1_Br6432_Ant_IF,1,1,1,0,1,4
CACCTTGGCGCCTTTG-1_Br6432_Ant_IF,3,1,1,0,0,5
GCTAGACCGTCTACTG-1_Br6432_Ant_IF,2,0,0,0,2,4
CGGCCCAGGTATATCC-1_Br6432_Ant_IF,3,1,1,0,0,5
GTCCATTACTGCTACG-1_Br6432_Ant_IF,4,2,0,0,1,7
GGGTTTAGGATAGGAT-1_Br6432_Ant_IF,5,1,2,0,2,10
TAATTAGGACATCCGT-1_Br6432_Ant_IF,0,1,1,0,2,4
GCTCCCAGTCGGTCCA-1_Br6432_Ant_IF,2,1,2,0,1,6
ATTCGTGCTATCTCTT-1_Br6432_Ant_IF,3,4,0,0,1,8
GTTAACTATGTTGTCA-1_Br6432_Ant_IF,3,0,0,0,0,3
GCTCCGCTCGCTTCAG-1_Br6432_Ant_IF,0,0,0,0,2,2
GCAACGGCTAGTTATG-1_Br6432_Ant_IF,0,1,0,0,0,1
AATCGCGCAGAGGACT-1_Br6432_Ant_IF,0,0,0,2,1,3
AGGTTACACCATGCCG-1_Br6432_Ant_IF,2,0,2,1,2,7
CGAGATTTCGCTCGGG-1_Br6432_Ant_IF,3,0,1,0,0,4
CGATAATACTCAGGTT-1_Br6432_Ant_IF,4,0,1,1,1,7
AAGGCAGGCTGTCTCC-1_Br6432_Ant_IF,2,1,0,1,1,5
GTAAGTCCACACTCTA-1_Br6432_Ant_IF,3,0,0,1,2,6
ATGAGGGCAGCGGCTA-1_Br6432_Ant_IF,1,1,0,1,0,3
GCCGCACTCCGTTTCA-1_Br6432_Ant_IF,2,2,1,0,0,5
GAGCACGGCGCCTCTT-1_Br6432_Ant_IF,1,0,0,1,0,2
ACAATTTGGCCATATT-1_Br6432_Ant_IF,0,1,0,0,1,2
CTGGTTCGCGAGCTAC-1_Br6432_Ant_IF,0,5,0,0,0,5
GACAGATTTCTGGCTC-1_Br6432_Ant_IF,2,0,0,0,0,2
ACTTGTAGTCCCTTCA-1_Br6432_Ant_IF,0,0,1,0,0,1
TGACGAATATTTCCCT-1_Br6432_Ant_IF,0,0,0,0,0,0
TAGAGATCATGCAACT-1_Br6432_Ant_IF,4,0,0,0,2,6
TTGTTTCCATACAACT-1_Br6432_Ant_IF,1,1,0,0,1,3
GAGAGGTGCATTCTGG-1_Br6432_Ant_IF,1,0,0,0,2,3
GTGGACCAACCCGATT-1_Br6432_Ant_IF,4,0,2,1,0,7
CTGGGCCTGCTATATC-1_Br6432_Ant_IF,5,0,0,0,1,6
CATAGTCCACAAGAAC-1_Br6432_Ant_IF,5,0,1,0,0,6
TTGACATGAACGTGGA-1_Br6432_Ant_IF,1,0,1,0,0,2
GGTTACCACCCTCGGG-1_Br6432_Ant_IF,3,0,0,0,0,3
TACCGGTCGTTTCCAT-1_Br6432_Ant_IF,1,0,0,0,0,1
CGAGTACTAAAGAGGA-1_Br6432_Ant_IF,3,0,2,0,1,6
GCAAGAATTCCTTGGC-1_Br6432_Ant_IF,2,0,0,0,2,4
TCGCCGAAGTTGCGTC-1_Br6432_Ant_IF,3,0,0,0,0,3
TTGAGAGTACTGCTAA-1_Br6432_Ant_IF,3,1,2,0,0,6
GCCACAATTTAAGGAC-1_Br6432_Ant_IF,4,0,1,0,1,6
ATATTCAGTTAAACCT-1_Br6432_Ant_IF,1,0,4,0,1,6
TGAGTGCCTCTTAAAT-1_Br6432_Ant_IF,1,0,0,0,0,1
ATCAGACGGCACGCCG-1_Br6432_Ant_IF,3,1,0,0,1,5
GTGCGAAATCGAACAC-1_Br6432_Ant_IF,1,0,1,0,0,2
GTGCCGCTTCAAAGGT-1_Br6432_Ant_IF,0,0,0,0,1,1
GATACGATGGGAGTCA-1_Br6432_Ant_IF,1,0,0,0,1,2
GACACTGAGTTCAGTG-1_Br6432_Ant_IF,2,0,0,0,0,2
ATCCTGCGTGGAATGG-1_Br6432_Ant_IF,0,0,1,0,2,3
ATCCTACCTAAGCTCT-1_Br6432_Ant_IF,0,0,1,0,1,2
AGTGATATGAGTAGTT-1_Br6432_Ant_IF,3,1,0,0,0,4
ATGATGCAATGGTACA-1_Br6432_Ant_IF,3,0,0,0,1,4
GAAACCGAATTACCTT-1_Br6432_Ant_IF,0,0,1,0,1,2
AGTGACCTACTTTACG-1_Br6432_Ant_IF,1,2,0,0,0,3
CAAATGTCCTTCCGTG-1_Br6432_Ant_IF,1,0,0,0,1,2
TTACTGGGATATTTCA-1_Br6432_Ant_IF,1,0,0,0,1,2
CTTGCCCAGGCTCTAC-1_Br6432_Ant_IF,5,0,0,0,0,5
AAATCGTGTACCACAA-1_Br6432_Ant_IF,4,0,0,0,1,5
GTGATCATAGATCTGC-1_Br6432_Ant_IF,2,0,0,0,1,3
TGGCAGATTACGATCA-1_Br6432_Ant_IF,4,1,1,0,0,6
TCACCCTCTTAAGATT-1_Br6432_Ant_IF,3,0,0,0,0,3
CAGGATATATCGTTGT-1_Br6432_Ant_IF,4,1,2,0,0,7
CCTGACCACCGATGGT-1_Br6432_Ant_IF,2,1,0,0,0,3
CTAAAGGGAAATAGGA-1_Br6432_Ant_IF,4,1,0,0,0,5
CCGCTATCAGCACCAG-1_Br6432_Ant_IF,1,2,0,0,0,3
CTTTAGTGCTATTATT-1_Br6432_Ant_IF,0,1,0,0,0,1
CGGGAATTTATGTAAA-1_Br6432_Ant_IF,2,0,0,0,0,2
TACGACTGCCTCTTAG-1_Br6432_Ant_IF,1,0,0,0,0,1
AAACTGCTGGCTCCAA-1_Br6432_Ant_IF,3,6,0,0,1,10
GTACGTTTGCCCGTCA-1_Br6432_Ant_IF,0,0,0,1,0,1
GGCAAGGCGAAATAGC-1_Br6432_Ant_IF,0,0,0,0,0,0
GATCTTGGAGGGCATA-1_Br6432_Ant_IF,1,0,0,0,0,1
AGCGTGGTATTCTACT-1_Br6432_Ant_IF,3,0,1,2,0,6
CTAAGGGAATGATTGG-1_Br6432_Ant_IF,1,1,0,0,0,2
CATGGTAAGTAGCGTT-1_Br6432_Ant_IF,4,0,0,0,0,4
CGTTGAGCGACCGTCG-1_Br6432_Ant_IF,1,1,0,0,0,2
TGCCCGTACCGTTAAA-1_Br6432_Ant_IF,3,1,0,0,0,4
ACAAGGGCAGGCTCTG-1_Br6432_Ant_IF,0,0,1,0,0,1
GAGATCTTCCATGACA-1_Br6432_Ant_IF,2,2,0,0,0,4
AATGACGTAGGATGTC-1_Br6432_Ant_IF,2,0,1,0,0,3
GTGGTGGCCAAGTGAA-1_Br6432_Ant_IF,3,0,0,0,2,5
TCCCGTGTGCAATTTG-1_Br6432_Ant_IF,0,0,0,1,1,2
ACATCGTATGCAATGG-1_Br6432_Ant_IF,3,0,0,0,0,3
GCGAAACTTAACTGGA-1_Br6432_Ant_IF,0,0,1,0,1,2
AATTGAACGCTCTGGT-1_Br6432_Ant_IF,2,0,0,0,1,3
ACAAATGGTAGTGTTT-1_Br6432_Ant_IF,3,1,2,0,2,8
ATGGTCGCGTGGTTTC-1_Br6432_Ant_IF,1,0,0,0,1,2
TGTTATTGTATGTGGC-1_Br6432_Ant_IF,3,0,1,0,1,5
TTCCGGTTACCCACTT-1_Br6432_Ant_IF,3,0,0,0,0,3
GAGTGTGCGGTACCCA-1_Br6432_Ant_IF,1,1,0,0,0,2
CAAGATATTATAACGT-1_Br6432_Ant_IF,0,0,0,0,0,0
ACACACCAGGACCAGT-1_Br6432_Ant_IF,2,0,0,0,2,4
ATGGGCCTCGGCCTCT-1_Br6432_Ant_IF,2,0,2,0,0,4
AAGGTGATAAACCAGC-1_Br6432_Ant_IF,2,0,1,0,1,4
TCTTACTTATGCCTCT-1_Br6432_Ant_IF,1,1,0,0,0,2
AAAGTGTGATTTATCT-1_Br6432_Ant_IF,1,0,1,0,2,4
TGCTCCACAGTTCTTA-1_Br6432_Ant_IF,1,0,1,0,2,4
CTGGCTGATTCATCCT-1_Br6432_Ant_IF,0,1,1,0,2,4
TAAGGCTGAATCCCTC-1_Br6432_Ant_IF,2,0,0,0,0,2
TCTAGTGATATCGTGG-1_Br6432_Ant_IF,3,0,2,0,1,6
TCGAAGAACCGAGCAC-1_Br6432_Ant_IF,2,0,0,0,0,2
GACAAACATATGCAGG-1_Br6432_Ant_IF,3,0,0,0,0,3
AAGTCAATTGTCGTCA-1_Br6432_Ant_IF,3,0,0,0,1,4
AGTGAACAAACTTCTC-1_Br6432_Ant_IF,3,0,0,0,0,3
CATGATGGAAGTTAGC-1_Br6432_Ant_IF,4,0,0,0,0,4
AAGTGCCTTGACTGTA-1_Br6432_Ant_IF,3,1,1,0,5,10
ATCGCCAGTCAACATT-1_Br6432_Ant_IF,2,1,1,0,0,4
ACCGCGGTGGAAGTCG-1_Br6432_Ant_IF,2,0,0,0,0,2
TCTTCTATAACCCGCC-1_Br6432_Ant_IF,1,0,0,0,0,1
CACATTTCTTGTCAGA-1_Br6432_Ant_IF,2,0,3,0,2,7
TAGCGTCCCTCGATTG-1_Br6432_Ant_IF,3,0,3,0,0,6
GTTCGGATCGGGAACA-1_Br6432_Ant_IF,2,0,0,0,2,4
CAAACTCGCGACGCCG-1_Br6432_Ant_IF,2,0,2,0,2,6
GTCTTGTAGCTATTCA-1_Br6432_Ant_IF,1,0,2,0,0,3
TCTCGACGTATCGCCG-1_Br6432_Ant_IF,1,0,1,0,1,3
TTGCCAAGCAGAACCC-1_Br6432_Ant_IF,1,1,0,0,0,2
AAACCCGAACGAAATC-1_Br6432_Ant_IF,0,0,1,0,1,2
TTGAGCAGCCCACGGT-1_Br6432_Ant_IF,2,0,0,0,2,4
CGCCTTTAGCATGCTC-1_Br6432_Ant_IF,0,0,0,0,0,0
TGTGGCTCCCACCAAC-1_Br6432_Ant_IF,2,1,2,0,2,7
CCGCCGTTGAGGATAA-1_Br6432_Ant_IF,2,2,1,0,2,7
CAATACGAGAGTCTGA-1_Br6432_Ant_IF,0,0,0,0,1,1
CATCTAGTGAAGGGAA-1_Br6432_Ant_IF,0,2,3,0,2,7
GGTGGAGGTTGATACG-1_Br6432_Ant_IF,0,4,4,0,1,9
ACGGGAGTGTCGGCCC-1_Br6432_Ant_IF,0,0,2,0,0,2
TTAACTTCAGGTAGGA-1_Br6432_Ant_IF,1,0,0,0,0,1
CCACGGAGCCATAAGA-1_Br6432_Ant_IF,3,0,2,0,4,9
CTTCTATGTTGAAGTA-1_Br6432_Ant_IF,1,0,0,0,1,2
CACCGTTGCGCGATAT-1_Br6432_Ant_IF,0,0,0,0,0,0
TCTAGCAATCTCCGCC-1_Br6432_Ant_IF,2,1,0,0,0,3
AGTTTGGCCAGACCTA-1_Br6432_Ant_IF,3,4,0,0,2,9
TTGTAAGGACCTAAGT-1_Br6432_Ant_IF,1,1,0,0,2,4
AAATTTGCGGGTGTGG-1_Br6432_Ant_IF,3,1,0,0,1,5
AAGTTCGGCCAACAGG-1_Br6432_Ant_IF,1,0,0,0,0,1
CCGCTTACCTCACTCT-1_Br6432_Ant_IF,4,0,1,0,0,5
ATCACGTGCTAATTAA-1_Br6432_Ant_IF,1,0,0,0,0,1
GGTGAAGTACAGGGAT-1_Br6432_Ant_IF,2,0,0,0,0,2
GCTGTATTACTGGCCC-1_Br6432_Ant_IF,1,0,1,0,1,3
AACGGCCATCTCCGGT-1_Br6432_Ant_IF,0,0,0,0,0,0
TAAGTAACATCTTGAC-1_Br6432_Ant_IF,1,0,0,0,1,2
TTCTTGAGCCGCGCTA-1_Br6432_Ant_IF,0,0,0,0,1,1
AGTGCGTAGCTCGTAA-1_Br6432_Ant_IF,0,1,1,0,1,3
GGGATGGTCGTAACCG-1_Br6432_Ant_IF,3,1,1,0,2,7
GTCTGGGCGGTCGAGA-1_Br6432_Ant_IF,0,0,0,0,1,1
CGGAACGTAAACATAG-1_Br6432_Ant_IF,0,0,0,0,0,0
TGCGACACCCTAGTGC-1_Br6432_Ant_IF,1,0,0,0,0,1
CAAACGAGTATCGCAG-1_Br6432_Ant_IF,2,1,0,0,1,4
TCAGTAGGGACTATAA-1_Br6432_Ant_IF,3,1,0,0,1,5
GCGGTTCCCTATCATG-1_Br6432_Ant_IF,2,0,0,0,1,3
GTGACTTCAGTAGTGC-1_Br6432_Ant_IF,1,1,0,0,0,2
CGTCACGTCCATTGGT-1_Br6432_Ant_IF,0,0,0,0,3,3
ATAAGTTACCGCGACG-1_Br6432_Ant_IF,1,0,1,0,0,2
CTGAATCCGAGACCTC-1_Br6432_Ant_IF,2,0,2,0,2,6
TACGACGCTTGCTGCG-1_Br6432_Ant_IF,1,1,1,0,3,6
GAATTCACCCGGGTGT-1_Br6432_Ant_IF,1,0,0,0,3,4
GGGTGACACCTTAACT-1_Br6432_Ant_IF,2,2,1,0,2,7
TGAGTAAATTAGCGTA-1_Br6432_Ant_IF,3,0,0,0,0,3
GAGTCCGCTTACCGGA-1_Br6432_Ant_IF,2,1,0,0,0,3
GGCGCGTTCGAGTTTA-1_Br6432_Ant_IF,3,3,1,0,0,7
ATTCATATACTGTCCA-1_Br6432_Ant_IF,5,0,0,0,0,5
ATAAACGGACCCGTAA-1_Br6432_Ant_IF,2,0,0,0,1,3
GTCGTACCATCTCGGG-1_Br6432_Ant_IF,3,3,1,0,0,7
ATAATAGCTGTTGAAT-1_Br6432_Ant_IF,2,0,0,0,1,3
TTCCGCGTGAGGCGAT-1_Br6432_Ant_IF,2,0,0,0,0,2
TACCGGCTCACTGCCC-1_Br6432_Ant_IF,5,0,0,0,0,5
GTATCTTTCATAACCA-1_Br6432_Ant_IF,5,0,2,1,0,8
GTTACCTACAACTTGC-1_Br6432_Ant_IF,2,0,0,0,0,2
TGACTATAATCCTTTC-1_Br6432_Ant_IF,11,0,2,0,0,13
AAATACCTATAAGCAT-1_Br6432_Ant_IF,4,2,0,2,0,8
TTATTAGAGCGTGTTC-1_Br6432_Ant_IF,0,0,0,0,0,0
ATGTGGACATCTTGAT-1_Br6432_Ant_IF,4,0,0,1,0,5
GTACGCTTCATTGCAC-1_Br6432_Ant_IF,5,1,1,0,0,7
CACATATTAGCAGGAT-1_Br6432_Ant_IF,1,0,0,0,0,1
CAAGAGGGCGGAGTAC-1_Br6432_Ant_IF,2,0,0,0,0,2
TCGCAAAGATGCATTT-1_Br6432_Ant_IF,2,0,0,0,0,2
GTCGTTATTCGCTTAT-1_Br6432_Ant_IF,3,0,1,0,0,4
TCGTGTACTATGGATG-1_Br6432_Ant_IF,3,0,0,0,0,3
GCGGAGAGGGAGAACG-1_Br6432_Ant_IF,3,0,2,0,2,7
TCACAGGGAATCGCAA-1_Br6432_Ant_IF,3,1,0,0,3,7
GACTGCACCAGCCCAG-1_Br6432_Ant_IF,2,0,0,0,1,3
TCCGCTGTCATCCCGG-1_Br6432_Ant_IF,3,0,1,0,1,5
AGATACTCAAGATCGA-1_Br6432_Ant_IF,3,0,1,0,2,6
ACTGAATGGCGAAAGT-1_Br6432_Ant_IF,0,0,1,0,1,2
TCCTACATCCACGGCC-1_Br6432_Ant_IF,0,2,1,1,2,6
TTCAGCCCTGGTCCAC-1_Br6432_Ant_IF,1,1,2,0,1,5
TTAGAGTTTAGAAGGA-1_Br6432_Ant_IF,3,1,0,1,1,6
GGTTAGCTATATGTCT-1_Br6432_Ant_IF,3,1,0,0,0,4
CTGGTTTCGAGCAAGA-1_Br6432_Ant_IF,1,1,0,0,0,2
TGGGCCCATACTAATT-1_Br6432_Ant_IF,0,1,1,0,1,3
ACTTATTTATGTGCCA-1_Br6432_Ant_IF,3,1,2,0,0,6
TTAGTTATTCGTGGCA-1_Br6432_Ant_IF,1,0,2,0,1,4
AACCGCTAAGGGATGC-1_Br6432_Ant_IF,0,0,0,0,0,0
ATACGTCCACTCCTGT-1_Br6432_Ant_IF,3,1,2,0,0,6
CGACACGCTCCGACAG-1_Br6432_Ant_IF,3,2,1,0,1,7
TCTGAACTCGTACCCG-1_Br6432_Ant_IF,4,0,1,0,0,5
AGGATATAGGGATTTA-1_Br6432_Ant_IF,1,0,0,0,0,1
GTGATCACTAACGCCT-1_Br6432_Ant_IF,4,0,0,0,0,4
ACCGGGCCTTTGTTGA-1_Br6432_Ant_IF,2,0,3,0,1,6
TTGACAGGAGCTCCCG-1_Br6432_Ant_IF,2,0,1,0,0,3
CTCTTCTATTGACTGG-1_Br6432_Ant_IF,2,0,2,0,0,4
CGTGGCCGAATATCTA-1_Br6432_Ant_IF,4,0,1,0,0,5
GGTTTAGCCTTTCTTG-1_Br6432_Ant_IF,0,1,1,0,0,2
TCAAGGTTACTACACC-1_Br6432_Ant_IF,3,1,1,0,1,6
TTGACTATTGTCCGGC-1_Br6432_Ant_IF,0,0,0,0,0,0
CGGGAATATAGTATAC-1_Br6432_Ant_IF,0,1,0,0,6,7
GCAACAGCAGTATGCG-1_Br6432_Ant_IF,3,0,0,1,3,7
ATCAAACACTGTTCCA-1_Br6432_Ant_IF,3,0,0,0,0,3
TGGGCAATAGTTGGGT-1_Br6432_Ant_IF,2,0,0,0,0,2
TGAATGTCAGCCGGCC-1_Br6432_Ant_IF,1,1,0,0,0,2
CGGCTCTAAAGCTGCA-1_Br6432_Ant_IF,0,0,1,0,1,2
GGACACAAGTTTACAC-1_Br6432_Ant_IF,1,0,0,0,3,4
CCGAGAAGTCGCATAA-1_Br6432_Ant_IF,3,1,1,0,1,6
AACTACCCGTTTGTCA-1_Br6432_Ant_IF,2,0,0,0,0,2
GCACAAACGAGGCGTG-1_Br6432_Ant_IF,1,0,3,0,0,4
CACACAGCTTGCGCTC-1_Br6432_Ant_IF,3,1,2,0,0,6
GTGCTTACATCAGCGC-1_Br6432_Ant_IF,3,0,2,0,0,5
GCAAACGTCGCCAGGT-1_Br6432_Ant_IF,2,1,0,0,0,3
GAATAGCATTTAGGGT-1_Br6432_Ant_IF,0,0,1,0,0,1
TACTGTTTCTCTGGTA-1_Br6432_Ant_IF,0,1,0,0,2,3
TCCTATCATAGGTAAC-1_Br6432_Ant_IF,0,4,0,0,0,4
CCCACTCCACGGTATC-1_Br6432_Ant_IF,0,0,0,0,0,0
TCAAAGAGCTATCTGT-1_Br6432_Ant_IF,1,0,0,0,0,1
CATATGTCAGGCTACG-1_Br6432_Ant_IF,0,0,0,0,0,0
GCCCGACTTCTTCCCG-1_Br6432_Ant_IF,0,0,0,0,0,0
CTGGCATCCGAATGAG-1_Br6432_Ant_IF,0,0,0,0,0,0
AAGTGCGTTAGAATCT-1_Br6432_Ant_IF,0,0,0,0,0,0
AGAAGTGATTCGTGAT-1_Br6432_Ant_IF,0,0,0,0,0,0
TACCTTAAGATTTCCC-1_Br6432_Ant_IF,1,0,0,0,1,2
AATGACAGCAATGTCT-1_Br6432_Ant_IF,0,0,1,0,0,1
TCAACGCAGGAAATAA-1_Br6432_Ant_IF,4,0,3,0,2,9
TATTCCTCCGCCCACT-1_Br6432_Ant_IF,1,2,0,0,2,5
ATCAAACGAAGGTTTG-1_Br6432_Ant_IF,1,0,2,0,3,6
TTGATTAGCTGTTTCT-1_Br6432_Ant_IF,3,1,0,0,2,6
CTGCTGAGGCCACGAA-1_Br6432_Ant_IF,2,0,1,0,0,3
CCGTGTTAAATTCCAT-1_Br6432_Ant_IF,2,0,0,0,0,2
CACGTCGGCAACCTCT-1_Br6432_Ant_IF,1,0,1,0,1,3
GTATTCTGAGAAACGA-1_Br6432_Ant_IF,3,0,2,0,0,5
CGGTGCGCGTTGGTCC-1_Br6432_Ant_IF,3,0,2,0,0,5
GTGATTCGCCGCTCAA-1_Br6432_Ant_IF,0,0,0,0,1,1
GCCCGCGCGTAAACGG-1_Br6432_Ant_IF,2,0,0,0,0,2
AACGTACTGTGGGTAC-1_Br6432_Ant_IF,2,0,0,0,1,3
GAGTATGCCCGCCTTG-1_Br6432_Ant_IF,2,0,1,0,1,4
TGATTCTGTCGCCGGT-1_Br6432_Ant_IF,0,0,3,0,0,3
GGGCGGCAAATGAATT-1_Br6432_Ant_IF,5,4,0,1,0,10
TTCCAATCTGGCTATC-1_Br6432_Ant_IF,1,0,0,0,2,3
GGAACCGTGTAAATTG-1_Br6432_Ant_IF,0,1,0,0,1,2
TTGGTCACACTCGTAA-1_Br6432_Ant_IF,3,0,0,0,1,4
CGAACCCGCATGCGTC-1_Br6432_Ant_IF,2,0,3,0,0,5
GGGCGTCACCACGTAA-1_Br6432_Ant_IF,3,0,0,0,3,6
TACCAGAAGTAGGTTC-1_Br6432_Ant_IF,0,0,0,0,0,0
TTGGATATCGTCTACG-1_Br6432_Ant_IF,2,1,0,0,1,4
TAGATATGGACTGGAA-1_Br6432_Ant_IF,3,0,0,0,1,4
GCGACGATAGTTGTAC-1_Br6432_Ant_IF,0,0,0,0,0,0
CTGGATTTACACTTGA-1_Br6432_Ant_IF,1,1,0,0,2,4
GTTATATTATCTCCCT-1_Br6432_Ant_IF,0,4,0,0,1,5
TATTCCACTCAGCTCG-1_Br6432_Ant_IF,1,0,0,0,0,1
CTGTTACCCAATCTAG-1_Br6432_Ant_IF,2,0,0,0,0,2
ACGCGAAGTCAGACGA-1_Br6432_Ant_IF,0,0,0,0,1,1
GATAGGTAACGTTGAC-1_Br6432_Ant_IF,3,0,0,0,0,3
TGTTCGTATTGCGGTG-1_Br6432_Ant_IF,5,1,2,0,2,10
GGTCAGTGGGTCCCAC-1_Br6432_Ant_IF,4,1,0,0,0,5
AATTCTAGAGTTAGGC-1_Br6432_Ant_IF,5,0,1,0,0,6
GTTTACGTTCCATCTG-1_Br6432_Ant_IF,1,1,0,0,0,2
AGACCCACCGCTGATC-1_Br6432_Ant_IF,0,2,0,0,0,2
TCTAGCATGCCCAGAA-1_Br6432_Ant_IF,0,2,0,0,0,2
CCCGCAGCGCGAACTA-1_Br6432_Ant_IF,4,0,2,0,0,6
CTCTATTTGGCTGCAG-1_Br6432_Ant_IF,5,1,1,1,1,9
TTCTGCCGCGCCTAGA-1_Br6432_Ant_IF,5,0,0,1,0,6
ACTCCCTAGAATAGTA-1_Br6432_Ant_IF,0,0,0,0,0,0
CCGAACCTTCCCGGCC-1_Br6432_Ant_IF,1,1,0,0,0,2
TCAGACGCTATAGAAG-1_Br6432_Ant_IF,0,0,1,0,0,1
CAGGCGCCATGCTAGG-1_Br6432_Ant_IF,2,0,1,5,0,8
CACTCGAGCTGAACAA-1_Br6432_Ant_IF,0,0,1,0,0,1
ACAAGGAAATCCGCCC-1_Br6432_Ant_IF,1,0,0,0,0,1
ACCACGTGCAGCTATA-1_Br6432_Ant_IF,4,0,0,0,0,4
ACGGCGACGATGGGAA-1_Br6432_Ant_IF,6,0,0,0,0,6
TTACTAAAGGACTTTA-1_Br6432_Ant_IF,1,1,0,0,0,2
GGCTGAAATAGCAAAG-1_Br6432_Ant_IF,2,2,2,0,0,6
TTAGACGAGTCACCTC-1_Br6432_Ant_IF,5,0,1,0,0,6
GTAGTCGCGGGAATCA-1_Br6432_Ant_IF,3,1,0,0,0,4
GCAAACCCTACATTAT-1_Br6432_Ant_IF,2,0,1,0,0,3
GTTAAAGTAGGACTGG-1_Br6432_Ant_IF,6,1,0,0,1,8
ACCCTCCCTTGCTATT-1_Br6432_Ant_IF,2,1,1,0,0,4
CATGTCTCATTTATGG-1_Br6432_Ant_IF,0,1,0,0,0,1
AATAGAATCTGTTTCA-1_Br6432_Ant_IF,2,0,0,0,0,2
TCTCATGAGATAGGGT-1_Br6432_Ant_IF,2,0,0,0,1,3
ATGACTATGCGACATT-1_Br6432_Ant_IF,1,0,0,0,0,1
CCTAACCCAAACAAGT-1_Br6432_Ant_IF,0,0,0,0,1,1
AGTCAAGATGACACTT-1_Br6432_Ant_IF,5,0,0,0,1,6
CGGGAGCTTCAGTGTA-1_Br6432_Ant_IF,1,0,0,0,1,2
CCACAGTACCCATCCT-1_Br6432_Ant_IF,0,0,0,0,1,1
GAGCGCGCACGAGTAG-1_Br6432_Ant_IF,1,0,0,0,2,3
ACCAGTGCGGGAGACG-1_Br6432_Ant_IF,3,0,0,0,0,3
TCCTTACGACGGTCCG-1_Br6432_Ant_IF,0,1,0,0,2,3
TAGTCGATCACGGGTT-1_Br6432_Ant_IF,0,0,0,0,0,0
AGACGAAGTGCCGGTC-1_Br6432_Ant_IF,3,0,0,0,0,3
CGCTGGTGACTACCCT-1_Br6432_Ant_IF,2,0,1,0,1,4
AGGCATTGTCGTAGGG-1_Br6432_Ant_IF,1,0,0,0,0,1
TGGTAGAATATATGGG-1_Br6432_Ant_IF,3,0,1,0,0,4
TTCTTATCCGCTGGGT-1_Br6432_Ant_IF,2,0,3,0,4,9
AGTTTGGCACGGGTTG-1_Br6432_Ant_IF,1,0,0,0,0,1
GCATCGGCCGTGTAGG-1_Br6432_Ant_IF,2,0,2,0,1,5
ATGCGAGTCCCACCAC-1_Br6432_Ant_IF,0,0,1,0,2,3
TCGGCGAACCCAAACC-1_Br6432_Ant_IF,0,0,1,0,1,2
AGAGTAAACTTCACTA-1_Br6432_Ant_IF,1,2,2,0,1,6
AAGCCGAAGCGGTTTA-1_Br6432_Ant_IF,2,0,2,0,3,7
CCCGAGTTTCTCCGTA-1_Br6432_Ant_IF,0,0,0,0,0,0
AATATCGAATCAATGC-1_Br6432_Ant_IF,3,1,0,0,1,5
GCGCCTCCCACTCCGA-1_Br6432_Ant_IF,2,0,2,0,2,6
CGTTAAACTAGTTAGG-1_Br6432_Ant_IF,1,1,0,0,1,3
TGAGTTAAAGACATTC-1_Br6432_Ant_IF,2,1,0,0,2,5
AACAGGTAGTATGGAT-1_Br6432_Ant_IF,3,1,2,0,0,6
GAACGCGGGTCACACG-1_Br6432_Ant_IF,1,0,0,0,0,1
TGTTTGAGATCGTCAG-1_Br6432_Ant_IF,1,0,1,0,0,2
ATCTCGTGAGCGAAAC-1_Br6432_Ant_IF,5,0,0,0,0,5
CTGAGAAAGTTCGGCG-1_Br6432_Ant_IF,2,0,0,0,0,2
ATTACCACACTGCCTG-1_Br6432_Ant_IF,0,3,0,0,2,5
GCATTGACTTGCGGAA-1_Br6432_Ant_IF,0,0,0,0,0,0
GGGCTACTATTTCGTG-1_Br6432_Ant_IF,0,0,0,0,0,0
GGCGAGCGAAACGGCA-1_Br6432_Ant_IF,0,2,2,1,0,5
TTGGAAGAATACAGTC-1_Br6432_Ant_IF,0,0,0,0,0,0
AGTTAAGTCAACCGCT-1_Br6432_Ant_IF,0,0,0,0,0,0
CTCATGGTAATTTGCG-1_Br6432_Ant_IF,0,0,0,0,0,0
AAAGTAGCATTGCTCA-1_Br6432_Ant_IF,5,2,0,0,0,7
TTGTGGTAGGAGGGAT-1_Br6432_Ant_IF,3,0,1,0,0,4
AGTCGTGGGCATTACG-1_Br6432_Ant_IF,3,0,1,0,0,4
ACCTAAGTACCTTTCA-1_Br6432_Ant_IF,3,0,2,0,1,6
GTAGAGGGAGACAAGT-1_Br6432_Ant_IF,2,0,0,0,2,4
GATCCTCGACACTGGC-1_Br6432_Ant_IF,3,0,1,0,4,8
CCTACATTCACAGACG-1_Br6432_Ant_IF,1,0,0,0,0,1
TTGACCGTGTTAATGA-1_Br6432_Ant_IF,3,1,0,0,0,4
TCTGTTACCCAGCATA-1_Br6432_Ant_IF,3,1,2,0,1,7
CTAACTGGTCCGGTTC-1_Br6432_Ant_IF,4,0,0,0,0,4
AGCGACAGGAACGGTC-1_Br6432_Ant_IF,1,0,0,0,0,1
TAATAGAACAGAGTTA-1_Br6432_Ant_IF,5,0,1,0,1,7
ACAGGTGGAGGTGAGG-1_Br6432_Ant_IF,2,1,1,0,0,4
TGCGAGAATATTACCC-1_Br6432_Ant_IF,3,1,1,0,1,6
TTGCGTCGGCCAACCG-1_Br6432_Ant_IF,0,0,0,0,0,0
AGGCTTCCCGAAGAAG-1_Br6432_Ant_IF,0,1,1,0,0,2
GCGGACCGCGTTGTGG-1_Br6432_Ant_IF,3,0,0,0,0,3
GTAATCTGATTCTTCG-1_Br6432_Ant_IF,6,0,0,0,0,6
CCGCGGAATGCGTCAC-1_Br6432_Ant_IF,1,0,0,0,1,2
TTCCACACAGATTTGA-1_Br6432_Ant_IF,2,0,1,0,2,5
CTTCTATTAATGCTAG-1_Br6432_Ant_IF,2,0,0,0,0,2
CATTTGAGTGGTACGT-1_Br6432_Ant_IF,3,1,0,0,0,4
TCACAGCAAACTCGAA-1_Br6432_Ant_IF,2,0,0,0,1,3
CAGACGAACCTGATAC-1_Br6432_Ant_IF,0,0,0,0,1,1
TAGCTAGAAGGCATGA-1_Br6432_Ant_IF,2,0,1,0,1,4
ATCCAGAGCAACAACC-1_Br6432_Ant_IF,1,0,0,0,1,2
TCCGGTTCGTCCGGTC-1_Br6432_Ant_IF,2,1,0,0,0,3
CGCGCATGTTTGATTG-1_Br6432_Ant_IF,2,0,1,0,1,4
TGGCGATCAAGTTATG-1_Br6432_Ant_IF,2,0,0,0,1,3
CCCTTTGACAGGTCTT-1_Br6432_Ant_IF,2,1,0,0,1,4
CAGAGACGGTCACCCA-1_Br6432_Ant_IF,0,1,2,0,3,6
TAGCTCGCCTGATAAC-1_Br6432_Ant_IF,1,3,1,0,2,7
TTGTGTTTCCCGAAAG-1_Br6432_Ant_IF,1,0,0,0,1,2
TATACACAGACGCCTT-1_Br6432_Ant_IF,0,1,0,0,0,1
ACATTAGTTTATATCC-1_Br6432_Ant_IF,0,0,0,0,1,1
CCATCGCAGTTAAACT-1_Br6432_Ant_IF,2,0,0,0,1,3
AATTAGCGCTGCAGCG-1_Br6432_Ant_IF,4,0,0,1,1,6
TCCGCTTATCCCATTA-1_Br6432_Ant_IF,8,0,0,0,1,9
GTTTGGGCTTGTGAGC-1_Br6432_Ant_IF,1,0,1,0,2,4
CTTGTCAACATTCGAG-1_Br6432_Ant_IF,2,0,0,0,1,3
GGACCAACAGGATAAC-1_Br6432_Ant_IF,4,0,0,0,1,5
AAGCTAGATCGAGTAA-1_Br6432_Ant_IF,3,0,0,0,0,3
TACCGTGCCTCGGACC-1_Br6432_Ant_IF,5,3,0,0,0,8
GTAGCCAAACATGGGA-1_Br6432_Ant_IF,6,2,0,0,0,8
TGCCAGTACGTGGAGA-1_Br6432_Ant_IF,4,0,0,3,0,7
ATAAGGTGGAGAACAT-1_Br6432_Ant_IF,0,0,0,0,0,0
CTTTAATATTGGTCGA-1_Br6432_Ant_IF,1,0,0,0,0,1
TGGTTCAACGGGTAAT-1_Br6432_Ant_IF,3,0,0,2,0,5
GCTGCTACTGCGTAGC-1_Br6432_Ant_IF,4,1,0,0,0,5
CTGCACAACTACATAT-1_Br6432_Ant_IF,2,0,1,0,0,3
ATATTCCACATAGTGA-1_Br6432_Ant_IF,4,0,0,0,0,4
TGGCAAACTAAATTAC-1_Br6432_Ant_IF,2,0,0,0,1,3
ACCGCAATAACTGCCT-1_Br6432_Ant_IF,4,1,1,0,0,6
TCGCACCAGGAGGCAG-1_Br6432_Ant_IF,4,2,0,0,1,7
ACTTCAGGCTGATCCC-1_Br6432_Ant_IF,5,1,1,0,0,7
ACAAATCGCACCGAAT-1_Br6432_Ant_IF,7,1,1,0,2,11
TCTGATGTATTCTGTC-1_Br6432_Ant_IF,1,0,0,1,0,2
CTTTACCGAATAGTAG-1_Br6432_Ant_IF,1,0,0,0,1,2
GCAGATCCATAAGACT-1_Br6432_Ant_IF,1,0,1,0,0,2
TTCCTCGGACTAACCA-1_Br6432_Ant_IF,2,0,0,1,1,4
TTATCCGGGATCTATA-1_Br6432_Ant_IF,1,0,1,0,1,3
CTGGAAGACACGGTGG-1_Br6432_Ant_IF,6,0,0,0,0,6
GTTCGTCTAAAGAACT-1_Br6432_Ant_IF,1,0,0,1,1,3
GTCTATTGGTTCCGGT-1_Br6432_Ant_IF,1,0,0,0,2,3
CTAGGCGCCCTATCAG-1_Br6432_Ant_IF,1,1,0,0,1,3
AACGGACGTACGTATA-1_Br6432_Ant_IF,1,0,4,0,1,6
AACACACGCTCGCCGC-1_Br6432_Ant_IF,0,0,0,0,1,1
GCTACTATAGTAGAGT-1_Br6432_Ant_IF,2,0,0,0,1,3
AGCATATCAATATGCT-1_Br6432_Ant_IF,1,1,0,0,0,2
CGAACAGTATGGGCGT-1_Br6432_Ant_IF,0,1,0,0,1,2
ACAATTGTGTCTCTTT-1_Br6432_Ant_IF,1,0,2,0,1,4
GATCGCTACCCGATTT-1_Br6432_Ant_IF,2,0,2,0,0,4
ATTGCGATCAGTAACT-1_Br6432_Ant_IF,2,0,1,0,0,3
CAGCAGTCCAGACTAT-1_Br6432_Ant_IF,0,1,0,0,0,1
AGAGGCTTCGGAAACC-1_Br6432_Ant_IF,2,0,1,0,1,4
AAACAAGTATCTCCCA-1_Br6432_Ant_IF,3,0,1,0,1,5
GGCAGCAAACCTATGC-1_Br6432_Ant_IF,1,0,0,0,0,1
ACTAGTTGCGATCGTC-1_Br6432_Ant_IF,2,0,0,0,0,2
TTGGACCATCTGGCAA-1_Br6432_Ant_IF,4,1,0,0,0,5
CCCTCCTCGCTCGTAT-1_Br6432_Ant_IF,3,0,1,0,1,5
GAGCGCAAATACTCCG-1_Br6432_Ant_IF,1,0,1,0,0,2
ATTACATGTCAGTCTT-1_Br6432_Ant_IF,2,1,0,0,3,6
TTGGGACGTAAGAGTT-1_Br6432_Ant_IF,3,0,1,0,2,6
CTTCGGCCAATTGTTT-1_Br6432_Ant_IF,2,0,0,0,0,2
AGACCGCTCCGCGGTT-1_Br6432_Ant_IF,5,0,3,0,1,9
GACCGCGTCTGACGTG-1_Br6432_Ant_IF,2,1,0,0,0,3
CCAAATAACAAGATTC-1_Br6432_Ant_IF,2,2,1,0,1,6
TCTTTAGAGTCTAACA-1_Br6432_Ant_IF,3,1,2,0,1,7
CTCCCAATGAGTCGCG-1_Br6432_Ant_IF,1,0,2,0,0,3
TAGTCTTTCCGAATTG-1_Br6432_Ant_IF,0,1,2,0,1,4
GTTTGTTAGCCAAGTA-1_Br6432_Ant_IF,0,0,0,0,1,1
TTGTCACCGCGGTATC-1_Br6432_Ant_IF,0,0,0,7,2,9
GATCTAACCGTATTCA-1_Br6432_Ant_IF,1,0,0,0,0,1
ATGGAAATTTAAGGAG-1_Br6432_Ant_IF,3,3,0,0,1,7
ATTGATCACCACATTT-1_Br6432_Ant_IF,0,0,0,0,0,0
ACAGAACTGAGAACAA-1_Br6432_Ant_IF,0,0,0,0,0,0
CTACTATCATAGGTTT-1_Br6432_Ant_IF,3,0,0,0,1,4
CCTCTATCGATTAGCA-1_Br6432_Ant_IF,3,0,0,0,2,5
CCGTATCTCGTCGTAG-1_Br6432_Ant_IF,2,0,0,0,0,2
TCACGATGTCCGTGGA-1_Br6432_Ant_IF,1,1,0,0,1,3
TCAACAAAGATAATTC-1_Br6432_Ant_IF,1,0,0,1,0,2
ATGACGCGTTCTATCC-1_Br6432_Ant_IF,1,0,1,0,0,2
ATTTGCGCGAGTAGCT-1_Br6432_Ant_IF,2,2,1,0,0,5
TTCTTGGACGATCTGC-1_Br6432_Ant_IF,0,0,0,0,1,1
AGACGACGATGCCGCT-1_Br6432_Ant_IF,3,1,0,0,1,5
GGTCTCTGAATGGACT-1_Br6432_Ant_IF,1,0,1,0,1,3
GCTCAATCCGTTTATT-1_Br6432_Ant_IF,0,0,0,0,0,0
CCAGAAAGCAACTCAT-1_Br6432_Ant_IF,2,0,2,0,4,8
CACCGTTAGGGATCAC-1_Br6432_Ant_IF,2,0,1,0,3,6
AATAACACTAGAACAA-1_Br6432_Ant_IF,2,0,1,0,1,4
CACCCGGTTTGTGACT-1_Br6432_Ant_IF,3,0,0,0,0,3
CCACCAACTTTACTGT-1_Br6432_Ant_IF,4,0,2,0,0,6
AACTCTCAGTGTGCTC-1_Br6432_Ant_IF,3,0,0,0,0,3
AAACCGTTCGTCCAGG-1_Br6432_Ant_IF,3,1,0,0,1,5
CAGCGATTCCCTTCAA-1_Br6432_Ant_IF,1,0,1,0,1,3
GCTAGCTTGAATAGCT-1_Br6432_Ant_IF,0,0,0,0,2,2
TTGCGGCATCAGAAAG-1_Br6432_Ant_IF,0,0,0,0,0,0
AATAGAACAGAGTGGC-1_Br6432_Ant_IF,2,0,1,0,0,3
GCCATCGAGCTGCGTG-1_Br6432_Ant_IF,0,0,0,0,0,0
ACACTGATCAAGGTGT-1_Br6432_Ant_IF,3,0,0,0,0,3
ACCAACGCTTATTTAT-1_Br6432_Ant_IF,4,0,0,0,3,7
GACATCGATTTATAAC-1_Br6432_Ant_IF,1,0,0,0,0,1
CAGACACCGATCGCTG-1_Br6432_Ant_IF,1,0,0,0,2,3
CCAAGAAAGTGGGCGA-1_Br6432_Ant_IF,1,0,0,0,0,1
GGTAGACCGTTGGGCG-1_Br6432_Ant_IF,2,1,1,0,0,4
TCGTTAGGAGTCCCTA-1_Br6432_Ant_IF,1,1,0,0,0,2
ACGGCCAACATGGACT-1_Br6432_Ant_IF,1,0,0,0,0,1
GTGAGTGGTACAACGC-1_Br6432_Ant_IF,3,0,0,0,1,4
GAGACTTCGCGACCGA-1_Br6432_Ant_IF,3,0,0,0,1,4
GAAGTCAGTTGCACTA-1_Br6432_Ant_IF,1,1,0,0,1,3
GTTTGGTAGGGTCAAC-1_Br6432_Ant_IF,2,0,0,0,0,2
ACGGCACTTGCTTGGG-1_Br6432_Ant_IF,1,0,0,0,0,1
CCTCTGTACTATTCTA-1_Br6432_Ant_IF,0,0,0,0,0,0
CTATTCATGTGTCCCA-1_Br6432_Ant_IF,3,0,0,0,1,4
GCCCGATCTGTGGTCG-1_Br6432_Ant_IF,1,0,1,0,3,5
TTAGAAGAACATGACT-1_Br6432_Ant_IF,2,1,1,0,2,6
AGGATAAAGTCGGGAT-1_Br6432_Ant_IF,6,0,0,0,0,6
CGGCAAACATCGTGCG-1_Br6432_Ant_IF,2,3,0,0,0,5
CTAGTTACAACCCGGT-1_Br6432_Ant_IF,4,0,0,0,0,4
TTCGACAGAGCCCGTG-1_Br6432_Ant_IF,0,0,0,0,1,1
AAGCATACTCTCCTGA-1_Br6432_Ant_IF,4,3,2,0,0,9
GACGACGATCCGCGTT-1_Br6432_Ant_IF,4,1,0,0,0,5
GGTAGAAGACCGCCTG-1_Br6432_Ant_IF,5,1,0,0,0,6
GAGATGGGAGTCGACA-1_Br6432_Ant_IF,1,3,0,1,0,5
AACGATAATGCCGTAG-1_Br6432_Ant_IF,1,0,0,0,0,1
TGGTCCCACGCTACGG-1_Br6432_Ant_IF,1,0,0,0,0,1
CTGCTTGGCGATAGCT-1_Br6432_Ant_IF,1,2,0,1,0,4
ATCGGAGACAGACGGC-1_Br6432_Ant_IF,2,1,1,2,0,6
TAGCGTCCGGTGTGGT-1_Br6432_Ant_IF,2,0,0,0,0,2
GTTGAGTCCCGCCGGT-1_Br6432_Ant_IF,2,1,0,0,0,3
AAATAGGGTGCTATTG-1_Br6432_Ant_IF,4,0,0,0,0,4
AAGTGTTTGGAGACGG-1_Br6432_Ant_IF,6,3,0,0,0,9
AGCACTACCTCACCAG-1_Br6432_Ant_IF,1,1,0,0,0,2
TGCCTTGGCCAGGCAA-1_Br6432_Ant_IF,1,0,1,0,0,2
TCGTCTTAGGCGTTAA-1_Br6432_Ant_IF,3,0,1,0,0,4
TTCTGACCGGGCTCAA-1_Br6432_Ant_IF,5,0,2,0,0,7
CAGAACTTAGCCCTCT-1_Br6432_Ant_IF,0,0,0,1,1,2
AGCTCCTTCGCACATC-1_Br6432_Ant_IF,0,0,3,0,0,3
ACAGGCTTGCCCGACT-1_Br6432_Ant_IF,0,0,0,0,2,2
GCTATACGTCTCGGAC-1_Br6432_Ant_IF,0,0,0,0,0,0
GAGCCAGCTACCTGTG-1_Br6432_Ant_IF,3,0,2,0,0,5
TGCTAAGTGTCTATTT-1_Br6432_Ant_IF,0,0,2,0,1,3
GTCCTACGAATAGTCT-1_Br6432_Ant_IF,1,0,0,0,0,1
CAGTGTCGGCTGGCCC-1_Br6432_Ant_IF,3,1,0,0,1,5
CTATCGACGAAATACA-1_Br6432_Ant_IF,3,0,1,0,0,4
CATCATTACCCTGAGG-1_Br6432_Ant_IF,3,0,1,0,1,5
TAAGTTGCGACGTAGG-1_Br6432_Ant_IF,2,0,0,0,1,3
AGTGCACGCTTAAGAA-1_Br6432_Ant_IF,2,1,0,0,1,4
TGTGCCGGTGCCGGAA-1_Br6432_Ant_IF,2,1,1,0,1,5
AGGAGGCCTTCGCGCG-1_Br6432_Ant_IF,4,1,1,0,0,6
TCCGCGGCCCAATGAA-1_Br6432_Ant_IF,1,0,0,0,0,1
TCCGTTAAGCTAATAT-1_Br6432_Ant_IF,2,0,1,0,2,5
AAATCTAGCCCTGCTA-1_Br6432_Ant_IF,1,0,0,0,1,2
CGCAGGCGATCCAAAC-1_Br6432_Ant_IF,1,0,0,0,1,2
CCATATGGAAACTATA-1_Br6432_Ant_IF,0,0,0,0,0,0
CACCGTATCCCATCCG-1_Br6432_Ant_IF,1,1,0,0,0,2
GGTCAAGACTACTTCG-1_Br6432_Ant_IF,1,0,0,0,0,1
CCCGTTTCGCAGATGT-1_Br6432_Ant_IF,0,0,0,0,0,0
GTTATAATACGGTGAA-1_Br6432_Ant_IF,2,0,0,0,3,5
ACTTGTGGATGGAACG-1_Br6432_Ant_IF,2,0,2,0,2,6
GTTCGCTGAGACGTCT-1_Br6432_Ant_IF,0,2,0,0,7,9
GACACTGGAACCCGAT-1_Br6432_Ant_IF,2,0,0,0,0,2
CCCAGGTCTGAAGGCT-1_Br6432_Ant_IF,1,0,2,0,0,3
TCTCGAGGAGGTTCGC-1_Br6432_Ant_IF,5,1,2,0,1,9
ACTATCTGCCCGCGTA-1_Br6432_Ant_IF,0,0,2,0,0,2
CCTAAATTGTATCCTA-1_Br6432_Ant_IF,3,1,0,0,0,4
GATATCAAGCAGGAGC-1_Br6432_Ant_IF,1,0,0,0,1,2
CCACATGGCTCTTTAT-1_Br6432_Ant_IF,2,0,0,0,0,2
GTCCTACTCTACGGGC-1_Br6432_Ant_IF,6,1,1,0,1,9
CTCGAGACATACGATA-1_Br6432_Ant_IF,3,4,1,0,0,8
TGACAGGACAAGTCCA-1_Br6432_Ant_IF,5,4,2,0,2,13
TTGCCATAGCCCGCTC-1_Br6432_Ant_IF,1,0,0,0,2,3
TAACATACACGCGATC-1_Br6432_Ant_IF,0,0,0,0,0,0
CCGACGGGCATGAGGT-1_Br6432_Ant_IF,2,0,1,0,4,7
AATGTGCCCGAGGTGT-1_Br6432_Ant_IF,1,0,2,0,2,5
AGCTGTAACCTCAATC-1_Br6432_Ant_IF,1,0,0,0,0,1
CGAGTGAAGGTACCAG-1_Br6432_Ant_IF,1,0,0,0,1,2
AGTCTCACAAGACTAC-1_Br6432_Ant_IF,1,0,0,0,0,1
AAATTGATAGTCCTTT-1_Br6432_Ant_IF,2,0,1,0,1,4
TAAGTCGCCGAGTATC-1_Br6432_Ant_IF,1,0,1,0,1,3
GCGGAGAAACTTCGCA-1_Br6432_Ant_IF,2,0,0,0,0,2
GGCAAAGGCGCCAATA-1_Br6432_Ant_IF,1,0,1,0,1,3
ATTTCCGGGTTCTGCG-1_Br6432_Ant_IF,2,0,1,0,1,4
TAAACCCAGGAGGGCA-1_Br6432_Ant_IF,1,0,1,0,1,3
TTCGGGCGCTAGTCTT-1_Br6432_Ant_IF,2,0,1,0,0,3
GTGGAGTCGGCGGTTG-1_Br6432_Ant_IF,1,0,1,0,3,5
GCACGCCTACTTAGAT-1_Br6432_Ant_IF,1,0,1,0,0,2
CAATATTCTTGACCTA-1_Br6432_Ant_IF,3,0,3,0,0,6
CGTTTGTGTAGAGGGT-1_Br6432_Ant_IF,1,0,0,0,0,1
CATAGCGTTGCCCACC-1_Br6432_Ant_IF,1,0,0,0,0,1
TGATACATTTAGCCGT-1_Br6432_Ant_IF,4,0,0,0,0,4
TTCCGGCCTTGAGGCT-1_Br6432_Ant_IF,2,0,0,0,0,2
CCTATACCGTCCTGTC-1_Br6432_Ant_IF,0,0,0,0,0,0
TCGTTGCTATCCGGTC-1_Br6432_Ant_IF,0,0,0,0,1,1
TGGCGACTGCTCCAAA-1_Br6432_Ant_IF,1,1,1,0,1,4
CAGAGGCGATGCATGA-1_Br6432_Ant_IF,1,0,0,0,0,1
TCACAGGAGAATAAGA-1_Br6432_Ant_IF,2,0,2,0,2,6
GGGTTAACATTTGAGT-1_Br6432_Ant_IF,1,0,1,0,1,3
GCGGGCGAGCCTTACC-1_Br6432_Ant_IF,3,1,1,0,0,5
TGCCAATGGGTACTCT-1_Br6432_Ant_IF,2,0,0,0,3,5
AGGGACTCTACGCGAC-1_Br6432_Ant_IF,3,2,1,0,2,8
GACGCCGTAAAGGCTA-1_Br6432_Ant_IF,1,0,1,0,1,3
AAAGGCTCTCGCGCCG-1_Br6432_Ant_IF,3,0,1,0,0,4
CTGGCTGGTTGTCAGT-1_Br6432_Ant_IF,3,1,2,0,1,7
ACATCCCGGCCATACG-1_Br6432_Ant_IF,1,0,0,1,0,2
CTCTTGTCCCGCTTGG-1_Br6432_Ant_IF,1,0,0,0,1,2
TACGCCTCCATTCCGA-1_Br6432_Ant_IF,3,0,0,0,1,4
CGGAGCAATTTAATCG-1_Br6432_Ant_IF,0,0,0,0,1,1
AACTAGGCTTGGGTGT-1_Br6432_Ant_IF,3,0,1,0,1,5
GCGTCGCCAGGGTGAT-1_Br6432_Ant_IF,1,0,0,0,0,1
GTTGGTCATGCTATCC-1_Br6432_Ant_IF,0,0,1,0,2,3
GCTGGCGGCGCATGCT-1_Br6432_Ant_IF,3,0,0,0,2,5
TGAGCGGAAAGTGTTC-1_Br6432_Ant_IF,4,0,0,0,0,4
CTTTCTGTGCGGGCTT-1_Br6432_Ant_IF,5,0,1,0,0,6
ATCTAATATCCTACGG-1_Br6432_Ant_IF,4,1,0,0,1,6
AACCTTTAAATACGGT-1_Br6432_Ant_IF,5,0,0,0,0,5
TTCACTCGAGCACCTA-1_Br6432_Ant_IF,1,0,0,0,0,1
CTGCACTCCAGTACAG-1_Br6432_Ant_IF,1,0,0,0,0,1
CCATTTCTACCTATTA-1_Br6432_Ant_IF,2,1,0,0,0,3
CAAGCGGCACATAATT-1_Br6432_Ant_IF,4,0,0,0,0,4
GTTAACATCACTTAAA-1_Br6432_Ant_IF,5,0,0,0,0,5
ATATAAATGTAGCTGC-1_Br6432_Ant_IF,2,0,0,2,0,4
GCCTCTATACATAGCA-1_Br6432_Ant_IF,1,1,0,0,0,2
GTGTCGTATAGCGTTC-1_Br6432_Ant_IF,0,1,1,0,0,2
ATACGTACTTAGCCAC-1_Br6432_Ant_IF,0,0,0,0,0,0
GCTATCATACTCATGG-1_Br6432_Ant_IF,6,1,1,0,0,8
TATCCAATTGGTTATC-1_Br6432_Ant_IF,5,0,0,0,0,5
TCTCCCTGGGCAGCGT-1_Br6432_Ant_IF,0,0,0,0,0,0
CCTATAATGAGTGCCC-1_Br6432_Ant_IF,6,5,0,0,0,11
CAATGCGAGAAGTATC-1_Br6432_Ant_IF,1,1,0,0,0,2
TACCAATAAAGTACCA-1_Br6432_Ant_IF,2,11,1,2,0,16
GCTAGGCACCACGGAG-1_Br6432_Ant_IF,3,1,0,1,1,6
GGTGGACTGCTCTGGC-1_Br6432_Ant_IF,3,0,0,0,1,4
TATTCCGAGCTGTTAT-1_Br6432_Ant_IF,1,1,0,0,0,2
TTGAGAAGTTTAGCAT-1_Br6432_Ant_IF,1,1,0,0,2,4
GTCCGGACCTGAAATT-1_Br6432_Ant_IF,0,0,1,0,0,1
CTGTGGTCGGGAGATA-1_Br6432_Ant_IF,2,0,0,0,0,2
CATGTAAGAGACATTT-1_Br6432_Ant_IF,3,0,0,0,1,4
CACGTTTCGTACACAC-1_Br6432_Ant_IF,2,0,2,0,1,5
CATCCTCTCAAAGATC-1_Br6432_Ant_IF,2,0,1,0,0,3
GATTAACCGAAAGCCC-1_Br6432_Ant_IF,1,0,1,0,2,4
AACGCTGTTGCTGAAA-1_Br6432_Ant_IF,2,0,0,0,0,2
TTCAGCTGGCGTGCCC-1_Br6432_Ant_IF,2,0,0,0,0,2
TAGAGGTTCTACTTGT-1_Br6432_Ant_IF,3,0,1,0,0,4
GTATCAAACGTTAGCT-1_Br6432_Ant_IF,3,0,0,0,1,4
AATCATGTAAAGACTC-1_Br6432_Ant_IF,1,0,1,0,0,2
AGTCACTAGCTCTCGA-1_Br6432_Ant_IF,1,0,1,0,1,3
GCGAAACGATCGGGAG-1_Br6432_Ant_IF,1,2,0,0,0,3
CATGGATTGTCTTCCG-1_Br6432_Ant_IF,1,0,0,0,0,1
ATTGGATTACAGCGTA-1_Br6432_Ant_IF,1,0,0,0,0,1
CACACACGCTAACGAG-1_Br6432_Ant_IF,2,0,2,0,0,4
CTATGGGAAGCGGAAT-1_Br6432_Ant_IF,1,0,2,0,0,3
TGCCTAATTGAAGATT-1_Br6432_Ant_IF,1,0,1,0,0,2
TGGCAATGGGACGGCG-1_Br6432_Ant_IF,6,0,0,0,1,7
ACCTCCGCCCTCGCTG-1_Br6432_Ant_IF,4,0,1,0,0,5
CGGCAATAAGATCGCC-1_Br6432_Ant_IF,1,0,0,0,2,3
CCTTGACCACTTTATT-1_Br6432_Ant_IF,3,0,1,0,2,6
TCATTTAGAAGTGTGA-1_Br6432_Ant_IF,0,0,2,0,1,3
CAGAATAACACACGGA-1_Br6432_Ant_IF,0,2,0,0,3,5
TCTGAGCAATTGACTG-1_Br6432_Ant_IF,0,0,0,0,2,2
ACTTCCAGTGGAAGCT-1_Br6432_Ant_IF,0,0,0,4,0,4
CAATTGGGCCGCACTC-1_Br6432_Ant_IF,1,0,1,0,1,3
AAATCGCGGAAGGAGT-1_Br6432_Ant_IF,1,0,0,0,0,1
ATATCAATTCCAGCCT-1_Br6432_Ant_IF,3,1,4,0,0,8
TGAGGCATGTACTGTG-1_Br6432_Ant_IF,1,1,1,0,2,5
CGCGCAAATGTCCAGA-1_Br6432_Ant_IF,0,0,0,0,0,0
TCTAATACTGCCTCAG-1_Br6432_Ant_IF,1,0,1,8,4,14
CTCGGTTGTCGGCCCT-1_Br6432_Ant_IF,2,0,0,0,0,2
GGTAACCGGGAGGATA-1_Br6432_Ant_IF,1,1,0,0,1,3
CAGGCGCACGGTGGTC-1_Br6432_Ant_IF,3,0,0,0,0,3
TCATCGATGGTCCCAA-1_Br6432_Ant_IF,1,0,1,0,1,3
CAAAGATTATTGGGCC-1_Br6432_Ant_IF,1,1,0,0,0,2
ACAATGAATACGGAGA-1_Br6432_Ant_IF,3,0,2,0,2,7
GCTCCTGACATACTGG-1_Br6432_Ant_IF,2,1,1,1,1,6
GATGACAAGTAGGGCA-1_Br6432_Ant_IF,1,0,1,0,2,4
TACGCCGAGGGTACCC-1_Br6432_Ant_IF,1,1,1,0,2,5
AAGCGTCCCTCATCGA-1_Br6432_Ant_IF,4,2,0,0,0,6
CACTCCTATGTAAGAT-1_Br6432_Ant_IF,2,0,0,0,1,3
TCGAGCCAGGCAGGCC-1_Br6432_Ant_IF,1,0,0,0,1,2
TCGTCAAGTACGCGCA-1_Br6432_Ant_IF,4,0,1,0,2,7
CCCGTAGCTGGGAAGA-1_Br6432_Ant_IF,3,0,0,0,2,5
ACCCTATGCCATATCG-1_Br6432_Ant_IF,3,1,2,0,0,6
GTGGTATAGTCTGCCG-1_Br6432_Ant_IF,6,0,2,0,0,8
CCGGTTTGTAATTGTG-1_Br6432_Ant_IF,1,0,3,0,1,5
GTCGCCGTTGTGTGTT-1_Br6432_Ant_IF,2,0,0,0,1,3
TACTGAACAGATTTAG-1_Br6432_Ant_IF,3,0,0,0,0,3
TATTAACCTGACCGCG-1_Br6432_Ant_IF,6,0,0,0,0,6
CTGTAGCCATCTCACT-1_Br6432_Ant_IF,2,2,0,0,1,5
TACTATGGTTCCTCAG-1_Br6432_Ant_IF,2,0,1,0,4,7
GAGTCAGACCAGAATC-1_Br6432_Ant_IF,1,0,0,0,2,3
TAAGGCATAACATCAA-1_Br6432_Ant_IF,4,0,2,0,0,6
CTTCCGCTCCGTGAAG-1_Br6432_Ant_IF,2,0,0,0,0,2
GGGCTATGATCGATGG-1_Br6432_Ant_IF,3,0,0,0,0,3
GGTCGGTCGTCCACAG-1_Br6432_Ant_IF,2,0,0,0,0,2
GGGACCCGTATATCTT-1_Br6432_Ant_IF,2,0,0,0,1,3
GAAAGCAGTGCACTTT-1_Br6432_Ant_IF,1,0,1,0,0,2
AGCGCATAATGAATCG-1_Br6432_Ant_IF,3,0,0,0,0,3
GCTGCTAAGTAGTCGA-1_Br6432_Ant_IF,0,0,0,0,1,1
AATAGTCCGTCCCGAC-1_Br6432_Ant_IF,1,1,0,0,0,2
AGCAGCCAGATGAATA-1_Br6432_Ant_IF,1,0,1,0,2,4
CCTCGCGCTGTGCGAT-1_Br6432_Ant_IF,1,1,0,0,0,2
TTGTGTATGCCACCAA-1_Br6432_Ant_IF,4,0,1,0,0,5
TGCTCGGCGAAACCCA-1_Br6432_Ant_IF,0,0,0,0,1,1
CGATTAAATATCTCCT-1_Br6432_Ant_IF,2,0,0,0,0,2
TGCCGTGGATCGTCCT-1_Br6432_Ant_IF,2,1,1,0,2,6
GTGGACGCATTTGTCC-1_Br6432_Ant_IF,0,1,0,0,1,2
ACCCGGAAACTCCCAG-1_Br6432_Ant_IF,1,0,0,0,1,2
CCGCATGTGGTACGAT-1_Br6432_Ant_IF,1,1,0,0,2,4
GCAAACCTTGGCCATA-1_Br6432_Ant_IF,2,1,0,0,0,3
ATTCACTGATGTTGGA-1_Br6432_Ant_IF,4,0,0,0,0,4
ACTCCCTAATGCTAAA-1_Br6432_Ant_IF,5,0,0,0,0,5
TCCTAAATTGGGAAGC-1_Br6432_Ant_IF,1,0,0,0,1,2
GAACAGATTACTAAAT-1_Br6432_Ant_IF,2,0,1,0,0,3
ATACAGGCCCTCCAAT-1_Br6432_Ant_IF,3,0,0,0,0,3
CGATTCGCCTGGCTGC-1_Br6432_Ant_IF,0,1,0,0,0,1
TCCGCCTGTCTACAAG-1_Br6432_Ant_IF,2,1,0,0,0,3
CACATCTCACCGACGA-1_Br6432_Ant_IF,2,0,2,0,1,5
CGTCGTCCTTCGCGAA-1_Br6432_Ant_IF,0,0,0,0,0,0
CGTTGAATACCGCGCT-1_Br6432_Ant_IF,4,0,0,0,0,4
ACCAATATGCAAGTTA-1_Br6432_Ant_IF,3,1,0,3,0,7
ACGGATGGTGCGGATA-1_Br6432_Ant_IF,2,1,0,0,0,3
CACCCTAACAAGATCT-1_Br6432_Ant_IF,0,0,0,0,0,0
AAGCTCTTTCATGGTG-1_Br6432_Ant_IF,2,1,0,0,0,3
CATGGGTATGCCTTAT-1_Br6432_Ant_IF,4,0,0,0,0,4
GCGCGTCATTGGTACA-1_Br6432_Ant_IF,2,0,0,1,1,4
TCTGAAGCACGTGGTC-1_Br6432_Ant_IF,5,4,1,0,2,12
AAGTTCACTCCAAGCT-1_Br6432_Ant_IF,3,2,0,0,0,5
TTGGACCTATAACAGT-1_Br6432_Ant_IF,1,0,0,0,1,2
ATCAGCCTCATGCTGC-1_Br6432_Ant_IF,1,0,0,0,1,2
AGTACTCTTATGCCCA-1_Br6432_Ant_IF,1,0,1,0,1,3
GCGCTTAAATAATTGG-1_Br6432_Ant_IF,0,0,1,0,2,3
TTGTGAACCTAATCCG-1_Br6432_Ant_IF,1,3,0,0,0,4
AGTCGTCGACCACCAA-1_Br6432_Ant_IF,1,0,0,0,1,2
TCCTTTAAATCCGCTT-1_Br6432_Ant_IF,1,0,0,0,0,1
ACTGAAACGCCGTTAG-1_Br6432_Ant_IF,2,0,0,0,0,2
GCACACACTGGTAGCC-1_Br6432_Ant_IF,2,0,0,0,3,5
TAAGGGCCTGTCCGAT-1_Br6432_Ant_IF,0,0,0,0,2,2
GCTAGAGTAGAGATGT-1_Br6432_Ant_IF,1,3,0,0,0,4
CACAGGGCCATATAGT-1_Br6432_Ant_IF,0,1,1,0,0,2
CCATGCCCTAGATTTC-1_Br6432_Ant_IF,2,0,1,0,0,3
TCGCGTAGCAGTGTCC-1_Br6432_Ant_IF,6,0,0,0,0,6
GACGAGGCTAATAAAC-1_Br6432_Ant_IF,3,0,1,0,0,4
CTACACTCGCAGATGG-1_Br6432_Ant_IF,2,0,3,0,2,7
ACGCATACGTTTACTA-1_Br6432_Ant_IF,2,0,0,0,1,3
GGAGCAACATTTCAAG-1_Br6432_Ant_IF,2,2,1,0,1,6
CGAGAGGGTAGCCGCG-1_Br6432_Ant_IF,1,1,1,0,1,4
TCGTGTTCGACCACAA-1_Br6432_Ant_IF,1,0,0,0,0,1
TCTACCCAATAGAGAG-1_Br6432_Ant_IF,4,0,2,0,0,6
ATAAACGTTGCACCAC-1_Br6432_Ant_IF,3,1,0,0,0,4
TCAACTGCAGAGTCAG-1_Br6432_Ant_IF,1,3,1,0,0,5
AGCTCCATATATGTTC-1_Br6432_Ant_IF,1,0,0,0,0,1
GTAACATCTAAGATAA-1_Br6432_Ant_IF,2,1,0,0,2,5
CCGGCCGCGAGCATAT-1_Br6432_Ant_IF,0,1,0,1,1,3
AAACGAAGATGGAGTA-1_Br6432_Ant_IF,0,0,0,0,1,1
GTATCTCAGTCTTGAC-1_Br6432_Ant_IF,0,0,1,0,1,2
GCTGAATCTTCCAATC-1_Br6432_Ant_IF,0,0,0,0,0,0
AGATGCAAGACGTGCA-1_Br6432_Ant_IF,0,0,0,1,0,1
TTAAGGCCCGTACTTT-1_Br6432_Ant_IF,1,1,1,0,0,3
AGTATGCTGGAGACCA-1_Br6432_Ant_IF,2,0,0,0,1,3
GCGGCAAAGTATTGCC-1_Br6432_Ant_IF,2,0,1,0,1,4
GCGCAAATATATTCAA-1_Br6432_Ant_IF,2,0,1,0,1,4
GAAGAAACGATATTGT-1_Br6432_Ant_IF,0,0,1,0,1,2
GGACCTCTAGGCCGCC-1_Br6432_Ant_IF,4,0,0,0,0,4
AACAGCTGTGTGGCAA-1_Br6432_Ant_IF,2,1,1,0,0,4
TCGAATATCCCGCAGG-1_Br6432_Ant_IF,2,0,0,0,0,2
GCGACCCAACCATCTG-1_Br6432_Ant_IF,3,0,1,0,1,5
AGAGAAGGAGTACAAT-1_Br6432_Ant_IF,2,0,0,0,3,5
GGCTCCTCCACCTGTT-1_Br6432_Ant_IF,1,0,0,0,3,4
TCAGTGTATACGTCAT-1_Br6432_Ant_IF,2,0,1,0,0,3
ATTATTATGTCCGTCA-1_Br6432_Ant_IF,1,0,0,0,0,1
TTAGGTCATAACCGAC-1_Br6432_Ant_IF,1,0,0,0,0,1
AAGATGGCACCGGACC-1_Br6432_Ant_IF,5,0,1,0,0,6
CTACAAGAAATAACCC-1_Br6432_Ant_IF,2,2,0,0,0,4
ACTATTTCCGGGCCCA-1_Br6432_Ant_IF,0,0,0,0,0,0
TTGTTTCACATCCAGG-1_Br6432_Ant_IF,0,0,2,0,0,2
CGCTGTGTGGATGTTG-1_Br6432_Ant_IF,2,0,1,0,1,4
TCAACATAGCGCCCTA-1_Br6432_Ant_IF,3,0,0,0,0,3
GGCCGTTTGGGTTTCA-1_Br6432_Ant_IF,1,0,2,0,2,5
TACTCTTTCGTCTTCA-1_Br6432_Ant_IF,2,0,1,0,0,3
TTCGCGCGCCATACGA-1_Br6432_Ant_IF,1,0,2,0,1,4
CGGAAAGAATCAAACG-1_Br6432_Ant_IF,2,0,0,0,1,3
AGGCAGGGAGCGTACT-1_Br6432_Ant_IF,1,0,1,0,0,2
CCTTTAAGGGAGCACT-1_Br6432_Ant_IF,4,0,0,0,1,5
CGCCCAGCACGCCTAG-1_Br6432_Ant_IF,1,0,0,0,2,3
AGTATTTGGCACGACC-1_Br6432_Ant_IF,0,0,1,0,0,1
TATCCGCACCGTCGGG-1_Br6432_Ant_IF,0,1,0,0,3,4
ACCCGTGTCATCAGTA-1_Br6432_Ant_IF,2,1,1,0,1,5
CAACTGCTCATCCGAT-1_Br6432_Ant_IF,2,2,1,0,0,5
CCGGAGCGTACTTTCT-1_Br6432_Ant_IF,1,1,0,0,1,3
TACCGTAGGTTAACTA-1_Br6432_Ant_IF,2,1,0,0,1,4
TGAGGAGTGCCAGCTT-1_Br6432_Ant_IF,5,1,0,0,1,7
CCAGTCTTGTCATAGA-1_Br6432_Ant_IF,2,2,1,0,1,6
GGGCAGAGCAATCGTT-1_Br6432_Ant_IF,1,2,1,0,1,5
TACCAAATAGCCCAGA-1_Br6432_Ant_IF,6,1,0,0,2,9
TACCTACTCCCAGTAT-1_Br6432_Ant_IF,3,2,0,0,0,5
TGTGAGACTAGCCCAA-1_Br6432_Ant_IF,3,2,2,0,1,8
ATACCTAACCAAGAAA-1_Br6432_Ant_IF,0,0,0,0,2,2
GTCGGGAAGCAGAAAC-1_Br6432_Ant_IF,2,0,0,0,0,2
AATTAACGGATTTCCA-1_Br6432_Ant_IF,2,0,0,1,0,3
GAACCCTCTGTGTTCT-1_Br6432_Ant_IF,1,0,0,0,1,2
ATATAAAGCGCTCGTG-1_Br6432_Ant_IF,3,0,0,0,1,4
CCTGGTCGAATGTGGG-1_Br6432_Ant_IF,2,0,0,0,0,2
CTAGGTTCGGACGTGA-1_Br6432_Ant_IF,4,0,0,0,0,4
TCGGGAGACAGCGTAC-1_Br6432_Ant_IF,0,0,0,0,0,0
CATAAGAAGCTTGGCT-1_Br6432_Ant_IF,4,0,0,0,0,4
AAGCACCCTGCGTATC-1_Br6432_Ant_IF,1,0,1,0,0,2
AGTTTGCACCTGCCTC-1_Br6432_Ant_IF,4,0,1,0,0,5
GACTGCAAATCGAGCT-1_Br6432_Ant_IF,4,0,0,0,0,4
GTGTATATCAGCGGGC-1_Br6432_Ant_IF,5,1,0,0,0,6
CTTCAACTCCACTTGG-1_Br6432_Ant_IF,1,0,0,1,0,2
ACTTACGCATCCACGC-1_Br6432_Ant_IF,2,0,0,0,0,2
CATGAGATGCACTCTC-1_Br6432_Ant_IF,5,0,0,2,0,7
GAGCACCTGTGTCCAG-1_Br6432_Ant_IF,1,1,0,0,0,2
CGCGACCGCGACAGAT-1_Br6432_Ant_IF,4,1,3,0,0,8
GTCCCGCGACGTTATG-1_Br6432_Ant_IF,7,1,0,0,1,9
GCAGTGTGGCTATAGG-1_Br6432_Ant_IF,1,1,1,1,0,4
ATACTGCCTTACACCG-1_Br6432_Ant_IF,3,0,0,0,0,3
TACAGAAACGGTGGGC-1_Br6432_Ant_IF,6,1,0,1,0,8
GGCGCGGAGATCTTTC-1_Br6432_Ant_IF,5,0,2,0,2,9
CGTTAATGTCCCGACG-1_Br6432_Ant_IF,6,0,0,0,0,6
GCTAACTGAAGTCTGA-1_Br6432_Ant_IF,1,1,1,0,3,6
AGTGATAACCTGCGCG-1_Br6432_Ant_IF,1,1,1,0,0,3
TATGATCTTCTCTTTA-1_Br6432_Ant_IF,1,0,0,0,2,3
TGTACCTACACGAGGG-1_Br6432_Ant_IF,1,0,0,1,2,4
ATATCGTTCCTCGAAC-1_Br6432_Ant_IF,1,0,0,0,1,2
CGGCGCCATCAATCCC-1_Br6432_Ant_IF,0,0,0,0,0,0
CCTGTTTGAAGACACG-1_Br6432_Ant_IF,2,0,0,0,2,4
GCCACTCAGAGCGCGA-1_Br6432_Ant_IF,5,0,1,0,2,8
TCGGCTTGTATCGACG-1_Br6432_Ant_IF,1,0,0,0,0,1
TAGATGGTTCCTTACT-1_Br6432_Ant_IF,3,1,0,0,2,6
ATCGTTAGCTAGCGGA-1_Br6432_Ant_IF,2,0,1,0,1,4
ACAGCGACATTCTCAT-1_Br6432_Ant_IF,1,1,1,0,0,3
ATTCAACCATTTAAGG-1_Br6432_Ant_IF,0,0,1,0,0,1
CACTCTTCTGCTAGCC-1_Br6432_Ant_IF,0,0,0,0,0,0
CTAACTGATAATCGCC-1_Br6432_Ant_IF,3,0,2,0,1,6
TGATGTCAATTAAGTG-1_Br6432_Ant_IF,0,0,1,0,1,2
CGCCGTTCAGCATAGT-1_Br6432_Ant_IF,1,0,2,0,1,4
ATACTACCCGTACCAC-1_Br6432_Ant_IF,6,0,3,0,1,10
CCACTGTTTGGATTAA-1_Br6432_Ant_IF,2,0,0,0,0,2
CACTACGGGAGCTGCC-1_Br6432_Ant_IF,3,0,0,0,0,3
GACCAAACGTTGACTG-1_Br6432_Ant_IF,0,0,0,0,1,1
AAGAGGCCCTTTGGAA-1_Br6432_Ant_IF,0,0,0,0,0,0
CTAACAGCACAATAAC-1_Br6432_Ant_IF,1,2,0,0,1,4
TAATAGGTCACCAGAA-1_Br6432_Ant_IF,0,0,0,0,0,0
CACCAGTCAGCATGCA-1_Br6432_Ant_IF,0,0,0,0,0,0
GAGCGCTGTTAGGTAA-1_Br6432_Ant_IF,1,1,2,0,2,6
CCCTATGTAGAGCAGA-1_Br6432_Ant_IF,0,0,1,0,1,2
GATCGCTATATCTCAG-1_Br6432_Ant_IF,2,0,0,0,2,4
AAGGGACTATGCATTC-1_Br6432_Ant_IF,2,0,0,0,0,2
CTCGGGTTCTCTGGCC-1_Br6432_Ant_IF,0,0,1,0,1,2
TATATATCGAGAAATG-1_Br6432_Ant_IF,4,0,0,0,0,4
ACCCGAGCGAAATTAC-1_Br6432_Ant_IF,3,1,0,0,0,4
TTGTTTCATTAGTCTA-1_Br6432_Ant_IF,1,0,0,0,0,1
ATGGGACCTGCTGAAC-1_Br6432_Ant_IF,2,0,2,0,1,5
TGCGACGGCCGAACGT-1_Br6432_Ant_IF,2,2,1,0,2,7
AGCTAACAAGCAATGT-1_Br6432_Ant_IF,5,1,1,0,4,11
CGTGTCTCGTTACGAC-1_Br6432_Ant_IF,0,0,0,0,0,0
CTAAATCCGGTGTACA-1_Br6432_Ant_IF,2,0,0,0,0,2
GAATAGTGCTCGATTA-1_Br6432_Ant_IF,3,1,1,0,2,7
AACAATACATTGTCGA-1_Br6432_Ant_IF,3,0,0,0,2,5
CACATCGTGCACGCGC-1_Br6432_Ant_IF,2,1,1,0,0,4
ACCGTGACCACGTGGG-1_Br6432_Ant_IF,6,1,0,0,0,7
CCCAATGAGATTTGCA-1_Br6432_Ant_IF,3,0,1,0,0,4
TCAGCAGTAGGCCCTG-1_Br6432_Ant_IF,2,1,1,0,2,6
CTACTCAAGGTATAGT-1_Br6432_Ant_IF,3,1,2,0,0,6
TAGTAGCTTATACCAG-1_Br6432_Ant_IF,1,1,0,0,2,4
ACGTTCGTTCAGGAAA-1_Br6432_Ant_IF,0,0,0,0,0,0
TTAGAATAAGGGTCGG-1_Br6432_Ant_IF,1,0,1,0,0,2
TTCTAGAAAGTCTTAT-1_Br6432_Ant_IF,2,0,0,0,0,2
CCTTCAGTTAAAGTGA-1_Br6432_Ant_IF,0,0,1,0,0,1
TAGCTAGTGATGATGG-1_Br6432_Ant_IF,0,0,0,0,1,1
AGCCCGGTAGCCTGTA-1_Br6432_Ant_IF,1,0,0,0,1,2
TACCTCAGTTGTCTGT-1_Br6432_Ant_IF,1,1,0,0,0,2
GACGGGTTGGCCCGTA-1_Br6432_Ant_IF,2,0,0,0,0,2
GAAACCTATACAAATG-1_Br6432_Ant_IF,1,0,0,0,1,2
TCCACCTCTAGCCTTT-1_Br6432_Ant_IF,3,0,0,0,0,3
AAGACCCAACTGAACA-1_Br6432_Ant_IF,0,0,2,0,0,2
CATACACGGTTCCCAC-1_Br6432_Ant_IF,2,1,0,0,0,3
ACTACGCGTTAGAATT-1_Br6432_Ant_IF,1,1,1,0,0,3
CTTGGCCAAGCTGGGA-1_Br6432_Ant_IF,2,0,0,0,0,2
TTACCCTAGGGATTGG-1_Br6432_Ant_IF,3,0,1,0,0,4
TTCGCACTGTACGACA-1_Br6432_Ant_IF,0,0,1,0,1,2
TAGGTGTTCCACAGAT-1_Br6432_Ant_IF,2,0,0,0,0,2
GAAGCCTGCACATTCC-1_Br6432_Ant_IF,3,0,0,0,0,3
GGCTTTCAATAAGGGT-1_Br6432_Ant_IF,4,0,0,0,2,6
TCCAGGGTATATACGA-1_Br6432_Ant_IF,2,0,0,0,1,3
CTCGCCGAATGTAGGG-1_Br6432_Ant_IF,2,2,0,0,2,6
AGGAAGCTGTCCGCCG-1_Br6432_Ant_IF,1,0,0,0,1,2
GTCTCAAGGCCCGGCT-1_Br6432_Ant_IF,1,0,0,0,0,1
ACCGACACATCTCCCA-1_Br6432_Ant_IF,2,0,0,0,1,3
TATACGCGTCATCACT-1_Br6432_Ant_IF,2,0,0,0,0,2
ATCTGGGCTGTTCTTG-1_Br6432_Ant_IF,1,0,2,0,1,4
TCAAATTTGAGACTCA-1_Br6432_Ant_IF,5,1,1,0,0,7
GTTAAGGGTGCGATGT-1_Br6432_Ant_IF,3,0,2,0,1,6
AGCAAAGGCCGCTAGT-1_Br6432_Ant_IF,1,2,0,0,0,3
TTATAGGTAATTGTCT-1_Br6432_Ant_IF,2,0,0,0,1,3
TTGTGCAGCCACGTCA-1_Br6432_Ant_IF,3,0,0,0,0,3
ACGGACTCTCAAAGCG-1_Br6432_Ant_IF,0,0,1,0,0,1
ATGCTCTGGCGCGGTA-1_Br6432_Ant_IF,3,0,2,0,0,5
ATAATCTTGGAGAACC-1_Br6432_Ant_IF,2,0,0,0,0,2
CTCATTGCTCTAACAA-1_Br6432_Ant_IF,6,2,0,1,0,9
TAGGTGACGATAACCT-1_Br6432_Ant_IF,3,4,0,0,0,7
CGGATCCTCAAGGACT-1_Br6432_Ant_IF,2,0,0,0,0,2
GGGCGTGGTTTCCCAG-1_Br6432_Ant_IF,4,1,0,0,0,5
TGGCTATGTGACATAC-1_Br6432_Ant_IF,3,0,1,0,1,5
CTTAGTGTAGTAGCAT-1_Br6432_Ant_IF,0,0,0,0,0,0
GGATTGCTGTGACTCC-1_Br6432_Ant_IF,0,1,0,0,0,1
ACTTCCATGCGGGACA-1_Br6432_Ant_IF,2,0,0,0,0,2
ACTCAAGTGCAAGGCT-1_Br6432_Ant_IF,4,0,0,0,0,4
ACAAGGATGCTTTAGG-1_Br6432_Ant_IF,2,0,0,0,0,2
TTGAACGACGTGCTGA-1_Br6432_Ant_IF,2,1,1,1,3,8
ATTCATCGTTGAGGCA-1_Br6432_Ant_IF,0,0,0,0,1,1
TGCAACCCATCTGCGG-1_Br6432_Ant_IF,0,0,1,0,1,2
AGTGCTAAACACAGCA-1_Br6432_Ant_IF,1,0,0,0,2,3
AACTCCAGAGCGTGTT-1_Br6432_Ant_IF,2,0,0,0,3,5
TCTCCACAAGTTGAAT-1_Br6432_Ant_IF,1,0,0,0,1,2
CTTTGCATCGCTCTTG-1_Br6432_Ant_IF,1,2,1,0,1,5
TCACAAACCGAGGTAC-1_Br6432_Ant_IF,2,1,0,0,1,4
CCGTAGGAAATCCCTG-1_Br6432_Ant_IF,1,0,0,0,1,2
AAACATTTCCCGGATT-1_Br6432_Ant_IF,1,0,0,0,2,3
GCCTCCGACAATTCAC-1_Br6432_Ant_IF,2,0,2,0,3,7
TCTGCATACCTTGCTT-1_Br6432_Ant_IF,0,0,0,0,0,0
ACCCATTTGTCCCTCT-1_Br6432_Ant_IF,4,1,0,0,4,9
CTGCAGAGAATCAGAG-1_Br6432_Ant_IF,3,1,0,0,1,5
GGAAACTAAATGGGCC-1_Br6432_Ant_IF,2,0,0,0,1,3
CAACCTACCGAGCAGT-1_Br6432_Ant_IF,0,1,1,0,1,3
CCGTAGGGTTGTTTAC-1_Br6432_Ant_IF,2,1,0,0,0,3
GGTTTGTGACCTGAGG-1_Br6432_Ant_IF,5,2,2,0,1,10
TAACCTAGGGAGTCCA-1_Br6432_Ant_IF,2,0,0,0,0,2
TTCCATCGACAGCGTG-1_Br6432_Ant_IF,3,0,0,0,1,4
ATCTCCCACGGAATAT-1_Br6432_Ant_IF,1,2,0,0,3,6
TAAGAGGGACAGGGAC-1_Br6432_Ant_IF,0,0,0,0,0,0
CGAATGAAGTCATTGC-1_Br6432_Ant_IF,0,0,0,0,0,0
AAGGGAACGACTGGCT-1_Br6432_Ant_IF,1,2,0,0,3,6
CGAATCTGCTCGACGC-1_Br6432_Ant_IF,2,2,0,0,1,5
ATCGTGGAAAGTCTGG-1_Br6432_Ant_IF,3,0,1,0,3,7
CCTATGGCTCCTAGTG-1_Br6432_Ant_IF,1,1,0,0,1,3
CGTCGCTTGGTTATAC-1_Br6432_Ant_IF,2,0,0,0,3,5
TGCTTAGAGAGAATGC-1_Br6432_Ant_IF,3,0,1,0,2,6
GATTGCTCCAGTTGCA-1_Br6432_Ant_IF,0,0,0,0,0,0
CGTGCTTCTACCTAAA-1_Br6432_Ant_IF,0,0,0,0,1,1
ACTCCAATATCATCAT-1_Br6432_Ant_IF,0,0,0,0,0,0
GCCGACCCACGACTGC-1_Br6432_Ant_IF,7,0,0,0,0,7
GAGGGTAGTAACAAAG-1_Br6432_Ant_IF,3,0,1,0,3,7
GGCCGAGACTCTGGTG-1_Br6432_Ant_IF,2,0,3,0,1,6
TATATAGGGCTTTACG-1_Br6432_Ant_IF,1,1,1,0,1,4
TGCCGGATGTACGAGC-1_Br6432_Ant_IF,0,0,0,0,0,0
AGGTAGATCGAGATAT-1_Br6432_Ant_IF,2,0,0,0,0,2
GATCAACATAAAGGGA-1_Br6432_Ant_IF,0,1,1,0,0,2
TAACAGCGTTTGTGCT-1_Br6432_Ant_IF,1,0,0,0,2,3
CTATAGGCGTTGATGT-1_Br6432_Ant_IF,1,0,1,0,0,2
GGTTTAATTACCATCG-1_Br6432_Ant_IF,4,0,0,0,1,5
CTCTTCTGGAAGTTAG-1_Br6432_Ant_IF,1,0,2,0,1,4
ATCTGACATGGAAGGA-1_Br6432_Ant_IF,1,0,3,0,0,4
TACGTACTAGTGCTGA-1_Br6432_Ant_IF,0,0,1,0,0,1
ATGACTATCAGCTGTG-1_Br6432_Ant_IF,2,0,0,0,1,3
CTTTGGGATTGTTGCA-1_Br6432_Ant_IF,2,0,1,0,0,3
AGACTGTTACCGGGTC-1_Br6432_Ant_IF,3,0,2,0,0,5
TCCTAACCGTCGGGCA-1_Br6432_Ant_IF,3,0,0,0,1,4
ACGCAAACTAATAGAT-1_Br6432_Ant_IF,2,0,1,0,0,3
AAGTGAGTCGGGTTTA-1_Br6432_Ant_IF,0,0,0,0,0,0
TAAAGCGGTATTTCCA-1_Br6432_Ant_IF,2,1,0,0,0,3
CTCCTCCAGCTCACAC-1_Br6432_Ant_IF,1,0,0,0,0,1
CGGTCCGTCGCAAGCC-1_Br6432_Ant_IF,1,0,0,0,0,1
CCTATATTTGTCCTGG-1_Br6432_Ant_IF,1,0,1,0,0,2
TCCAATAAAGGCTACC-1_Br6432_Ant_IF,0,0,0,0,0,0
AAAGGCTACGGACCAT-1_Br6432_Ant_IF,1,0,0,0,1,2
CGTGACCAGTCCTCTG-1_Br6432_Ant_IF,4,0,0,0,0,4
GATCTGCTATCTAAGG-1_Br6432_Ant_IF,2,0,0,0,0,2
CGAATGACGCATAATG-1_Br6432_Ant_IF,0,0,1,0,2,3
GCTCAATGTAATACCG-1_Br6432_Ant_IF,1,0,1,0,1,3
CTATGCCCGAATGCAA-1_Br6432_Ant_IF,2,0,0,0,0,2
CACAGGGCCGTTGTCA-1_Br6432_Ant_IF,4,0,0,0,0,4
TCAATACGCCGTCATG-1_Br6432_Ant_IF,2,0,0,0,0,2
AGCGGACACTTCGTAG-1_Br6432_Ant_IF,1,0,0,0,0,1
ATACGTTATGCACGGA-1_Br6432_Ant_IF,1,0,0,0,1,2
GAGTAGATACTAGTTG-1_Br6432_Ant_IF,0,0,0,0,1,1
CCAGCTCGAACGCATT-1_Br6432_Ant_IF,0,0,0,0,1,1
TGCTTCCCAAGCAGTA-1_Br6432_Ant_IF,1,0,0,0,1,2
GTAGACACGCCTGACT-1_Br6432_Ant_IF,2,0,0,0,2,4
CTCACATTTACTAAAT-1_Br6432_Ant_IF,2,0,0,0,0,2
GAATGCGAATCGGTTC-1_Br6432_Ant_IF,1,0,0,1,1,3
TAAGGCCCGTCACCCT-1_Br6432_Ant_IF,4,0,0,0,0,4
GAGTATGCGCGTGCAT-1_Br6432_Ant_IF,5,0,1,0,0,6
ATCCACATCGACAGAA-1_Br6432_Ant_IF,1,0,1,0,0,2
TAGACGAAACGCCAAT-1_Br6432_Ant_IF,2,0,0,0,0,2
CAGCAGTCTGTGCTGC-1_Br6432_Ant_IF,1,0,0,1,0,2
CTCACTGTGATACTTA-1_Br6432_Ant_IF,1,1,1,0,0,3
TTAATTGCTTTGGGTG-1_Br6432_Ant_IF,1,1,0,0,0,2
GTAGTCTACGATATTG-1_Br6432_Ant_IF,3,0,0,0,0,3
TTGCCGCTTTCTAGTA-1_Br6432_Ant_IF,0,0,0,0,0,0
GAACCTTTAACGATCC-1_Br6432_Ant_IF,5,2,0,0,0,7
TGGACCAATCTAAGAT-1_Br6432_Ant_IF,0,0,0,0,0,0
CTAGTAGAAAGGGATT-1_Br6432_Ant_IF,2,0,0,0,0,2
AACCTCGCTTTAGCCC-1_Br6432_Ant_IF,0,0,0,0,0,0
GAGTGTCAACCAGAAA-1_Br6432_Ant_IF,2,0,1,0,0,3
GTGATCCTTGTCATGA-1_Br6432_Ant_IF,6,1,1,1,0,9
CTCAACTAACCCGGAT-1_Br6432_Ant_IF,0,0,1,0,0,1
AGTGGCGTCTGAAGGT-1_Br6432_Ant_IF,0,2,0,0,0,2
GGGAAGGGCTTTCTCA-1_Br6432_Ant_IF,0,0,3,0,0,3
AGGCCTGAGAATCTCG-1_Br6432_Ant_IF,5,0,0,0,1,6
AGCCACAGGTTACCCG-1_Br6432_Ant_IF,1,0,1,0,1,3
TGCAATCTAACACGGT-1_Br6432_Ant_IF,2,0,1,0,0,3
GTTTGGGTTTCGCCCG-1_Br6432_Ant_IF,3,1,1,0,1,6
CCTATGTCCACTCCAC-1_Br6432_Ant_IF,2,1,0,0,1,4
CTGCCTTTCTAGTAAA-1_Br6432_Ant_IF,2,0,1,0,2,5
TTAGTAAACCTGCTCT-1_Br6432_Ant_IF,1,0,0,0,0,1
TTGTGGTGGTACTAAG-1_Br6432_Ant_IF,2,0,0,0,0,2
CCTCCTGTTGTGTCGT-1_Br6432_Ant_IF,0,0,0,0,0,0
ACAAAGCATGACCTAG-1_Br6432_Ant_IF,2,0,0,0,0,2
ATAGCAACTAGGGAAG-1_Br6432_Ant_IF,0,0,0,0,0,0
CCGCTCTTCCGAACTA-1_Br6432_Ant_IF,0,0,0,0,0,0
TAGAATAGCCGATGAA-1_Br6432_Ant_IF,4,0,0,0,0,4
GGTCTCCGTCCAGGTT-1_Br6432_Ant_IF,0,0,0,0,0,0
TAATTACGTCAGTAGA-1_Br6432_Ant_IF,1,0,0,0,1,2
TACGTAAAGCGGAGTG-1_Br6432_Ant_IF,0,0,0,0,0,0
GCTACAATCGAGGATA-1_Br6432_Ant_IF,0,2,1,0,0,3
TCAGCCAATCCGTAAA-1_Br6432_Ant_IF,0,1,1,0,1,3
ATCATAGCCCTATGTA-1_Br6432_Ant_IF,1,2,0,0,1,4
CACAGAGACGAGGACG-1_Br6432_Ant_IF,4,1,0,0,1,6
GCACAAACCCTAGATG-1_Br6432_Ant_IF,0,0,0,0,0,0
ACTATGTCCAGCTGCC-1_Br6432_Ant_IF,0,0,0,0,0,0
AAGCCGCCGTGAAATC-1_Br6432_Ant_IF,0,0,0,0,0,0
ATGGGTGTATACCTCC-1_Br6432_Ant_IF,1,1,0,0,0,2
TAAGCGCGAATCAAAT-1_Br6432_Ant_IF,0,0,0,0,0,0
AGCCCGGCATTAGAGG-1_Br6432_Ant_IF,0,0,0,0,0,0
GTGATCAAGCGTGCAC-1_Br6432_Ant_IF,2,0,0,0,1,3
CTGCCTTTAATACCTT-1_Br6432_Ant_IF,0,0,0,0,0,0
TACCTCCACACCAATG-1_Br6432_Ant_IF,2,0,1,0,0,3
GAGCATCAACAACTTG-1_Br6432_Ant_IF,5,1,2,0,2,10
CATACGAACTAGCTGG-1_Br6432_Ant_IF,6,0,0,0,1,7
GGGAACGGTTTCAGAT-1_Br6432_Ant_IF,3,0,0,0,0,3
AGGGTGCCGTTCTTTA-1_Br6432_Ant_IF,1,0,1,0,1,3
ACGACTGGTCATACTC-1_Br6432_Ant_IF,1,1,0,0,1,3
GGATCTTACTGCCCTT-1_Br6432_Ant_IF,4,1,1,0,0,6
TACTCCTCTAGTTGAC-1_Br6432_Ant_IF,6,0,2,0,0,8
GTAGCTCCGGGAGGCT-1_Br6432_Ant_IF,4,0,1,0,1,6
GGACTCGTGAGTGGTC-1_Br6432_Ant_IF,2,0,1,0,0,3
GTAGTTCGAAGGCGAA-1_Br6432_Ant_IF,1,0,1,0,1,3
CTCAAACCACTGCCCG-1_Br6432_Ant_IF,3,0,1,0,1,5
GAGGGAGTCAGATCGC-1_Br6432_Ant_IF,2,0,1,0,1,4
GCGTCCCTAAGACATA-1_Br6432_Ant_IF,0,1,0,0,0,1
TCTCTTACCGCGAACC-1_Br6432_Ant_IF,3,0,0,0,0,3
GGCTACTATACACTCC-1_Br6432_Ant_IF,3,1,0,0,0,4
CGTTGCCCGCGTGGGA-1_Br6432_Ant_IF,2,2,0,0,1,5
TATAGAGTCGCTTGAA-1_Br6432_Ant_IF,1,0,0,0,0,1
ATGTTGTAGTCTGTTT-1_Br6432_Ant_IF,1,0,3,0,2,6
AGTATACACAGCGACA-1_Br6432_Ant_IF,4,0,1,0,1,6
TGTGGTTGCTAAAGCT-1_Br6432_Ant_IF,1,0,2,0,1,4
TGATTCCCGGTTACCT-1_Br6432_Ant_IF,2,1,0,0,1,4
CACTGACGATTGTGGA-1_Br6432_Ant_IF,1,0,0,0,1,2
AACATTGTGACTCGAG-1_Br6432_Ant_IF,3,0,1,0,3,7
GTCCAATATTTAGCCT-1_Br6432_Ant_IF,2,0,1,0,0,3
GCTCTTTCCGCTAGTG-1_Br6432_Ant_IF,2,0,1,0,0,3
GGGTCAGGAGCTAGAT-1_Br6432_Ant_IF,1,0,0,0,3,4
AGGTGGTGACCTTCGC-1_Br6432_Ant_IF,5,0,0,0,0,5
CCCGGGTCGTTCAGGG-1_Br6432_Ant_IF,1,1,0,0,1,3
AGCCAAGCTTTGTGTC-1_Br6432_Ant_IF,4,0,2,0,0,6
TGTGGCGGGCTTCTGG-1_Br6432_Ant_IF,1,0,0,0,0,1
CGAGGGTATCCAGGTG-1_Br6432_Ant_IF,1,1,0,0,0,2
CGTTCAGACCCGCGAA-1_Br6432_Ant_IF,1,0,0,0,0,1
TCATATGAGCTTTGTT-1_Br6432_Ant_IF,3,0,1,0,2,6
AGTTGACGGTCCTTGC-1_Br6432_Ant_IF,0,1,0,0,0,1
ATAATTAGCTAAGTAG-1_Br6432_Ant_IF,1,0,0,0,1,2
GGTCTTGAGCGCTCTT-1_Br6432_Ant_IF,3,0,0,0,1,4
CGTTGTCGGCAATTGA-1_Br6432_Ant_IF,0,0,0,0,0,0
TCTTGCTCCCGATACT-1_Br6432_Ant_IF,1,0,1,0,1,3
AGCAGAAGGAGAAAGA-1_Br6432_Ant_IF,0,0,0,0,1,1
GAAGCCACTGATTATG-1_Br6432_Ant_IF,1,0,2,0,0,3
TGCTCTTGAGAGTTTG-1_Br6432_Ant_IF,1,0,0,0,0,1
GACATCCGTCGAACTG-1_Br6432_Ant_IF,0,0,0,0,0,0
AGATATAATACGACTA-1_Br6432_Ant_IF,3,0,0,0,0,3
TCGCTACTGGCTTTGA-1_Br6432_Ant_IF,3,1,1,0,1,6
GTGACAGCTTCCCACT-1_Br6432_Ant_IF,3,0,0,0,0,3
GTGACGCAGGTTTCAT-1_Br6432_Ant_IF,4,0,0,1,0,5
GGGAAGACGGTCTGTC-1_Br6432_Ant_IF,2,0,0,0,0,2
CGTCGCATGTGAGCCA-1_Br6432_Ant_IF,2,0,0,0,0,2
AGAAGGTTGTAGGTCG-1_Br6432_Ant_IF,3,0,0,0,0,3
GGCCGGCGTCTGCTAT-1_Br6432_Ant_IF,2,3,0,0,0,5
TTGACCAGGAACAACT-1_Br6432_Ant_IF,1,1,0,0,0,2
AGTCGTATAAAGCAGA-1_Br6432_Ant_IF,2,0,0,0,0,2
GGCGTAGGGAAAGCTG-1_Br6432_Ant_IF,2,1,0,0,0,3
AAACCTAAGCAGCCGG-1_Br6432_Ant_IF,0,0,0,1,0,1
ATTGCCTTTATGTTTG-1_Br6432_Ant_IF,5,1,1,0,0,7
CAGGCAGTCTTACCAG-1_Br6432_Ant_IF,2,1,0,0,0,3
AGCTAAGTACGCAGGC-1_Br6432_Ant_IF,1,0,0,0,0,1
AAATCCGATACACGCC-1_Br6432_Ant_IF,2,1,0,0,0,3
CGAGAGCTTTCACTAC-1_Br6432_Ant_IF,2,0,2,0,0,4
CGCCCAGCGTTTCACG-1_Br6432_Ant_IF,0,0,0,0,0,0
TTAAGTATTGTTATCC-1_Br6432_Ant_IF,2,3,0,0,1,6
GTATCCTTTGGTAACC-1_Br6432_Ant_IF,5,0,0,0,3,8
TCTATGCTATAACGAC-1_Br6432_Ant_IF,6,1,0,0,0,7
AAAGGCCCTATAATAC-1_Br6432_Ant_IF,0,0,0,0,0,0
GCTAGCGATAGGTCTT-1_Br6432_Ant_IF,0,0,0,0,0,0
ATTGCCTATTAGACCG-1_Br6432_Ant_IF,3,0,0,0,3,6
GGGCGTTTACATTCAT-1_Br6432_Ant_IF,4,0,2,0,1,7
CCTCTACAAGGATTGG-1_Br6432_Ant_IF,1,1,0,0,7,9
AGTGACTGTGACACAA-1_Br6432_Ant_IF,4,0,2,0,3,9
AGCCCTCCCTGGTGGC-1_Br6432_Ant_IF,1,2,3,0,2,8
CGGTTGAGTATCCTTC-1_Br6432_Ant_IF,2,0,0,0,0,2
CATTATCCCATTAACG-1_Br6432_Ant_IF,3,1,0,0,0,4
AATGTGCTAATCTGAG-1_Br6432_Ant_IF,5,1,2,0,0,8
CTTAGTTGAGGAATCG-1_Br6432_Ant_IF,4,0,2,0,1,7
CTTCTGGGCGTACCTA-1_Br6432_Ant_IF,3,0,1,0,0,4
AGTCAAATGATGTGAT-1_Br6432_Ant_IF,3,0,0,0,2,5
TGAACAAGCAGGGACT-1_Br6432_Ant_IF,4,1,0,0,1,6
AATACCGGAGGGCTGT-1_Br6432_Ant_IF,1,0,0,0,0,1
GTTTGGTGATCGGTGC-1_Br6432_Ant_IF,0,0,0,0,0,0
GACTGCTGGTGAGAAA-1_Br6432_Ant_IF,2,0,0,0,0,2
CGATCCTCGCAACATA-1_Br6432_Ant_IF,7,1,0,0,0,8
CCAACCTTATGTAACT-1_Br6432_Ant_IF,1,0,0,0,1,2
CGTGGTACCCAAAGGC-1_Br6432_Ant_IF,0,0,0,0,0,0
AACCCGACAACCCGTG-1_Br6432_Ant_IF,4,0,0,0,1,5
TATGTAAAGTGCTTAA-1_Br6432_Ant_IF,4,0,0,0,0,4
GCAAGTGTAAAGCATG-1_Br6432_Ant_IF,1,0,0,0,1,2
GTAACTGCCCAAGGAG-1_Br6432_Ant_IF,2,1,1,0,1,5
GGTGCATAAATGATTA-1_Br6432_Ant_IF,0,0,0,0,1,1
TAGTCCCGGAGACCAC-1_Br6432_Ant_IF,4,0,0,0,1,5
CGGCCAGAGCGACCAT-1_Br6432_Ant_IF,1,1,0,0,0,2
TGAATGAGTGTTTCCC-1_Br6432_Ant_IF,1,0,1,0,0,2
TTCACTTCCTAGAACG-1_Br6432_Ant_IF,4,0,0,0,0,4
CGCTTAGTATTGATAC-1_Br6432_Ant_IF,2,0,0,0,1,3
AACGCGACCTTGGGCG-1_Br6432_Ant_IF,0,0,0,0,2,2
GTGCACCAGCTTCAAC-1_Br6432_Ant_IF,1,1,1,0,1,4
TTCTATTAAACGCAGC-1_Br6432_Ant_IF,2,0,0,0,1,3
TGGCAAGCACAAGTCG-1_Br6432_Ant_IF,4,0,0,0,2,6
ATCTGCTGTTATCGCC-1_Br6432_Ant_IF,3,0,0,0,1,4
AATTCCAAGCATGTAC-1_Br6432_Ant_IF,0,0,0,0,1,1
AAACGGTTGCGAACTG-1_Br6432_Ant_IF,2,0,0,0,1,3
GAAGGAGTCGAGTGCG-1_Br6432_Ant_IF,2,0,0,0,0,2
GGCAAGCCCATAGTGG-1_Br6432_Ant_IF,1,0,1,0,1,3
TGACCAAATCTTAAAC-1_Br6432_Ant_IF,2,0,1,0,0,3
TTCGGTACTGTAGAGG-1_Br6432_Ant_IF,1,0,0,0,0,1
ATGTACGATGACGTCG-1_Br6432_Ant_IF,2,0,0,0,0,2
ATCTAGCTTGTGAGGG-1_Br6432_Ant_IF,2,0,0,0,0,2
AGCGGGTCTGACACTC-1_Br6432_Ant_IF,3,0,0,0,0,3
GAGGTACGCGTGTCCC-1_Br6432_Ant_IF,0,0,0,0,1,1
GCACTGCCTACCTTTA-1_Br6432_Ant_IF,1,0,0,0,0,1
GGAGCGAGGCCTACTT-1_Br6432_Ant_IF,1,0,0,0,0,1
AAACTCGGTTCGCAAT-1_Br6432_Ant_IF,5,0,2,0,0,7
GGCGCTTCATTCCCTG-1_Br6432_Ant_IF,2,3,1,0,1,7
TGCTCGGTGGGTCACC-1_Br6432_Ant_IF,2,0,0,0,0,2
AAGCGCAGGGCTTTGA-1_Br6432_Ant_IF,3,0,0,0,0,3
GACCTTCCACGTCTAC-1_Br6432_Ant_IF,5,1,0,0,1,7
GTTAGCCCATGACATC-1_Br6432_Ant_IF,2,1,0,0,0,3
AATTCGATTCGAGGAT-1_Br6432_Ant_IF,2,0,0,0,0,2
AGTCTTTAAAGTGTCC-1_Br6432_Ant_IF,1,0,0,0,0,1
GACTAGGCCGTTAGGT-1_Br6432_Ant_IF,1,0,0,0,0,1
TCCAAGCCTAGACACA-1_Br6432_Ant_IF,7,0,0,0,0,7
GATTGGGAAAGGTTGT-1_Br6432_Ant_IF,1,0,1,0,0,2
GATGAGGAACCTTCGG-1_Br6432_Ant_IF,0,1,0,0,0,1
TGAATACCGACGCGTA-1_Br6432_Ant_IF,4,1,0,1,0,6
AATCGTGAGCCGAGCA-1_Br6432_Ant_IF,0,0,0,0,0,0
GCGAAGAATCTGACGG-1_Br6432_Ant_IF,3,2,0,0,0,5
AGCGAGACGTGAAGGC-1_Br6432_Ant_IF,0,0,0,0,0,0
TTCTACCTCAATCGGT-1_Br6432_Ant_IF,2,1,1,0,0,4
TACGCTGCTGTGTTAA-1_Br6432_Ant_IF,1,0,0,0,0,1
TAGTCCTGCACTAAGC-1_Br6432_Ant_IF,0,5,1,0,0,6
AGCACACGTTTAGACT-1_Br6432_Ant_IF,0,3,6,0,2,11
GTTCGACAATTGTATA-1_Br6432_Ant_IF,7,2,1,0,1,11
CCATGTTCATCTATAT-1_Br6432_Ant_IF,1,1,1,0,1,4
CCCTCGATAATACACA-1_Br6432_Ant_IF,5,0,0,0,0,5
ACTGCCCGCCATTCTC-1_Br6432_Ant_IF,4,0,1,0,1,6
CTATATCCAGCCTGGC-1_Br6432_Ant_IF,1,0,0,0,0,1
CGCACGTCTGTTTATG-1_Br6432_Ant_IF,0,0,0,0,0,0
AATCAGGTTTCATTTA-1_Br6432_Ant_IF,0,0,0,0,1,1
AGAGAAACACCAGAAA-1_Br6432_Ant_IF,3,0,2,0,2,7
ACCCGATTGGTTCCGA-1_Br6432_Ant_IF,0,0,0,0,0,0
TACCAGGAATCCCGTC-1_Br6432_Ant_IF,0,0,1,0,0,1
AAGTGCTTCTCTATTG-1_Br6432_Ant_IF,2,0,0,0,0,2
TGCATGTGACCCATAG-1_Br6432_Ant_IF,3,1,0,0,0,4
TAGATTCAAAGTGCGG-1_Br6432_Ant_IF,2,0,0,0,3,5
AGGGTCAGAGCACTCG-1_Br6432_Ant_IF,4,0,0,0,0,4
GTGAGATAACCTTATA-1_Br6432_Ant_IF,1,0,1,0,0,2
GTGTCAGTGTACGTGG-1_Br6432_Ant_IF,0,0,0,0,0,0
CTGTAGTGAGGATCGA-1_Br6432_Ant_IF,3,0,1,0,1,5
GATAGTGCGAGTAAGT-1_Br6432_Ant_IF,1,0,2,0,1,4
AGGGTTCAGACGGTCC-1_Br6432_Ant_IF,4,0,2,0,0,6
GGACTCGACAGCGCAT-1_Br6432_Ant_IF,1,0,0,0,1,2
CACTCTCAAGCATCGA-1_Br6432_Ant_IF,2,0,0,0,0,2
GAGCGGAATGCGGTGT-1_Br6432_Ant_IF,1,0,0,0,0,1
CAGTTCGAGGACCCGA-1_Br6432_Ant_IF,4,0,0,0,0,4
CGTAACTTCGACACTT-1_Br6432_Ant_IF,2,0,0,0,0,2
TGATCACCACACTGAC-1_Br6432_Ant_IF,0,0,0,0,0,0
CATACTTCTTTCTCCG-1_Br6432_Ant_IF,0,0,0,0,1,1
CAAGTAAGTGATAGAC-1_Br6432_Ant_IF,2,0,0,0,2,4
AGCCCGCAACAAGCAG-1_Br6432_Ant_IF,5,0,1,0,1,7
GCTCCATGCAAAGCAA-1_Br6432_Ant_IF,1,0,1,0,0,2
TCGTACCGACGTCAAG-1_Br6432_Ant_IF,2,0,0,0,2,4
ATTATCGGAATGTACG-1_Br6432_Ant_IF,2,0,0,0,0,2
ACCTACTATAAATCTA-1_Br6432_Ant_IF,2,1,0,0,0,3
TATCCTATCAACTGGT-1_Br6432_Ant_IF,2,0,0,0,1,3
GCGCGGTCTAGTAACT-1_Br6432_Ant_IF,1,0,0,0,1,2
CCTTCGTATAGAATCC-1_Br6432_Ant_IF,0,0,0,0,0,0
TGGGCGATACAATAAG-1_Br6432_Ant_IF,3,0,0,0,2,5
TGACATGTAACGTGAC-1_Br6432_Ant_IF,5,1,0,0,1,7
TTGGGAAGACGAGCCG-1_Br6432_Ant_IF,4,0,1,0,0,5
GGTGTAAATCGATTGT-1_Br6432_Ant_IF,3,0,0,0,1,4
GAACTGTGGAGAGACA-1_Br6432_Ant_IF,2,2,0,0,0,4
TCCACATCGTATATTG-1_Br6432_Ant_IF,3,0,1,0,0,4
CCTATGGTCAAAGCTG-1_Br6432_Ant_IF,1,1,0,0,1,3
TCCTTGTCCTTTAATT-1_Br6432_Ant_IF,0,0,0,0,3,3
AAGTTTATGGGCCCAA-1_Br6432_Ant_IF,3,0,0,0,1,4
GTCCGGGTTCACATTA-1_Br6432_Ant_IF,1,0,1,0,1,3
ATGTAGCGCGCGTAGG-1_Br6432_Ant_IF,0,0,0,0,2,2
TACGGAAGCCAAACCA-1_Br6432_Ant_IF,6,1,1,0,0,8
GCCCTGAGGATGGGCT-1_Br6432_Ant_IF,2,0,0,0,0,2
CGGGCGATGGATCACG-1_Br6432_Ant_IF,4,1,0,0,0,5
TGCGGACTTGACTCCG-1_Br6432_Ant_IF,5,0,0,0,0,5
TAATACTAGAACAGAC-1_Br6432_Ant_IF,3,1,0,0,0,4
TCAAATTGTTGTGCCG-1_Br6432_Ant_IF,6,0,0,0,0,6
GGGCAGTCAACGCCAA-1_Br6432_Ant_IF,2,2,0,0,0,4
TCGCTGCCAATGCTGT-1_Br6432_Ant_IF,1,1,1,0,1,4
TACGTGGGCCCAGGGC-1_Br6432_Ant_IF,2,1,0,0,0,3
GCCTACGTTCTGTGCA-1_Br6432_Ant_IF,0,5,0,0,0,5
TTGCGTGTGTAGGCAT-1_Br6432_Ant_IF,3,0,0,0,0,3
ACCCTCCCGTCAGGGC-1_Br6432_Ant_IF,3,3,0,0,0,6
TGGGTGTAATAGATTT-1_Br6432_Ant_IF,1,0,0,0,0,1
CTTCACGCCCTGGTAC-1_Br6432_Ant_IF,1,1,0,0,0,2
CGGATGAATGCTGTGA-1_Br6432_Ant_IF,1,0,0,0,0,1
CTCTGCAGGCATTCTT-1_Br6432_Ant_IF,0,3,3,0,1,7
TCAAAGTCACGGCGTC-1_Br6432_Ant_IF,1,3,4,0,1,9
TGGGTTTCGGGCGTAC-1_Br6432_Ant_IF,1,0,1,0,0,2
TGCTATGGCAAAGGGA-1_Br6432_Ant_IF,2,0,0,0,0,2
TTCACGGTCGTCACGT-1_Br6432_Ant_IF,1,0,1,0,2,4
CGTAAAGCAAGAAATC-1_Br6432_Ant_IF,2,0,1,0,0,3
CTGATCCCTTTATGCA-1_Br6432_Ant_IF,2,0,0,0,1,3
GAGTATACCCTAATCA-1_Br6432_Ant_IF,6,0,0,0,0,6
CCACGGCAGGTGTAGG-1_Br6432_Ant_IF,0,1,0,0,0,1
ACGTACTTTGGCACGG-1_Br6432_Ant_IF,3,0,0,0,0,3
CCTGAGAATAAATGCA-1_Br6432_Ant_IF,0,0,0,0,0,0
TTGATGCCGCTCGTCG-1_Br6432_Ant_IF,1,0,0,0,0,1
GCCAGGAAAGAACACT-1_Br6432_Ant_IF,1,0,1,0,3,5
TCCGACCGCTAATCAA-1_Br6432_Ant_IF,2,0,0,0,1,3
TATATCAAAGTGATCT-1_Br6432_Ant_IF,4,0,0,0,0,4
CCTCGGTTTCCTTGCC-1_Br6432_Ant_IF,9,0,0,0,3,12
TAAATTTAGTAACACC-1_Br6432_Ant_IF,1,0,0,0,0,1
CTCGTTACGGCTACCA-1_Br6432_Ant_IF,1,1,0,0,2,4
GCCGTCGGTTTCGGGC-1_Br6432_Ant_IF,3,1,0,0,0,4
GTTCCGTCCGCCTGCA-1_Br6432_Ant_IF,3,0,1,0,1,5
CTAGGGATAGGGACAA-1_Br6432_Ant_IF,6,2,0,0,1,9
GTCCAGGCACGTGTGC-1_Br6432_Ant_IF,3,0,1,0,0,4
GAGGAATATCTCTTTG-1_Br6432_Ant_IF,2,0,1,0,0,3
CGTTCAAGGAAACGGA-1_Br6432_Ant_IF,1,0,0,0,1,2
GTGGGAACAAACCGGG-1_Br6432_Ant_IF,2,0,2,0,2,6
GGGCACGTAGTACTGT-1_Br6432_Ant_IF,4,0,0,0,0,4
ACTACAAAGAGAGGTG-1_Br6432_Ant_IF,0,0,2,0,2,4
GGTGTAGGTAAGTAAA-1_Br6432_Ant_IF,7,0,0,0,1,8
CCTGTTCAACCTCGGG-1_Br6432_Ant_IF,2,1,0,0,0,3
TGAGGTGTGTGGCGGA-1_Br6432_Ant_IF,1,0,1,0,0,2
ATTGTCTGTTTCATGT-1_Br6432_Ant_IF,4,1,0,0,1,6
GCCGGTCGTATCTCTC-1_Br6432_Ant_IF,2,0,1,0,0,3
ATATGGGATAGCAACT-1_Br6432_Ant_IF,1,0,0,0,0,1
GATAGAACCCGCTAGG-1_Br6432_Ant_IF,2,0,0,2,0,4
ATCCCATTTCCGTGGG-1_Br6432_Ant_IF,1,0,0,0,1,2
GATGCTACCTTCGATG-1_Br6432_Ant_IF,0,0,0,0,0,0
TGCAAAGTTCGTCTGT-1_Br6432_Ant_IF,1,0,0,0,0,1
GTTCAGTCGCCAAATG-1_Br6432_Ant_IF,2,0,0,0,1,3
GTCTCCGCCTCAATAC-1_Br6432_Ant_IF,3,2,0,1,2,8
AGTAGAAGGCGCCTCA-1_Br6432_Ant_IF,1,0,1,0,0,2
GTTGTAGATTTATGAG-1_Br6432_Ant_IF,1,1,0,0,1,3
CTATTTGCTTGGAGGA-1_Br6432_Ant_IF,7,0,0,0,0,7
AGCCATATAGTATGTG-1_Br6432_Ant_IF,2,0,0,0,0,2
TGTTCCGGCCTGAGCT-1_Br6432_Ant_IF,3,1,0,0,1,5
TGCCGTGGGACCCAAT-1_Br6432_Ant_IF,2,0,0,0,0,2
TTGCAAGAAGACTCCT-1_Br6432_Ant_IF,4,0,0,0,1,5
CCGCTCCAGGGCGATC-1_Br6432_Ant_IF,3,0,4,0,1,8
CAAACCCTCCGGCGGG-1_Br6432_Ant_IF,0,1,0,0,0,1
CGGACCTTTACGTCCC-1_Br6432_Ant_IF,0,0,0,0,0,0
ACGTAGGAGAGTCGCT-1_Br6432_Ant_IF,1,0,0,0,0,1
CTGCGACCTCGCCGAA-1_Br6432_Ant_IF,2,0,0,0,0,2
GGCCCAGCTGGTTTGC-1_Br6432_Ant_IF,1,0,0,0,0,1
GGATTAATCATGGACC-1_Br6432_Ant_IF,5,0,0,0,1,6
GAGATGGCTTTAATCA-1_Br6432_Ant_IF,5,0,0,1,0,6
AGTACAGAAGCTTATA-1_Br6432_Ant_IF,4,0,1,0,0,5
GCGGCTTTAGCAAGTT-1_Br6432_Ant_IF,4,0,0,0,0,4
ACCGAGTCTCCTTATT-1_Br6432_Ant_IF,0,0,0,0,0,0
GACCACACTTCCCTTT-1_Br6432_Ant_IF,1,0,0,0,0,1
GCCCGATGCCCAGTTC-1_Br6432_Ant_IF,0,1,1,0,0,2
CGAACCTCTTTCCTAG-1_Br6432_Ant_IF,1,0,0,0,0,1
CATGCACATGAGAGGC-1_Br6432_Ant_IF,6,4,0,0,1,11
CCAAATCAAAGGGCAA-1_Br6432_Ant_IF,6,3,0,0,2,11
GTAGTTTAAGCACACG-1_Br6432_Ant_IF,2,1,1,0,0,4
TAAGTGAATAGTCTAC-1_Br6432_Ant_IF,1,1,2,0,1,5
GGTCCACGTCTATTTG-1_Br6432_Ant_IF,0,0,0,0,0,0
CCCTCAGATCGAGAAC-1_Br6432_Ant_IF,0,0,0,0,1,1
ACATTCGCGCGGAATA-1_Br6432_Ant_IF,0,0,0,0,0,0
CTATGAACACCTTGCC-1_Br6432_Ant_IF,0,0,0,0,1,1
CGAATGGTAGGTCGTC-1_Br6432_Ant_IF,2,0,0,0,0,2
TCGACATAGCGTAGCG-1_Br6432_Ant_IF,2,0,0,0,0,2
GACGTTGCTCGGCGGC-1_Br6432_Ant_IF,1,0,0,0,2,3
CTCGAGGCAAGTTTCA-1_Br6432_Ant_IF,4,0,0,0,1,5
GCTGGGAGCGCGTCAA-1_Br6432_Ant_IF,2,0,0,0,1,3
GACGATATCACTGGGT-1_Br6432_Ant_IF,1,0,0,0,1,2
CAGCTCTGGGCTCACT-1_Br6432_Ant_IF,0,0,0,0,1,1
TAGTCTGCGGCACATT-1_Br6432_Ant_IF,0,0,0,0,0,0
TGGTCGATATACCTCT-1_Br6432_Ant_IF,2,0,0,0,0,2
TTCAGTTCAAGAGGAG-1_Br6432_Ant_IF,0,0,0,0,0,0
GTCTGTAGGTTGAACA-1_Br6432_Ant_IF,0,1,2,0,0,3
GAGAGTCTCGGGAGAG-1_Br6432_Ant_IF,3,0,0,0,0,3
TTGTTTGTATTACACG-1_Br6432_Ant_IF,0,0,0,0,0,0
GCACAGCACGGGCCGA-1_Br6432_Ant_IF,4,0,0,0,0,4
AAACAGTGTTCCTGGG-1_Br6432_Ant_IF,0,0,0,0,0,0
TGGAGAATAATCGTCC-1_Br6432_Ant_IF,0,0,0,0,0,0
CGCCGCGTTCTGAACG-1_Br6432_Ant_IF,1,1,0,0,0,2
CATGCGTTGAGAGGAG-1_Br6432_Ant_IF,1,0,0,0,0,1
TACGCTCCTAGAACTG-1_Br6432_Ant_IF,1,1,0,0,1,3
CCTTGTGAACGTGGTT-1_Br6432_Ant_IF,1,1,0,0,1,3
TTAAAGGCGATGCTCG-1_Br6432_Ant_IF,2,1,0,0,2,5
TAAAGTGCACGTCTCG-1_Br6432_Ant_IF,2,0,1,0,1,4
TGTCCGCAAACAATTC-1_Br6432_Ant_IF,4,0,0,0,0,4
AGGCCTATCATACCAA-1_Br6432_Ant_IF,0,0,0,0,0,0
ACTGGGATGCCAGTGC-1_Br6432_Ant_IF,0,0,0,0,0,0
CGATCCACCATTGTTG-1_Br6432_Ant_IF,0,0,0,0,0,0
GGGCATGCATGTCGAG-1_Br6432_Ant_IF,1,1,0,0,0,2
TCCAGGCAGGACGATC-1_Br6432_Ant_IF,2,0,0,0,0,2
CAATGACCCTTAATTT-1_Br6432_Ant_IF,4,1,0,0,1,6
ATCAAGATCCCAGGAC-1_Br6432_Ant_IF,2,1,1,0,1,5
CTCAGAGCTAATGTCG-1_Br6432_Ant_IF,0,0,0,0,0,0
CTGCGATTTCGAGATT-1_Br6432_Ant_IF,1,1,1,0,2,5
ATGGTATTGGGAACCG-1_Br6432_Ant_IF,2,0,0,0,0,2
TAGGTTCTGCTGAGAA-1_Br6432_Ant_IF,3,1,0,0,0,4
GCCTGTCCCGGTGCAT-1_Br6432_Ant_IF,2,0,0,0,1,3
GGCCTGCTCTGATGTT-1_Br6432_Ant_IF,3,0,0,0,1,4
TAGAGGGAGTTTATCT-1_Br6432_Ant_IF,2,0,0,0,0,2
CTCTACATCCTGCGTG-1_Br6432_Ant_IF,3,0,0,0,0,3
ACACATTTCCGTAGAC-1_Br6432_Ant_IF,0,0,0,0,1,1
TGGGTGTTAAGTAGAA-1_Br6432_Ant_IF,1,2,0,0,1,4
GAGCTCAACATGAGCG-1_Br6432_Ant_IF,2,1,0,0,0,3
GCACACAGCTATTACC-1_Br6432_Ant_IF,5,2,0,0,0,7
GCGACGGTAGTCTCCT-1_Br6432_Ant_IF,1,0,0,0,1,2
GTATCAAGGTACTTCC-1_Br6432_Ant_IF,1,0,0,0,2,3
GGAAAGGGAATTGAGC-1_Br6432_Ant_IF,3,0,0,0,0,3
TACACAGCCGTGGTGC-1_Br6432_Ant_IF,1,0,1,0,1,3
CGGTTGGGCAGGGTCC-1_Br6432_Ant_IF,2,0,0,0,0,2
GCACGCCGATTCCCGC-1_Br6432_Ant_IF,1,0,0,0,0,1
CGCTTTCCGCCAAGGT-1_Br6432_Ant_IF,5,0,1,0,0,6
TGCCCGATAGTTAGAA-1_Br6432_Ant_IF,0,0,0,0,0,0
ACATGCTTACGGCAGC-1_Br6432_Ant_IF,1,1,0,0,2,4
CAGGGAGATAGGCCAG-1_Br6432_Ant_IF,6,0,1,0,0,7
TCGCCACCCGGATTAC-1_Br6432_Ant_IF,2,1,0,0,0,3
TCTTGGTCAATGATAC-1_Br6432_Ant_IF,5,0,1,0,2,8
CATAGGGACACTTGTG-1_Br6432_Ant_IF,4,0,3,0,1,8
CACGAGCAAACCAGAC-1_Br6432_Ant_IF,4,1,0,0,0,5
GGGATATTGATCGCCA-1_Br6432_Ant_IF,0,0,0,0,3,3
TAATGTCGGTTCATGG-1_Br6432_Ant_IF,4,0,0,0,1,5
CGATTTGTCATTAATG-1_Br6432_Ant_IF,1,1,0,0,0,2
TTAAGATACCCAGAGA-1_Br6432_Ant_IF,2,0,0,0,1,3
CGACCGTTGGTATTCG-1_Br6432_Ant_IF,2,1,0,0,5,8
ACTACCATCCGAGGGC-1_Br6432_Ant_IF,2,0,1,0,0,3
TCTACGCACGATCTCC-1_Br6432_Ant_IF,2,0,1,0,0,3
AAGCCACTTGCAGGTA-1_Br6432_Ant_IF,2,1,0,0,2,5
ACGTTGTCGTTGAAAG-1_Br6432_Ant_IF,1,0,0,0,0,1
ACCGCTAGTCATTGGT-1_Br6432_Ant_IF,0,0,1,0,2,3
CATGAGTCCATCACGG-1_Br6432_Ant_IF,3,0,0,0,1,4
ATGTCTTGTTTGACTC-1_Br6432_Ant_IF,1,0,0,0,0,1
TCCCAAACATCCTCTA-1_Br6432_Ant_IF,3,0,0,0,1,4
CAACGCGATGAGCCAA-1_Br6432_Ant_IF,0,0,0,0,0,0
GACACCCAAAGACGCG-1_Br6432_Ant_IF,2,4,1,0,1,8
ACGTTCACTATGCCGC-1_Br6432_Ant_IF,0,0,0,0,0,0
ATGGACTGCTTAGTTG-1_Br6432_Ant_IF,4,2,1,0,1,8
CCATGGCAAACGCTCA-1_Br6432_Ant_IF,2,0,0,0,0,2
TTGTCTCGGCAAGATG-1_Br6432_Ant_IF,0,1,0,0,1,2
TTCGAACGAAACATGC-1_Br6432_Ant_IF,0,0,0,0,0,0
GGAAAGTCTTGATTGT-1_Br6432_Ant_IF,2,1,0,0,0,3
ATCATAGATCGACGAG-1_Br6432_Ant_IF,2,1,0,0,3,6
GATTAGAAACAAGCGT-1_Br6432_Ant_IF,4,2,0,0,1,7
GCTGCGAAGAATTATT-1_Br6432_Ant_IF,5,1,1,0,0,7
GCTCATTGATCATATC-1_Br6432_Ant_IF,5,0,0,0,0,5
GTCTATACACGCATGG-1_Br6432_Ant_IF,0,0,0,0,1,1
TGGTGCCCTGCCTTAC-1_Br6432_Ant_IF,1,0,0,0,0,1
TCGAATCGCAGGGTAG-1_Br6432_Ant_IF,2,0,0,0,1,3
GGTAGGCCAATATCAC-1_Br6432_Ant_IF,3,1,0,0,1,5
CGTAAATAACAAAGGG-1_Br6432_Ant_IF,1,0,0,0,1,2
GACTCTAGAGTTCCAA-1_Br6432_Ant_IF,1,0,0,0,0,1
ACTTGTTACCGGATCA-1_Br6432_Ant_IF,5,2,0,0,0,7
GGCATTGAACATCTCA-1_Br6432_Ant_IF,3,0,0,0,0,3
AACCCGCTGTATTCCA-1_Br6432_Ant_IF,2,1,0,0,0,3
TAACAGGTTCCCTTAG-1_Br6432_Ant_IF,2,1,0,0,0,3
GTTCTTGTAACTCAAT-1_Br6432_Ant_IF,3,0,0,0,0,3
GATTCTGTTAATGAGT-1_Br6432_Ant_IF,0,0,0,0,1,1
GGACACCTCGGTGTTG-1_Br6432_Ant_IF,6,0,0,0,0,6
CGATCGAGAAGCACCA-1_Br6432_Ant_IF,4,3,0,0,0,7
CTGCTCTGACGGCAAA-1_Br6432_Ant_IF,7,1,0,0,0,8
CCCAGGAAGAATTCGA-1_Br6432_Ant_IF,0,0,0,0,0,0
TGTCGTGGGTATAGGC-1_Br6432_Ant_IF,4,0,0,0,0,4
ATATGTCTAGAGCGTG-1_Br6432_Ant_IF,0,1,0,0,3,4
GCGGGCAGACGGGTGA-1_Br6432_Ant_IF,1,0,0,0,0,1
CGAAGATCAGTTTCAT-1_Br6432_Ant_IF,2,0,1,0,0,3
ACGCCACTCGAAACAG-1_Br6432_Ant_IF,3,0,1,0,2,6
CTTAGATGTTTCATCC-1_Br6432_Ant_IF,2,1,1,0,3,7
GCGAATGGACTAGCGA-1_Br6432_Ant_IF,3,1,0,0,0,4
TAAATTGTGGGTAAAG-1_Br6432_Ant_IF,1,1,0,0,0,2
ATTTATACTGGTAAAG-1_Br6432_Ant_IF,0,0,0,0,0,0
GCGTCGTAACATGGTC-1_Br6432_Ant_IF,1,5,0,0,0,6
CCAGGCGAGATGGTCT-1_Br6432_Ant_IF,2,3,0,0,2,7
CGACTTGCCGGGAAAT-1_Br6432_Ant_IF,3,0,0,0,0,3
GTGCCAAACGTTTCGA-1_Br6432_Ant_IF,4,0,1,0,1,6
TTGTTGGCAATGACTG-1_Br6432_Ant_IF,0,0,0,0,0,0
GGTGGGATTAGGTCCC-1_Br6432_Ant_IF,3,1,0,0,0,4
AATAGGCACGACCCTT-1_Br6432_Ant_IF,1,0,0,0,1,2
GAGGTCCGTTCGCTGT-1_Br6432_Ant_IF,3,0,0,0,0,3
AGCTAAGCTCCGTCCG-1_Br6432_Ant_IF,7,0,1,0,1,9
CCCAGATTCCCGTGAC-1_Br6432_Ant_IF,3,3,0,0,0,6
ACAAACTCCATCAGAG-1_Br6432_Ant_IF,4,0,2,0,0,6
TTGCGGAAAGCTGCCC-1_Br6432_Ant_IF,5,0,0,0,0,5
GGTTACCGCTCCCTAC-1_Br6432_Ant_IF,2,5,0,0,0,7
CCGTTTCCTTTCCGTG-1_Br6432_Ant_IF,2,0,0,0,1,3
CGGACCTCTGTAGTTA-1_Br6432_Ant_IF,5,0,1,0,2,8
CCCTAGCTCTAAGGTC-1_Br6432_Ant_IF,10,1,0,0,0,11
GTAACAGGTTAACGGC-1_Br6432_Ant_IF,4,0,0,0,0,4
CCCGCAAATAATCATC-1_Br6432_Ant_IF,9,0,0,0,0,9
AATCCCGCTCAGAGCC-1_Br6432_Ant_IF,0,0,0,0,0,0
AACGTCATCCGGCTTG-1_Br6432_Ant_IF,6,0,0,0,0,6
CTCGTGGCACTGAAAG-1_Br6432_Ant_IF,1,0,1,0,0,2
CTTTATCCGACGCATG-1_Br6432_Ant_IF,0,2,0,0,0,2
AAATGACTGATCAAAC-1_Br6432_Ant_IF,3,0,0,0,0,3
TTCGTGCATGTTATAG-1_Br6432_Ant_IF,5,0,0,0,0,5
ATCAAAGAGCCGTGGT-1_Br6432_Ant_IF,2,0,0,0,0,2
ATGTCATAATAAACGA-1_Br6432_Ant_IF,1,1,0,0,0,2
CTTAATCGACTTAGTA-1_Br6432_Ant_IF,1,5,0,0,0,6
CTAAAGGATGAGATAC-1_Br6432_Ant_IF,0,0,1,0,0,1
GTGCTATCCAGCTGGA-1_Br6432_Ant_IF,1,0,0,0,0,1
GACAGAGGTCTTCAGT-1_Br6432_Ant_IF,1,0,0,0,0,1
TCGATTTACGAAACGA-1_Br6432_Ant_IF,2,0,0,0,0,2
AGGCTTAAGTTGCACA-1_Br6432_Ant_IF,2,2,0,0,0,4
TAGGATCTTAACCGCA-1_Br6432_Ant_IF,4,0,0,0,0,4
